,stock_code,date,prev,open,high,low,close,change
0,ACES,2024-01-02,720,725,730,710,715,-5
1,ACES,2024-01-03,715,720,730,710,715,0
2,ACES,2024-01-04,715,715,745,715,735,20
3,ACES,2024-01-05,735,740,760,735,750,15
4,ACES,2024-01-08,750,750,755,730,735,-15
5,ACES,2024-01-09,735,745,765,725,765,30
6,ACES,2024-01-10,765,765,780,755,770,5
7,ACES,2024-01-10,765,765,780,755,770,5
8,ACES,2024-01-11,770,770,815,765,810,40
9,ACES,2024-01-12,810,810,815,790,810,0
10,ACES,2024-01-15,810,810,815,795,810,0
11,ACES,2024-01-16,810,810,815,800,810,0
12,ACES,2024-01-17,810,810,810,790,800,-10
13,ACES,2024-01-18,800,800,805,790,800,0
14,ACES,2024-01-19,800,800,810,780,800,0
15,ACES,2024-01-22,800,800,815,790,810,10
16,ACES,2024-01-23,810,815,825,805,825,15
17,ACES,2024-01-24,825,825,835,815,825,0
18,ACES,2024-01-25,825,830,835,825,825,0
19,ACES,2024-01-26,825,825,835,810,820,-5
20,ACES,2024-01-29,820,820,835,815,835,15
21,ACES,2024-01-30,835,835,835,820,830,-5
22,ACES,2024-01-31,830,830,850,825,850,20
23,ACES,2024-02-01,850,850,865,835,855,5
24,ACES,2024-02-02,855,855,855,810,820,-35
25,ACES,2024-02-05,820,820,825,800,810,-10
26,ACES,2024-02-06,810,820,845,815,830,20
27,ACES,2024-02-07,830,835,845,820,830,0
28,ACES,2024-02-12,830,830,830,810,815,-15
29,ACES,2024-02-13,815,815,825,810,820,5
30,ACES,2024-02-15,820,825,830,815,825,5
31,ACES,2024-02-16,825,825,825,765,775,-50
32,ACES,2024-02-19,775,775,795,760,760,-15
33,ACES,2024-02-20,760,760,795,760,785,25
34,ACES,2024-02-21,785,790,795,775,795,10
35,ACES,2024-02-22,795,800,850,800,835,40
36,ACES,2024-02-23,835,835,845,830,840,5
37,ACES,2024-02-26,840,840,860,840,850,10
38,ACES,2024-02-27,850,855,855,835,835,-15
39,ACES,2024-02-28,835,845,845,830,830,-5
40,ACES,2024-02-29,830,830,845,820,835,5
41,ACES,2024-03-01,835,840,845,820,825,-10
42,ACES,2024-03-04,825,830,830,810,820,-5
43,ACES,2024-03-05,820,820,825,805,805,-15
44,ACES,2024-03-06,805,810,820,800,800,-5
45,ACES,2024-03-07,800,805,830,805,820,20
46,ACES,2024-03-08,820,820,835,820,825,5
47,ACES,2024-03-13,825,830,850,830,835,10
48,ACES,2024-03-14,835,835,845,820,840,5
49,ACES,2024-03-15,840,840,845,830,835,-5
50,ACES,2024-03-18,835,835,845,825,825,-10
51,ACES,2024-03-19,825,825,855,825,845,20
52,ACES,2024-03-20,845,850,945,850,930,85
53,ACES,2024-03-21,930,930,950,915,920,-10
54,ACES,2024-03-22,920,925,935,910,915,-5
55,ACES,2024-03-25,915,910,945,900,930,15
56,ACES,2024-03-26,930,930,930,910,925,-5
57,ACES,2024-03-27,925,925,930,905,910,-15
58,ACES,2024-03-28,910,910,915,880,880,-30
59,ACES,2024-04-01,880,880,910,855,910,30
60,ACES,2024-04-02,910,910,965,910,955,45
61,ACES,2024-04-03,955,955,965,945,955,0
62,ACES,2024-04-04,955,955,985,930,965,10
63,ACES,2024-04-05,965,960,960,945,950,-15
64,ACES,2024-04-16,950,935,935,885,910,-40
65,ACES,2024-04-17,910,910,930,910,920,10
66,ACES,2024-04-18,920,925,950,925,940,20
67,ACES,2024-04-19,940,940,945,915,920,-20
68,ACES,2024-04-22,920,935,960,930,945,25
69,ACES,2024-04-23,945,950,980,950,970,25
70,ACES,2024-04-24,970,975,985,960,970,0
71,ACES,2024-04-25,970,970,995,965,975,5
72,ACES,2024-04-26,975,975,975,890,910,-65
73,ACES,2024-04-29,910,910,940,910,935,25
74,ACES,2024-04-30,935,935,940,920,935,0
75,ACES,2024-05-02,935,935,935,870,910,-25
76,ACES,2024-05-03,910,915,925,870,880,-30
77,ACES,2024-05-06,880,895,900,865,875,-5
78,ACES,2024-05-07,875,875,900,875,890,15
79,ACES,2024-05-08,890,895,915,875,875,-15
80,ACES,2024-05-13,875,880,885,805,855,-20
81,ACES,2024-05-14,855,855,875,845,855,0
82,ACES,2024-05-15,855,855,880,855,875,20
83,ACES,2024-05-16,875,875,885,850,850,-25
84,ACES,2024-05-17,850,865,865,835,845,-5
85,ACES,2024-05-20,845,860,865,845,850,5
86,ACES,2024-05-21,850,855,855,800,800,-50
87,ACES,2024-05-22,800,810,810,775,800,0
88,ACES,2024-05-27,800,805,820,800,815,15
89,ACES,2024-05-28,815,815,825,800,810,-5
90,ACES,2024-05-29,810,810,835,805,825,15
91,ACES,2024-05-30,825,830,835,810,815,-10
92,ACES,2024-05-31,815,815,830,815,820,5
93,ACES,2023-01-02,496,0,510,496,510,14
94,ACES,2023-01-03,510,0,550,510,510,0
95,ACES,2023-01-04,510,0,525,500,500,-10
96,ACES,2023-01-05,500,0,505,484,488,-12
97,ACES,2023-01-06,488,0,500,480,490,2
98,ACES,2023-01-09,490,0,505,490,492,2
99,ACES,2023-01-10,492,0,498,470,482,-10
100,ACES,2023-01-11,482,0,484,450,450,-32
101,ACES,2023-01-12,450,0,470,442,466,16
102,ACES,2023-01-13,466,0,470,444,450,-16
103,ACES,2023-01-16,450,0,456,440,440,-10
104,ACES,2023-01-17,440,0,446,432,436,-4
105,ACES,2023-01-18,436,0,446,436,440,4
106,ACES,2023-01-19,440,0,442,426,430,-10
107,ACES,2023-01-20,430,0,458,430,458,28
108,ACES,2023-01-24,458,0,478,444,450,-8
109,ACES,2023-01-25,450,0,454,446,450,0
110,ACES,2023-01-26,450,0,488,452,486,36
111,ACES,2023-01-27,486,0,520,484,496,10
112,ACES,2023-01-30,496,0,510,494,498,2
113,ACES,2023-01-31,498,0,515,490,490,-8
114,ACES,2023-02-01,490,490,505,476,480,-10
115,ACES,2023-02-02,480,482,505,482,494,14
116,ACES,2023-02-03,494,500,500,486,492,-2
117,ACES,2023-02-06,492,494,510,490,498,6
118,ACES,2023-02-07,498,500,500,488,490,-8
119,ACES,2023-02-08,490,492,505,492,496,6
120,ACES,2023-02-09,496,498,520,494,510,14
121,ACES,2023-02-10,510,515,515,492,505,-5
122,ACES,2023-02-13,505,505,545,500,545,40
123,ACES,2023-02-14,545,550,565,530,540,-5
124,ACES,2023-02-15,540,545,550,540,545,5
125,ACES,2023-02-16,545,545,560,540,555,10
126,ACES,2023-02-17,555,560,565,530,540,-15
127,ACES,2023-02-20,540,540,550,530,540,0
128,ACES,2023-02-21,540,545,555,540,545,5
129,ACES,2023-02-22,545,540,545,520,525,-20
130,ACES,2023-02-23,525,530,535,500,510,-15
131,ACES,2023-02-24,510,515,535,510,515,5
132,ACES,2023-02-27,515,515,525,500,510,-5
133,ACES,2023-02-28,510,510,515,500,505,-5
134,ACES,2023-03-01,505,505,515,505,505,0
135,ACES,2023-03-02,505,505,510,492,494,-11
136,ACES,2023-03-03,494,494,510,486,496,2
137,ACES,2023-03-06,496,505,510,498,498,2
138,ACES,2023-03-07,498,500,505,494,496,-2
139,ACES,2023-03-08,496,494,496,480,486,-10
140,ACES,2023-03-09,486,488,505,486,500,14
141,ACES,2023-03-10,500,500,505,492,500,0
142,ACES,2023-03-13,500,496,505,494,500,0
143,ACES,2023-03-14,500,498,500,466,468,-32
144,ACES,2023-03-15,468,472,482,436,456,-12
145,ACES,2023-03-16,456,452,458,436,440,-16
146,ACES,2023-03-17,440,442,454,442,442,2
147,ACES,2023-03-20,442,442,458,438,450,8
148,ACES,2023-03-21,450,452,458,444,450,0
149,ACES,2023-03-24,450,454,470,450,468,18
150,ACES,2023-03-27,468,470,478,460,468,0
151,ACES,2023-03-28,468,472,474,462,466,-2
152,ACES,2023-03-29,466,466,472,464,468,2
153,ACES,2023-03-30,468,470,486,470,482,14
154,ACES,2023-03-31,482,484,490,474,478,-4
155,ACES,2023-04-03,478,480,490,480,480,2
156,ACES,2023-04-04,480,480,486,472,474,-6
157,ACES,2023-04-05,474,474,480,464,464,-10
158,ACES,2023-04-06,464,468,470,450,452,-12
159,ACES,2023-04-10,452,454,456,440,444,-8
160,ACES,2023-04-11,444,444,452,442,444,0
161,ACES,2023-04-12,444,448,454,446,452,8
162,ACES,2023-04-13,452,452,454,444,446,-6
163,ACES,2023-04-14,446,446,450,444,446,0
164,ACES,2023-04-17,446,446,452,432,440,-6
165,ACES,2023-04-18,440,442,444,438,440,0
166,ACES,2023-04-26,440,440,444,438,442,2
167,ACES,2023-04-27,442,444,448,440,446,4
168,ACES,2023-04-28,446,446,454,446,450,4
169,ACES,2023-05-02,450,450,452,442,444,-6
170,ACES,2023-05-03,444,444,456,444,450,6
171,ACES,2023-05-04,450,450,466,448,464,14
172,ACES,2023-05-05,464,464,478,464,472,8
173,ACES,2023-05-08,472,476,525,476,510,38
174,ACES,2023-05-09,510,520,560,515,555,45
175,ACES,2023-05-10,555,560,560,535,550,-5
176,ACES,2023-05-11,550,550,550,525,540,-10
177,ACES,2023-05-12,540,540,550,530,535,-5
178,ACES,2023-05-15,535,535,565,535,565,30
179,ACES,2023-05-16,565,570,575,545,570,5
180,ACES,2023-05-17,570,570,600,560,595,25
181,ACES,2023-05-19,595,595,615,575,585,-10
182,ACES,2023-05-22,585,585,635,580,630,45
183,ACES,2023-05-23,630,630,645,595,605,-25
184,ACES,2023-05-24,605,605,625,600,615,10
185,ACES,2023-05-25,615,620,635,615,635,20
186,ACES,2023-05-26,635,640,655,635,655,20
187,ACES,2023-05-29,655,660,660,615,630,-25
188,ACES,2023-05-30,630,635,635,615,620,-10
189,ACES,2023-05-31,620,625,640,600,630,10
190,ACES,2023-06-05,630,630,635,610,630,0
191,ACES,2023-06-06,630,630,645,620,645,15
192,ACES,2023-06-07,645,645,705,640,700,55
193,ACES,2023-06-08,700,700,710,665,680,-20
194,ACES,2023-06-09,680,680,695,670,685,5
195,ACES,2023-06-12,685,685,705,675,680,-5
196,ACES,2023-06-13,680,680,685,630,645,-35
197,ACES,2023-06-14,645,645,685,635,685,40
198,ACES,2023-06-15,685,690,700,660,660,-25
199,ACES,2023-06-16,660,665,670,645,650,-10
200,ACES,2023-06-19,650,650,660,630,635,-15
201,ACES,2023-06-20,635,635,645,605,605,-30
202,ACES,2023-06-21,605,610,700,610,690,85
203,ACES,2023-06-22,690,690,690,660,670,-20
204,ACES,2023-06-23,670,670,680,660,670,0
205,ACES,2023-06-26,670,670,690,670,680,10
206,ACES,2023-06-27,680,680,685,670,675,-5
207,ACES,2023-07-03,675,675,690,670,670,-5
208,ACES,2023-07-04,670,670,685,640,655,-15
209,ACES,2023-07-05,655,635,650,625,640,-15
210,ACES,2023-07-06,640,645,665,635,655,15
211,ACES,2023-07-07,655,655,745,640,720,65
212,ACES,2023-07-10,720,725,735,705,710,-10
213,ACES,2023-07-11,710,710,725,705,710,0
214,ACES,2023-07-12,710,715,735,715,725,15
215,ACES,2023-07-13,725,730,730,700,715,-10
216,ACES,2023-07-14,715,715,730,710,720,5
217,ACES,2023-07-17,720,720,765,720,755,35
218,ACES,2023-07-18,755,760,780,735,750,-5
219,ACES,2023-07-20,750,750,795,695,695,-55
220,ACES,2023-07-21,695,695,715,690,705,10
221,ACES,2023-07-24,705,710,745,710,735,30
222,ACES,2023-07-25,735,745,780,730,750,15
223,ACES,2023-07-26,750,755,765,735,740,-10
224,ACES,2023-07-27,740,745,755,735,755,15
225,ACES,2023-07-28,755,760,765,735,735,-20
226,ACES,2023-07-31,735,735,745,715,720,-15
227,ACES,2023-08-01,720,715,730,675,675,-45
228,ACES,2023-08-02,675,675,700,655,665,-10
229,ACES,2023-08-03,665,670,695,670,690,25
230,ACES,2023-08-04,690,695,700,680,680,-10
231,ACES,2023-08-07,680,690,735,690,730,50
232,ACES,2023-08-08,730,730,740,715,720,-10
233,ACES,2023-08-09,720,720,725,705,715,-5
234,ACES,2023-08-10,715,715,720,690,700,-15
235,ACES,2023-08-11,700,700,700,685,700,0
236,ACES,2023-08-14,700,700,700,690,690,-10
237,ACES,2023-08-15,690,695,730,690,720,30
238,ACES,2023-08-16,720,720,730,710,715,-5
239,ACES,2023-08-18,715,715,730,710,710,-5
240,ACES,2023-08-21,710,710,745,710,730,20
241,ACES,2023-08-22,730,750,765,735,750,20
242,ACES,2023-08-23,750,750,760,730,755,5
243,ACES,2023-08-24,755,760,770,755,760,5
244,ACES,2023-08-25,760,765,765,745,750,-10
245,ACES,2023-08-28,750,755,775,750,760,10
246,ACES,2023-08-29,760,765,770,750,755,-5
247,ACES,2023-08-30,755,760,765,750,755,0
248,ACES,2023-08-31,755,755,755,730,730,-25
249,ACES,2023-09-01,730,730,740,710,740,10
250,ACES,2023-09-04,740,740,750,730,740,0
251,ACES,2023-09-05,740,740,740,730,730,-10
252,ACES,2023-09-06,730,730,750,715,725,-5
253,ACES,2023-09-07,725,725,735,720,720,-5
254,ACES,2023-09-08,720,725,730,715,720,0
255,ACES,2023-09-11,720,730,755,720,755,35
256,ACES,2023-09-12,755,760,760,735,750,-5
257,ACES,2023-09-13,750,750,760,745,745,-5
258,ACES,2023-09-14,745,745,750,735,735,-10
259,ACES,2023-09-15,735,735,745,725,730,-5
260,ACES,2023-09-18,730,735,795,730,795,65
261,ACES,2023-09-19,795,800,815,775,775,-20
262,ACES,2023-09-20,775,775,810,770,790,15
263,ACES,2023-09-21,790,800,810,780,800,10
264,ACES,2023-09-22,800,795,800,785,790,-10
265,ACES,2023-09-25,790,795,800,780,790,0
266,ACES,2023-09-26,790,790,795,730,760,-30
267,ACES,2023-09-27,760,760,765,745,755,-5
268,ACES,2023-09-29,755,755,765,745,750,-5
269,ACES,2023-10-02,750,755,790,755,785,35
270,ACES,2023-10-03,785,785,790,770,775,-10
271,ACES,2023-10-04,775,775,775,750,750,-25
272,ACES,2023-10-05,750,750,780,745,760,10
273,ACES,2023-10-06,760,760,770,755,765,5
274,ACES,2023-10-09,765,765,770,760,765,0
275,ACES,2023-10-10,765,770,790,770,780,15
276,ACES,2023-10-11,780,785,790,775,780,0
277,ACES,2023-10-12,780,780,810,780,805,25
278,ACES,2023-10-13,805,805,830,785,785,-20
279,ACES,2023-10-16,785,785,810,775,805,20
280,ACES,2023-10-17,805,805,815,785,800,-5
281,ACES,2023-10-18,800,800,805,785,800,0
282,ACES,2023-10-19,800,800,810,765,790,-10
283,ACES,2023-10-20,790,790,805,780,795,5
284,ACES,2023-10-23,795,810,845,805,825,30
285,ACES,2023-10-24,825,825,865,815,855,30
286,ACES,2023-10-25,855,855,890,855,875,20
287,ACES,2023-10-26,875,875,880,825,870,-5
288,ACES,2023-10-27,870,870,875,840,845,-25
289,ACES,2023-10-30,845,845,860,795,830,-15
290,ACES,2023-10-31,830,830,835,785,800,-30
291,ACES,2023-11-01,800,810,820,780,795,-5
292,ACES,2023-11-02,795,805,820,795,795,0
293,ACES,2023-11-03,795,800,825,795,820,25
294,ACES,2023-11-06,820,830,870,820,860,40
295,ACES,2023-11-07,860,860,860,825,830,-30
296,ACES,2023-11-08,830,840,845,820,830,0
297,ACES,2023-11-09,830,830,840,820,825,-5
298,ACES,2023-11-10,825,820,830,800,805,-20
299,ACES,2023-11-13,805,815,830,810,825,20
300,ACES,2023-11-14,825,830,840,810,810,-15
301,ACES,2023-11-15,810,825,835,820,835,25
302,ACES,2023-11-16,835,840,840,820,830,-5
303,ACES,2023-11-17,830,830,830,815,815,-15
304,ACES,2023-11-20,815,820,835,815,830,15
305,ACES,2023-11-21,830,830,855,820,820,-10
306,ACES,2023-11-22,820,825,830,815,815,-5
307,ACES,2023-11-23,815,820,825,805,810,-5
308,ACES,2023-11-24,810,815,820,760,815,5
309,ACES,2023-11-27,815,815,815,795,800,-15
310,ACES,2023-11-28,800,805,810,770,775,-25
311,ACES,2023-11-29,775,780,785,750,770,-5
312,ACES,2023-11-30,770,770,775,740,755,-15
313,ACES,2023-12-01,755,760,760,730,735,-20
314,ACES,2023-12-04,735,730,750,720,720,-15
315,ACES,2023-12-05,720,720,730,690,710,-10
316,ACES,2023-12-06,710,715,730,705,730,20
317,ACES,2023-12-07,730,730,730,670,695,-35
318,ACES,2023-12-08,695,695,710,690,695,0
319,ACES,2023-12-11,695,700,700,685,690,-5
320,ACES,2023-12-12,690,690,710,685,685,-5
321,ACES,2023-12-13,685,690,690,665,680,-5
322,ACES,2023-12-14,680,685,700,680,680,0
323,ACES,2023-12-15,680,685,690,675,685,5
324,ACES,2023-12-18,685,695,740,690,715,30
325,ACES,2023-12-19,715,720,750,705,740,25
326,ACES,2023-12-20,740,740,750,720,720,-20
327,ACES,2023-12-21,720,725,730,715,725,5
328,ACES,2023-12-22,725,730,735,715,720,-5
329,ACES,2023-12-27,720,720,740,715,725,5
330,ACES,2023-12-28,725,730,735,705,715,-10
331,ACES,2023-12-29,715,715,720,705,720,5
332,ACES,2022-01-03,1280,1285,1385,1285,1380,100
333,ACES,2022-01-04,1380,1380,1380,1345,1365,-15
334,ACES,2022-01-05,1365,1365,1395,1350,1385,20
335,ACES,2022-01-06,1385,1380,1385,1335,1360,-25
336,ACES,2022-01-07,1360,1370,1390,1350,1380,20
337,ACES,2022-01-10,1380,1380,1390,1365,1385,5
338,ACES,2022-01-11,1385,1385,1390,1315,1315,-70
339,ACES,2022-01-12,1315,1330,1360,1300,1325,10
340,ACES,2022-01-13,1325,1325,1370,1325,1355,30
341,ACES,2022-01-14,1355,1355,1370,1345,1370,15
342,ACES,2022-01-17,1370,1370,1375,1345,1350,-20
343,ACES,2022-01-18,1350,1350,1370,1335,1345,-5
344,ACES,2022-01-19,1345,1345,1350,1310,1340,-5
345,ACES,2022-01-20,1340,1340,1340,1300,1300,-40
346,ACES,2022-01-21,1300,1290,1300,1270,1275,-25
347,ACES,2022-01-24,1275,1280,1295,1270,1270,-5
348,ACES,2022-01-25,1270,1270,1285,1250,1250,-20
349,ACES,2022-01-26,1250,1250,1255,1190,1200,-50
350,ACES,2022-01-27,1200,1210,1255,1200,1255,55
351,ACES,2022-01-28,1255,1260,1270,1245,1260,5
352,ACES,2022-01-31,1260,1260,1265,1220,1235,-25
353,ACES,2022-02-02,1235,0,1290,1235,1270,35
354,ACES,2022-02-03,1270,0,1275,1255,1255,-15
355,ACES,2022-02-04,1255,0,1300,1260,1285,30
356,ACES,2022-02-07,1285,0,1305,1270,1275,-10
357,ACES,2022-02-08,1275,0,1285,1245,1245,-30
358,ACES,2022-02-09,1245,0,1250,1215,1220,-25
359,ACES,2022-02-10,1220,0,1240,1210,1230,10
360,ACES,2022-02-11,1230,0,1240,1220,1220,-10
361,ACES,2022-02-14,1220,0,1230,1210,1210,-10
362,ACES,2022-02-15,1210,0,1255,1215,1245,35
363,ACES,2022-02-16,1245,0,1255,1235,1245,0
364,ACES,2022-02-17,1245,0,1255,1215,1225,-20
365,ACES,2022-02-18,1225,0,1260,1215,1245,20
366,ACES,2022-02-21,1245,0,1245,1205,1205,-40
367,ACES,2022-02-22,1205,0,1215,1160,1165,-40
368,ACES,2022-02-23,1165,0,1170,1115,1120,-45
369,ACES,2022-02-24,1120,0,1120,1060,1060,-60
370,ACES,2022-02-25,1060,0,1090,1055,1070,10
371,ACES,2022-03-01,1070,0,1110,1070,1110,40
372,ACES,2022-03-02,1110,0,1110,1060,1060,-50
373,ACES,2022-03-04,1060,0,1070,1015,1025,-35
374,ACES,2022-03-07,1025,0,1035,955,960,-65
375,ACES,2022-03-08,960,0,1015,935,995,35
376,ACES,2022-03-09,995,0,1050,995,1045,50
377,ACES,2022-03-10,1045,0,1115,1045,1110,65
378,ACES,2022-03-11,1110,0,1110,1060,1095,-15
379,ACES,2022-03-14,1095,0,1105,1075,1100,5
380,ACES,2022-03-15,1100,0,1125,1035,1060,-40
381,ACES,2022-03-16,1060,0,1070,1015,1045,-15
382,ACES,2022-03-17,1045,0,1070,1030,1060,15
383,ACES,2022-03-18,1060,0,1070,1000,1000,-60
384,ACES,2022-03-21,1000,0,1025,1000,1005,5
385,ACES,2022-03-22,1005,0,1020,995,995,-10
386,ACES,2022-03-23,995,0,1010,970,990,-5
387,ACES,2022-03-24,990,0,1010,985,995,5
388,ACES,2022-03-25,995,0,1025,995,1005,10
389,ACES,2022-03-28,1005,0,1015,1000,1015,10
390,ACES,2022-03-29,1015,0,1035,1015,1025,10
391,ACES,2022-03-30,1025,0,1060,1020,1025,0
392,ACES,2022-03-31,1025,0,1035,1005,1025,0
393,ACES,2022-04-01,1025,0,1095,1025,1075,50
394,ACES,2022-04-04,1075,0,1120,1075,1110,35
395,ACES,2022-04-05,1110,0,1110,1070,1075,-35
396,ACES,2022-04-06,1075,0,1090,1065,1075,0
397,ACES,2022-04-07,1075,0,1110,1070,1095,20
398,ACES,2022-04-08,1095,0,1115,1080,1085,-10
399,ACES,2022-04-11,1085,0,1100,1050,1065,-20
400,ACES,2022-04-12,1065,0,1175,1060,1160,95
401,ACES,2022-04-13,1160,0,1175,1130,1170,10
402,ACES,2022-04-14,1170,0,1185,1125,1145,-25
403,ACES,2022-04-18,1145,0,1155,1125,1145,0
404,ACES,2022-04-19,1145,0,1150,1070,1075,-70
405,ACES,2022-04-20,1075,0,1120,1070,1095,20
406,ACES,2022-04-21,1095,0,1100,1070,1075,-20
407,ACES,2022-04-22,1075,0,1075,1035,1065,-10
408,ACES,2022-04-25,1065,0,1070,1045,1050,-15
409,ACES,2022-04-26,1050,0,1055,1020,1040,-10
410,ACES,2022-04-27,1040,0,1045,1020,1030,-10
411,ACES,2022-04-28,1030,0,1055,1025,1045,15
412,ACES,2022-05-09,1045,0,1045,985,990,-55
413,ACES,2022-05-10,990,0,1025,955,995,5
414,ACES,2022-05-11,995,0,1035,1000,1025,30
415,ACES,2022-05-12,1025,0,1035,970,970,-55
416,ACES,2022-05-13,970,0,1010,960,990,20
417,ACES,2022-05-17,990,0,1025,1000,1015,25
418,ACES,2022-05-18,1015,0,1030,1000,1015,0
419,ACES,2022-05-19,1015,0,1020,980,1020,5
420,ACES,2022-05-20,1020,0,1025,990,1010,-10
421,ACES,2022-05-23,1010,0,1025,985,995,-15
422,ACES,2022-05-24,995,0,995,960,975,-20
423,ACES,2022-05-25,975,0,1025,975,980,5
424,ACES,2022-05-27,980,0,1000,975,985,5
425,ACES,2022-05-30,985,0,1010,980,1000,15
426,ACES,2022-05-31,1000,0,1010,960,960,-40
427,ACES,2022-06-02,960,0,1000,970,985,25
428,ACES,2022-06-03,985,0,1010,985,1000,15
429,ACES,2022-06-06,1000,0,1005,970,980,-20
430,ACES,2022-06-07,980,0,990,980,990,10
431,ACES,2022-06-08,990,0,990,975,985,-5
432,ACES,2022-06-09,985,0,990,930,945,-40
433,ACES,2022-06-10,945,0,945,910,915,-30
434,ACES,2022-06-13,915,0,915,875,880,-35
435,ACES,2022-06-14,880,0,905,875,885,5
436,ACES,2022-06-15,885,0,890,860,860,-25
437,ACES,2022-06-16,860,0,885,850,850,-10
438,ACES,2022-06-17,850,0,840,800,805,-45
439,ACES,2022-06-20,805,0,815,750,775,-30
440,ACES,2022-06-21,775,0,800,760,765,-10
441,ACES,2022-06-22,765,0,785,720,770,5
442,ACES,2022-06-23,770,0,780,760,770,0
443,ACES,2022-06-24,770,0,810,770,780,10
444,ACES,2022-06-27,780,0,805,780,800,20
445,ACES,2022-06-28,800,0,805,780,790,-10
446,ACES,2022-06-29,790,0,795,775,785,-5
447,ACES,2022-06-30,785,0,795,770,770,-15
448,ACES,2022-07-01,770,0,785,770,775,5
449,ACES,2022-07-04,775,0,780,725,725,-50
450,ACES,2022-07-05,725,0,760,720,750,25
451,ACES,2022-07-06,750,0,760,740,755,5
452,ACES,2022-07-07,755,0,775,755,765,10
453,ACES,2022-07-08,765,0,800,765,795,30
454,ACES,2022-07-11,795,0,805,760,775,-20
455,ACES,2022-07-12,775,0,780,765,770,-5
456,ACES,2022-07-13,770,0,780,750,750,-20
457,ACES,2022-07-14,750,0,760,735,745,-5
458,ACES,2022-07-15,745,0,765,740,745,0
459,ACES,2022-07-18,745,0,755,730,730,-15
460,ACES,2022-07-19,730,0,760,705,755,25
461,ACES,2022-07-20,755,0,770,740,740,-15
462,ACES,2022-07-21,740,0,750,725,730,-10
463,ACES,2022-07-22,730,0,735,715,720,-10
464,ACES,2022-07-25,720,0,730,710,715,-5
465,ACES,2022-07-26,715,0,725,700,700,-15
466,ACES,2022-07-27,700,0,710,685,710,10
467,ACES,2022-07-28,710,0,725,705,705,-5
468,ACES,2022-07-29,705,0,720,700,710,5
469,ACES,2022-08-01,710,0,720,695,700,-10
470,ACES,2022-08-02,700,0,710,690,690,-10
471,ACES,2022-08-03,690,0,695,655,655,-35
472,ACES,2022-08-04,655,0,665,650,650,-5
473,ACES,2022-08-05,650,0,705,650,690,40
474,ACES,2022-08-08,690,0,730,690,705,15
475,ACES,2022-08-09,705,0,730,710,715,10
476,ACES,2022-08-10,715,0,730,710,720,5
477,ACES,2022-08-11,720,0,730,705,720,0
478,ACES,2022-08-12,720,0,745,720,740,20
479,ACES,2022-08-15,740,0,765,725,730,-10
480,ACES,2022-08-16,730,0,740,715,735,5
481,ACES,2022-08-18,735,0,740,715,720,-15
482,ACES,2022-08-19,720,0,745,720,745,25
483,ACES,2022-08-22,745,0,760,735,750,5
484,ACES,2022-08-23,750,0,760,740,760,10
485,ACES,2022-08-24,760,0,780,755,765,5
486,ACES,2022-08-25,765,0,765,745,745,-20
487,ACES,2022-08-26,745,0,750,735,740,-5
488,ACES,2022-08-29,740,0,740,720,720,-20
489,ACES,2022-08-30,720,0,735,720,725,5
490,ACES,2022-08-31,725,0,730,700,720,-5
491,ACES,2022-09-01,720,0,735,715,720,0
492,ACES,2022-09-02,720,0,720,700,705,-15
493,ACES,2022-09-05,705,0,705,665,665,-40
494,ACES,2022-09-06,665,0,695,655,660,-5
495,ACES,2022-09-07,660,0,685,660,680,20
496,ACES,2022-09-08,680,0,690,680,685,5
497,ACES,2022-09-09,685,0,690,670,675,-10
498,ACES,2022-09-12,675,0,685,670,680,5
499,ACES,2022-09-13,680,0,685,675,680,0
500,ACES,2022-09-14,680,0,680,665,670,-10
501,ACES,2022-09-15,670,0,675,665,670,0
502,ACES,2022-09-16,670,0,675,660,660,-10
503,ACES,2022-09-19,660,0,665,650,660,0
504,ACES,2022-09-20,660,0,665,655,660,0
505,ACES,2022-09-21,660,0,665,650,650,-10
506,ACES,2022-09-22,650,0,655,615,630,-20
507,ACES,2022-09-23,630,0,640,620,625,-5
508,ACES,2022-09-26,625,0,650,615,650,25
509,ACES,2022-09-27,650,0,660,635,650,0
510,ACES,2022-09-28,650,0,650,630,635,-15
511,ACES,2022-09-29,635,0,655,630,640,5
512,ACES,2022-09-30,640,0,640,605,610,-30
513,ACES,2022-10-03,610,0,615,600,605,-5
514,ACES,2022-10-04,605,0,620,605,615,10
515,ACES,2022-10-05,615,0,630,610,615,0
516,ACES,2022-10-06,615,0,620,610,615,0
517,ACES,2022-10-07,615,0,620,605,610,-5
518,ACES,2022-10-10,610,0,615,580,585,-25
519,ACES,2022-10-11,585,0,600,575,585,0
520,ACES,2022-10-12,585,0,590,545,545,-40
521,ACES,2022-10-13,545,0,545,510,510,-35
522,ACES,2022-10-14,510,0,535,510,525,15
523,ACES,2022-10-17,525,0,530,505,525,0
524,ACES,2022-10-18,525,0,545,515,535,10
525,ACES,2022-10-19,535,0,540,525,530,-5
526,ACES,2022-10-20,530,0,535,500,500,-30
527,ACES,2022-10-21,500,0,535,488,535,35
528,ACES,2022-10-24,535,0,555,535,540,5
529,ACES,2022-10-25,540,0,550,510,520,-20
530,ACES,2022-10-26,520,0,550,492,535,15
531,ACES,2022-10-27,535,0,590,530,570,35
532,ACES,2022-10-28,570,0,595,555,560,-10
533,ACES,2022-10-31,560,0,575,550,565,5
534,ACES,2022-11-01,565,0,575,555,565,0
535,ACES,2022-11-02,565,0,595,565,590,25
536,ACES,2022-11-03,590,0,610,575,580,-10
537,ACES,2022-11-04,580,0,595,565,590,10
538,ACES,2022-11-07,590,0,595,550,575,-15
539,ACES,2022-11-08,575,0,580,565,570,-5
540,ACES,2022-11-09,570,0,570,560,565,-5
541,ACES,2022-11-10,565,0,570,555,555,-10
542,ACES,2022-11-11,555,0,570,550,560,5
543,ACES,2022-11-14,560,0,570,555,555,-5
544,ACES,2022-11-15,555,0,565,535,535,-20
545,ACES,2022-11-16,535,0,555,530,535,0
546,ACES,2022-11-17,535,0,560,540,555,20
547,ACES,2022-11-18,555,0,575,555,570,15
548,ACES,2022-11-21,570,0,580,555,555,-15
549,ACES,2022-11-22,555,0,565,535,540,-15
550,ACES,2022-11-23,540,0,550,535,545,5
551,ACES,2022-11-24,545,0,550,540,540,-5
552,ACES,2022-11-25,540,0,545,535,540,0
553,ACES,2022-11-28,540,0,550,535,540,0
554,ACES,2022-11-29,540,0,545,515,520,-20
555,ACES,2022-11-30,520,0,525,496,500,-20
556,ACES,2022-12-01,500,0,510,498,500,0
557,ACES,2022-12-02,500,0,505,490,492,-8
558,ACES,2022-12-05,492,0,505,476,478,-14
559,ACES,2022-12-06,478,0,478,460,460,-18
560,ACES,2022-12-07,460,0,466,440,442,-18
561,ACES,2022-12-08,442,0,454,436,442,0
562,ACES,2022-12-09,442,0,448,432,436,-6
563,ACES,2022-12-12,436,0,442,434,440,4
564,ACES,2022-12-13,440,0,444,434,434,-6
565,ACES,2022-12-14,434,0,442,424,426,-8
566,ACES,2022-12-15,426,0,436,410,414,-12
567,ACES,2022-12-16,414,0,420,398,398,-16
568,ACES,2022-12-19,398,0,422,392,420,22
569,ACES,2022-12-20,420,0,438,416,430,10
570,ACES,2022-12-21,430,0,440,422,430,0
571,ACES,2022-12-22,430,0,496,432,486,56
572,ACES,2022-12-23,486,0,498,470,480,-6
573,ACES,2022-12-26,480,0,520,480,500,20
574,ACES,2022-12-27,500,0,515,492,492,-8
575,ACES,2022-12-28,492,0,520,492,494,2
576,ACES,2022-12-29,494,0,505,486,496,2
577,ACES,2022-12-30,496,0,510,494,496,0
