,stock_code,date,prev,open,high,low,close,change
0,SIDO,2024-01-02,525,525,530,510,510,-15
1,SIDO,2024-01-03,510,510,525,505,525,15
2,SIDO,2024-01-04,525,525,525,515,520,-5
3,SIDO,2024-01-05,520,520,525,515,520,0
4,SIDO,2024-01-08,520,520,525,515,520,0
5,SIDO,2024-01-09,520,520,525,515,520,0
6,SIDO,2024-01-10,520,520,525,515,525,5
7,SIDO,2024-01-10,520,520,525,515,525,5
8,SIDO,2024-01-11,525,520,525,515,520,-5
9,SIDO,2024-01-12,520,520,525,515,520,0
10,SIDO,2024-01-15,520,525,530,515,525,5
11,SIDO,2024-01-16,525,520,525,520,525,0
12,SIDO,2024-01-17,525,525,530,520,520,-5
13,SIDO,2024-01-18,520,520,530,520,520,0
14,SIDO,2024-01-19,520,520,520,515,515,-5
15,SIDO,2024-01-22,515,520,525,515,515,0
16,SIDO,2024-01-23,515,515,520,500,500,-15
17,SIDO,2024-01-24,500,500,505,492,500,0
18,SIDO,2024-01-25,500,500,510,498,505,5
19,SIDO,2024-01-26,505,510,510,500,500,-5
20,SIDO,2024-01-29,500,500,510,498,505,5
21,SIDO,2024-01-30,505,505,510,500,505,0
22,SIDO,2024-01-31,505,505,510,505,510,5
23,SIDO,2024-02-01,510,510,510,500,505,-5
24,SIDO,2024-02-02,505,505,505,500,500,-5
25,SIDO,2024-02-05,500,500,505,500,505,5
26,SIDO,2024-02-06,505,505,505,500,500,-5
27,SIDO,2024-02-07,500,505,505,500,500,0
28,SIDO,2024-02-12,500,500,510,498,505,5
29,SIDO,2024-02-13,505,505,510,498,500,-5
30,SIDO,2024-02-15,500,505,525,500,520,20
31,SIDO,2024-02-16,520,520,560,520,560,40
32,SIDO,2024-02-19,560,560,575,540,570,10
33,SIDO,2024-02-20,570,600,610,575,580,10
34,SIDO,2024-02-21,580,580,605,565,600,20
35,SIDO,2024-02-22,600,600,620,590,615,15
36,SIDO,2024-02-23,615,615,625,610,625,10
37,SIDO,2024-02-26,625,625,625,605,620,-5
38,SIDO,2024-02-27,620,620,630,615,620,0
39,SIDO,2024-02-28,620,620,620,610,615,-5
40,SIDO,2024-02-29,615,615,620,600,615,0
41,SIDO,2024-03-01,615,615,615,595,610,-5
42,SIDO,2024-03-04,610,610,630,600,620,10
43,SIDO,2024-03-05,620,620,625,615,620,0
44,SIDO,2024-03-06,620,620,620,600,610,-10
45,SIDO,2024-03-07,610,605,620,605,620,10
46,SIDO,2024-03-08,620,615,625,610,625,5
47,SIDO,2024-03-13,625,625,630,615,620,-5
48,SIDO,2024-03-14,620,620,620,605,615,-5
49,SIDO,2024-03-15,615,610,615,600,605,-10
50,SIDO,2024-03-18,605,605,610,600,600,-5
51,SIDO,2024-03-19,600,600,610,600,605,5
52,SIDO,2024-03-20,605,605,630,600,630,25
53,SIDO,2024-03-21,630,635,645,625,635,5
54,SIDO,2024-03-22,635,640,640,610,630,-5
55,SIDO,2024-03-25,630,630,630,615,620,-10
56,SIDO,2024-03-26,620,620,625,615,615,-5
57,SIDO,2024-03-27,615,620,635,620,625,10
58,SIDO,2024-03-28,625,625,630,620,620,-5
59,SIDO,2024-04-01,620,620,625,600,610,-10
60,SIDO,2024-04-02,610,610,615,605,605,-5
61,SIDO,2024-04-03,605,605,645,605,640,35
62,SIDO,2024-04-04,640,645,670,640,660,20
63,SIDO,2024-04-05,660,660,705,655,675,15
64,SIDO,2024-04-16,675,670,680,640,675,0
65,SIDO,2024-04-17,675,675,675,660,665,-10
66,SIDO,2024-04-18,665,665,675,660,665,0
67,SIDO,2024-04-19,665,665,690,645,685,20
68,SIDO,2024-04-22,685,690,715,690,710,25
69,SIDO,2024-04-23,710,710,715,705,715,5
70,SIDO,2024-04-24,715,715,720,710,720,5
71,SIDO,2024-04-25,720,720,750,715,725,5
72,SIDO,2024-04-26,725,730,745,690,705,-20
73,SIDO,2024-04-29,705,705,725,705,725,20
74,SIDO,2024-04-30,725,720,730,715,730,5
75,SIDO,2024-05-02,730,730,735,705,715,-15
76,SIDO,2024-05-03,715,715,720,705,720,5
77,SIDO,2024-05-06,720,720,725,710,720,0
78,SIDO,2024-05-07,720,720,725,710,720,0
79,SIDO,2024-05-08,720,720,725,710,720,0
80,SIDO,2024-05-13,720,720,720,705,715,-5
81,SIDO,2024-05-14,715,715,730,705,720,5
82,SIDO,2024-05-15,720,720,720,710,715,-5
83,SIDO,2024-05-16,715,715,720,710,715,0
84,SIDO,2024-05-17,715,715,720,710,715,0
85,SIDO,2024-05-20,715,715,715,700,705,-10
86,SIDO,2024-05-21,705,705,710,670,690,-15
87,SIDO,2024-05-22,690,690,715,690,715,25
88,SIDO,2024-05-27,715,715,715,680,700,-15
89,SIDO,2024-05-28,700,690,715,685,705,5
90,SIDO,2024-05-29,705,705,715,690,700,-5
91,SIDO,2024-05-30,700,700,700,670,700,0
92,SIDO,2024-05-31,700,700,710,680,710,10
93,SIDO,2023-01-02,755,0,760,740,745,-10
94,SIDO,2023-01-03,745,0,755,735,745,0
95,SIDO,2023-01-04,745,0,760,740,755,10
96,SIDO,2023-01-05,755,0,760,735,740,-15
97,SIDO,2023-01-06,740,0,745,735,745,5
98,SIDO,2023-01-09,745,0,750,725,730,-15
99,SIDO,2023-01-10,730,0,735,705,710,-20
100,SIDO,2023-01-11,710,0,715,700,705,-5
101,SIDO,2023-01-12,705,0,715,700,715,10
102,SIDO,2023-01-13,715,0,730,710,730,15
103,SIDO,2023-01-16,730,0,735,725,725,-5
104,SIDO,2023-01-17,725,0,735,720,725,0
105,SIDO,2023-01-18,725,0,730,720,725,0
106,SIDO,2023-01-19,725,0,730,720,725,0
107,SIDO,2023-01-20,725,0,730,715,725,0
108,SIDO,2023-01-24,725,0,735,720,725,0
109,SIDO,2023-01-25,725,0,735,720,735,10
110,SIDO,2023-01-26,735,0,775,735,770,35
111,SIDO,2023-01-27,770,0,775,760,760,-10
112,SIDO,2023-01-30,760,0,775,755,765,5
113,SIDO,2023-01-31,765,0,770,750,755,-10
114,SIDO,2023-02-01,755,760,785,750,780,25
115,SIDO,2023-02-02,780,780,790,780,780,0
116,SIDO,2023-02-03,780,785,790,780,785,5
117,SIDO,2023-02-06,785,785,790,780,785,0
118,SIDO,2023-02-07,785,785,790,780,790,5
119,SIDO,2023-02-08,790,790,800,785,800,10
120,SIDO,2023-02-09,800,800,805,795,800,0
121,SIDO,2023-02-10,800,805,810,790,800,0
122,SIDO,2023-02-13,800,800,840,795,830,30
123,SIDO,2023-02-14,830,830,875,830,870,40
124,SIDO,2023-02-15,870,875,880,850,870,0
125,SIDO,2023-02-16,870,870,890,865,890,20
126,SIDO,2023-02-17,890,890,890,835,870,-20
127,SIDO,2023-02-20,870,865,870,840,860,-10
128,SIDO,2023-02-21,860,860,865,850,865,5
129,SIDO,2023-02-22,865,860,895,855,880,15
130,SIDO,2023-02-23,880,880,880,865,880,0
131,SIDO,2023-02-24,880,880,880,865,865,-15
132,SIDO,2023-02-27,865,865,875,850,855,-10
133,SIDO,2023-02-28,855,855,880,850,880,25
134,SIDO,2023-03-01,880,875,890,860,885,5
135,SIDO,2023-03-02,885,880,915,870,910,25
136,SIDO,2023-03-03,910,910,915,890,895,-15
137,SIDO,2023-03-06,895,895,900,885,900,5
138,SIDO,2023-03-07,900,900,910,895,900,0
139,SIDO,2023-03-08,900,895,895,880,885,-15
140,SIDO,2023-03-09,885,890,900,880,885,0
141,SIDO,2023-03-10,885,885,900,855,900,15
142,SIDO,2023-03-13,900,890,890,845,845,-55
143,SIDO,2023-03-14,845,855,875,830,835,-10
144,SIDO,2023-03-15,835,840,855,840,850,15
145,SIDO,2023-03-16,850,850,850,815,835,-15
146,SIDO,2023-03-17,835,835,845,825,825,-10
147,SIDO,2023-03-20,825,825,830,820,820,-5
148,SIDO,2023-03-21,820,825,835,820,825,5
149,SIDO,2023-03-24,825,825,865,825,845,20
150,SIDO,2023-03-27,845,845,865,845,855,10
151,SIDO,2023-03-28,855,860,875,855,865,10
152,SIDO,2023-03-29,865,865,875,860,860,-5
153,SIDO,2023-03-30,860,860,865,840,840,-20
154,SIDO,2023-03-31,840,845,870,845,870,30
155,SIDO,2023-04-03,870,870,875,855,860,-10
156,SIDO,2023-04-04,860,860,865,840,845,-15
157,SIDO,2023-04-05,845,845,855,835,835,-10
158,SIDO,2023-04-06,835,835,845,820,830,-5
159,SIDO,2023-04-10,830,825,825,800,805,-25
160,SIDO,2023-04-11,805,810,840,810,825,20
161,SIDO,2023-04-12,825,830,835,815,815,-10
162,SIDO,2023-04-13,815,815,830,810,815,0
163,SIDO,2023-04-14,815,815,825,810,810,-5
164,SIDO,2023-04-17,810,810,820,805,820,10
165,SIDO,2023-04-18,820,815,815,800,800,-20
166,SIDO,2023-04-26,800,805,820,800,820,20
167,SIDO,2023-04-27,820,820,820,800,800,-20
168,SIDO,2023-04-28,800,800,800,780,790,-10
169,SIDO,2023-05-02,790,785,800,780,795,5
170,SIDO,2023-05-03,795,795,810,790,805,10
171,SIDO,2023-05-04,805,805,815,800,810,5
172,SIDO,2023-05-05,810,810,815,795,800,-10
173,SIDO,2023-05-08,800,800,810,790,805,5
174,SIDO,2023-05-09,805,805,805,795,800,-5
175,SIDO,2023-05-10,800,800,805,770,775,-25
176,SIDO,2023-05-11,775,775,775,755,775,0
177,SIDO,2023-05-12,775,775,785,765,775,0
178,SIDO,2023-05-15,775,775,785,765,775,0
179,SIDO,2023-05-16,775,775,780,765,770,-5
180,SIDO,2023-05-17,770,770,775,765,770,0
181,SIDO,2023-05-19,770,770,770,760,765,-5
182,SIDO,2023-05-22,765,765,780,760,760,-5
183,SIDO,2023-05-23,760,765,775,760,770,10
184,SIDO,2023-05-24,770,775,780,770,780,10
185,SIDO,2023-05-25,780,780,780,770,775,-5
186,SIDO,2023-05-26,775,775,780,760,765,-10
187,SIDO,2023-05-29,765,765,770,755,765,0
188,SIDO,2023-05-30,765,765,770,760,760,-5
189,SIDO,2023-05-31,760,760,765,725,725,-35
190,SIDO,2023-06-05,725,725,740,710,720,-5
191,SIDO,2023-06-06,720,720,755,720,750,30
192,SIDO,2023-06-07,750,755,755,730,735,-15
193,SIDO,2023-06-08,735,740,755,740,755,20
194,SIDO,2023-06-09,755,755,765,740,765,10
195,SIDO,2023-06-12,765,765,770,745,765,0
196,SIDO,2023-06-13,765,765,765,750,760,-5
197,SIDO,2023-06-14,760,755,760,750,760,0
198,SIDO,2023-06-15,760,760,760,745,745,-15
199,SIDO,2023-06-16,745,745,750,725,735,-10
200,SIDO,2023-06-19,735,735,740,720,730,-5
201,SIDO,2023-06-20,730,730,740,725,730,0
202,SIDO,2023-06-21,730,730,740,720,720,-10
203,SIDO,2023-06-22,720,725,735,720,725,5
204,SIDO,2023-06-23,725,725,740,725,735,10
205,SIDO,2023-06-26,735,735,740,725,730,-5
206,SIDO,2023-06-27,730,730,745,730,730,0
207,SIDO,2023-07-03,730,730,740,720,725,-5
208,SIDO,2023-07-04,725,725,730,720,725,0
209,SIDO,2023-07-05,725,725,730,720,720,-5
210,SIDO,2023-07-06,720,725,735,720,730,10
211,SIDO,2023-07-07,730,730,735,725,730,0
212,SIDO,2023-07-10,730,730,735,730,730,0
213,SIDO,2023-07-11,730,735,755,730,745,15
214,SIDO,2023-07-12,745,745,755,740,745,0
215,SIDO,2023-07-13,745,745,750,720,725,-20
216,SIDO,2023-07-14,725,725,730,715,720,-5
217,SIDO,2023-07-17,720,725,735,720,720,0
218,SIDO,2023-07-18,720,725,730,710,715,-5
219,SIDO,2023-07-20,715,715,720,685,690,-25
220,SIDO,2023-07-21,690,690,700,690,700,10
221,SIDO,2023-07-24,700,700,700,695,700,0
222,SIDO,2023-07-25,700,700,700,690,695,-5
223,SIDO,2023-07-26,695,695,700,680,685,-10
224,SIDO,2023-07-27,685,685,685,650,650,-35
225,SIDO,2023-07-28,650,650,650,635,640,-10
226,SIDO,2023-07-31,640,640,660,635,640,0
227,SIDO,2023-08-01,640,640,655,640,640,0
228,SIDO,2023-08-02,640,640,645,610,615,-25
229,SIDO,2023-08-03,615,615,650,615,640,25
230,SIDO,2023-08-04,640,640,655,635,640,0
231,SIDO,2023-08-07,640,645,655,640,650,10
232,SIDO,2023-08-08,650,650,660,650,655,5
233,SIDO,2023-08-09,655,655,655,640,640,-15
234,SIDO,2023-08-10,640,640,650,640,640,0
235,SIDO,2023-08-11,640,640,650,640,640,0
236,SIDO,2023-08-14,640,640,650,640,645,5
237,SIDO,2023-08-15,645,645,655,640,645,0
238,SIDO,2023-08-16,645,645,650,640,640,-5
239,SIDO,2023-08-18,640,640,655,640,650,10
240,SIDO,2023-08-21,650,650,655,645,645,-5
241,SIDO,2023-08-22,645,645,655,645,650,5
242,SIDO,2023-08-23,650,650,655,645,650,0
243,SIDO,2023-08-24,650,650,655,635,635,-15
244,SIDO,2023-08-25,635,635,645,635,640,5
245,SIDO,2023-08-28,640,640,645,635,640,0
246,SIDO,2023-08-29,640,640,645,630,635,-5
247,SIDO,2023-08-30,635,635,635,620,620,-15
248,SIDO,2023-08-31,620,625,625,615,620,0
249,SIDO,2023-09-01,620,620,625,610,615,-5
250,SIDO,2023-09-04,615,620,630,615,615,0
251,SIDO,2023-09-05,615,615,620,610,615,0
252,SIDO,2023-09-06,615,615,625,615,620,5
253,SIDO,2023-09-07,620,620,625,615,620,0
254,SIDO,2023-09-08,620,620,620,600,600,-20
255,SIDO,2023-09-11,600,600,615,600,605,5
256,SIDO,2023-09-12,605,605,615,605,610,5
257,SIDO,2023-09-13,610,610,610,600,605,-5
258,SIDO,2023-09-14,605,605,610,600,605,0
259,SIDO,2023-09-15,605,605,610,590,590,-15
260,SIDO,2023-09-18,590,590,600,590,595,5
261,SIDO,2023-09-19,595,590,595,585,590,-5
262,SIDO,2023-09-20,590,590,590,580,585,-5
263,SIDO,2023-09-21,585,585,595,580,590,5
264,SIDO,2023-09-22,590,590,610,585,600,10
265,SIDO,2023-09-25,600,600,610,595,595,-5
266,SIDO,2023-09-26,595,600,600,590,590,-5
267,SIDO,2023-09-27,590,590,595,580,585,-5
268,SIDO,2023-09-29,585,585,595,580,590,5
269,SIDO,2023-10-02,590,590,590,580,585,-5
270,SIDO,2023-10-03,585,585,590,585,585,0
271,SIDO,2023-10-04,585,585,590,560,560,-25
272,SIDO,2023-10-05,560,565,615,565,605,45
273,SIDO,2023-10-06,605,605,610,580,595,-10
274,SIDO,2023-10-09,595,595,605,590,590,-5
275,SIDO,2023-10-10,590,595,600,585,590,0
276,SIDO,2023-10-11,590,590,595,580,585,-5
277,SIDO,2023-10-12,585,585,600,585,590,5
278,SIDO,2023-10-13,590,590,595,575,580,-10
279,SIDO,2023-10-16,580,580,590,570,575,-5
280,SIDO,2023-10-17,575,575,585,575,580,5
281,SIDO,2023-10-18,580,580,585,575,580,0
282,SIDO,2023-10-19,580,580,580,570,570,-10
283,SIDO,2023-10-20,570,570,575,560,575,5
284,SIDO,2023-10-23,575,575,575,565,570,-5
285,SIDO,2023-10-24,570,575,590,570,590,20
286,SIDO,2023-10-25,590,590,600,590,590,0
287,SIDO,2023-10-26,590,590,590,575,575,-15
288,SIDO,2023-10-27,575,575,585,565,575,0
289,SIDO,2023-10-30,575,575,580,510,515,-60
290,SIDO,2023-10-31,515,515,520,505,510,-5
291,SIDO,2023-11-01,510,505,505,484,486,-24
292,SIDO,2023-11-02,486,486,505,486,492,6
293,SIDO,2023-11-03,492,494,500,478,496,4
294,SIDO,2023-11-06,496,496,505,496,500,4
295,SIDO,2023-11-07,500,505,505,496,496,-4
296,SIDO,2023-11-08,496,496,498,484,486,-10
297,SIDO,2023-11-09,486,488,494,486,494,8
298,SIDO,2023-11-10,494,494,498,494,496,2
299,SIDO,2023-11-13,496,498,500,496,500,4
300,SIDO,2023-11-14,500,500,500,492,498,-2
301,SIDO,2023-11-15,498,500,505,496,498,0
302,SIDO,2023-11-16,498,498,500,498,498,0
303,SIDO,2023-11-17,498,500,500,494,498,0
304,SIDO,2023-11-20,498,500,505,498,505,7
305,SIDO,2023-11-21,505,500,505,498,500,-5
306,SIDO,2023-11-22,500,500,500,496,498,-2
307,SIDO,2023-11-23,498,498,500,498,498,0
308,SIDO,2023-11-24,498,498,500,498,498,0
309,SIDO,2023-11-27,498,500,505,498,500,2
310,SIDO,2023-11-28,500,500,505,496,498,-2
311,SIDO,2023-11-29,498,500,500,496,498,0
312,SIDO,2023-11-30,498,500,505,498,500,2
313,SIDO,2023-12-01,500,500,500,496,498,-2
314,SIDO,2023-12-04,498,500,545,496,530,32
315,SIDO,2023-12-05,530,535,575,530,560,30
316,SIDO,2023-12-06,560,560,575,560,570,10
317,SIDO,2023-12-07,570,570,570,540,550,-20
318,SIDO,2023-12-08,550,555,555,535,540,-10
319,SIDO,2023-12-11,540,540,555,530,530,-10
320,SIDO,2023-12-12,530,530,540,520,530,0
321,SIDO,2023-12-13,530,530,565,525,550,20
322,SIDO,2023-12-14,550,550,565,550,555,5
323,SIDO,2023-12-15,555,560,560,540,545,-10
324,SIDO,2023-12-18,545,550,550,540,545,0
325,SIDO,2023-12-19,545,545,560,545,555,10
326,SIDO,2023-12-20,555,555,560,540,545,-10
327,SIDO,2023-12-21,545,545,550,530,535,-10
328,SIDO,2023-12-22,535,535,545,535,540,5
329,SIDO,2023-12-27,540,540,545,525,525,-15
330,SIDO,2023-12-28,525,530,535,525,530,5
331,SIDO,2023-12-29,530,530,530,520,525,-5
332,SIDO,2022-01-03,865,0,875,865,870,5
333,SIDO,2022-01-04,870,0,910,865,900,30
334,SIDO,2022-01-05,900,0,915,900,910,10
335,SIDO,2022-01-06,910,0,930,910,925,15
336,SIDO,2022-01-07,925,0,970,925,950,25
337,SIDO,2022-01-10,950,0,975,945,970,20
338,SIDO,2022-01-11,970,0,985,940,955,-15
339,SIDO,2022-01-12,955,0,960,940,950,-5
340,SIDO,2022-01-13,950,0,960,935,935,-15
341,SIDO,2022-01-14,935,0,960,935,935,0
342,SIDO,2022-01-17,935,0,950,935,945,10
343,SIDO,2022-01-18,945,0,955,935,950,5
344,SIDO,2022-01-19,950,0,965,945,950,0
345,SIDO,2022-01-20,950,0,955,940,940,-10
346,SIDO,2022-01-21,940,0,945,935,935,-5
347,SIDO,2022-01-24,935,0,945,930,935,0
348,SIDO,2022-01-25,935,0,940,925,940,5
349,SIDO,2022-01-26,940,0,950,930,940,0
350,SIDO,2022-01-27,940,0,945,920,925,-15
351,SIDO,2022-01-28,925,0,940,915,925,0
352,SIDO,2022-01-31,925,0,940,925,930,5
353,SIDO,2022-02-02,930,0,940,930,940,10
354,SIDO,2022-02-03,940,0,940,930,935,-5
355,SIDO,2022-02-04,935,0,940,920,920,-15
356,SIDO,2022-02-07,920,0,940,920,925,5
357,SIDO,2022-02-08,925,0,1000,915,925,0
358,SIDO,2022-02-09,925,0,940,925,935,10
359,SIDO,2022-02-10,935,0,950,925,935,0
360,SIDO,2022-02-11,935,0,945,930,945,10
361,SIDO,2022-02-14,945,0,960,930,955,10
362,SIDO,2022-02-15,955,0,960,940,945,-10
363,SIDO,2022-02-16,945,0,955,945,945,0
364,SIDO,2022-02-17,945,0,960,945,955,10
365,SIDO,2022-02-18,955,0,980,955,955,0
366,SIDO,2022-02-21,955,0,970,950,955,0
367,SIDO,2022-02-22,955,0,965,950,955,0
368,SIDO,2022-02-23,955,0,975,945,950,-5
369,SIDO,2022-02-24,950,0,970,945,955,5
370,SIDO,2022-02-25,955,0,975,945,975,20
371,SIDO,2022-03-01,975,0,980,965,970,-5
372,SIDO,2022-03-02,970,0,980,965,965,-5
373,SIDO,2022-03-04,965,0,980,950,970,5
374,SIDO,2022-03-07,970,0,985,955,965,-5
375,SIDO,2022-03-08,965,0,980,950,950,-15
376,SIDO,2022-03-09,950,0,960,935,935,-15
377,SIDO,2022-03-10,935,0,970,940,970,35
378,SIDO,2022-03-11,970,0,1000,965,1000,30
379,SIDO,2022-03-14,1000,0,1035,1000,1020,20
380,SIDO,2022-03-15,1020,0,1035,1020,1030,10
381,SIDO,2022-03-16,1030,0,1070,1030,1040,10
382,SIDO,2022-03-17,1040,0,1070,1040,1050,10
383,SIDO,2022-03-18,1050,0,1060,1030,1040,-10
384,SIDO,2022-03-21,1040,0,1050,1020,1020,-20
385,SIDO,2022-03-22,1020,0,1040,1020,1040,20
386,SIDO,2022-03-23,1040,0,1050,1025,1045,5
387,SIDO,2022-03-24,1045,0,1050,1030,1030,-15
388,SIDO,2022-03-25,1030,0,1040,1025,1035,5
389,SIDO,2022-03-28,1035,0,1035,1010,1020,-15
390,SIDO,2022-03-29,1020,0,1020,995,1000,-20
391,SIDO,2022-03-30,1000,0,1015,985,995,-5
392,SIDO,2022-03-31,995,0,1025,990,1020,25
393,SIDO,2022-04-01,1020,0,1025,950,955,-65
394,SIDO,2022-04-04,955,0,970,940,965,10
395,SIDO,2022-04-05,965,0,975,955,960,-5
396,SIDO,2022-04-06,960,0,975,940,940,-20
397,SIDO,2022-04-07,940,0,950,930,940,0
398,SIDO,2022-04-08,940,0,940,920,935,-5
399,SIDO,2022-04-11,935,0,940,900,905,-30
400,SIDO,2022-04-12,905,0,935,900,905,0
401,SIDO,2022-04-13,905,0,925,905,905,0
402,SIDO,2022-04-14,905,0,925,905,910,5
403,SIDO,2022-04-18,910,0,920,910,915,5
404,SIDO,2022-04-19,915,0,930,910,930,15
405,SIDO,2022-04-20,930,0,940,925,940,10
406,SIDO,2022-04-21,940,0,950,930,930,-10
407,SIDO,2022-04-22,930,0,940,925,935,5
408,SIDO,2022-04-25,935,0,940,915,920,-15
409,SIDO,2022-04-26,920,0,940,910,940,20
410,SIDO,2022-04-27,940,0,950,930,940,0
411,SIDO,2022-04-28,940,0,945,935,940,0
412,SIDO,2022-05-09,940,0,950,920,940,0
413,SIDO,2022-05-10,940,0,945,910,935,-5
414,SIDO,2022-05-11,935,0,940,920,920,-15
415,SIDO,2022-05-12,920,0,930,900,900,-20
416,SIDO,2022-05-13,900,0,925,900,925,25
417,SIDO,2022-05-17,925,0,930,920,925,0
418,SIDO,2022-05-18,925,0,940,920,930,5
419,SIDO,2022-05-19,930,0,965,920,965,35
420,SIDO,2022-05-20,965,0,970,950,960,-5
421,SIDO,2022-05-23,960,0,970,945,960,0
422,SIDO,2022-05-24,960,0,965,940,945,-15
423,SIDO,2022-05-25,945,0,960,945,960,15
424,SIDO,2022-05-27,960,0,970,950,965,5
425,SIDO,2022-05-30,965,0,970,965,965,0
426,SIDO,2022-05-31,965,0,1020,965,1020,55
427,SIDO,2022-06-02,1020,0,1020,975,1000,-20
428,SIDO,2022-06-03,1000,0,1010,985,985,-15
429,SIDO,2022-06-06,985,0,995,980,990,5
430,SIDO,2022-06-07,990,0,995,980,985,-5
431,SIDO,2022-06-08,985,0,995,975,985,0
432,SIDO,2022-06-09,985,0,985,975,975,-10
433,SIDO,2022-06-10,975,0,980,965,975,0
434,SIDO,2022-06-13,975,0,990,945,960,-15
435,SIDO,2022-06-14,960,0,960,945,945,-15
436,SIDO,2022-06-15,945,0,955,935,950,5
437,SIDO,2022-06-16,950,0,970,945,950,0
438,SIDO,2022-06-17,950,0,960,945,960,10
439,SIDO,2022-06-20,960,0,970,945,965,5
440,SIDO,2022-06-21,965,0,970,945,955,-10
441,SIDO,2022-06-22,955,0,975,955,975,20
442,SIDO,2022-06-23,975,0,985,970,985,10
443,SIDO,2022-06-24,985,0,1000,980,990,5
444,SIDO,2022-06-27,990,0,1005,980,985,-5
445,SIDO,2022-06-28,985,0,995,985,995,10
446,SIDO,2022-06-29,995,0,1010,980,995,0
447,SIDO,2022-06-30,995,0,1000,985,1000,5
448,SIDO,2022-07-01,1000,0,1000,975,990,-10
449,SIDO,2022-07-04,990,0,990,955,985,-5
450,SIDO,2022-07-05,985,0,990,975,975,-10
451,SIDO,2022-07-06,975,0,990,975,980,5
452,SIDO,2022-07-07,980,0,990,975,985,5
453,SIDO,2022-07-08,985,0,985,970,970,-15
454,SIDO,2022-07-11,970,0,990,970,980,10
455,SIDO,2022-07-12,980,0,985,965,980,0
456,SIDO,2022-07-13,980,0,980,950,955,-25
457,SIDO,2022-07-14,955,0,975,950,970,15
458,SIDO,2022-07-15,970,0,975,960,965,-5
459,SIDO,2022-07-18,965,0,970,950,960,-5
460,SIDO,2022-07-19,960,0,960,955,960,0
461,SIDO,2022-07-20,960,0,990,960,970,10
462,SIDO,2022-07-21,970,0,990,965,985,15
463,SIDO,2022-07-22,985,0,990,970,975,-10
464,SIDO,2022-07-25,975,0,985,970,980,5
465,SIDO,2022-07-26,980,0,985,970,970,-10
466,SIDO,2022-07-27,970,0,990,970,975,5
467,SIDO,2022-07-28,975,0,990,970,970,-5
468,SIDO,2022-07-29,970,0,975,905,905,-65
469,SIDO,2022-08-01,905,0,905,845,845,-60
470,SIDO,2022-08-02,845,0,835,790,790,-55
471,SIDO,2022-08-03,790,0,820,740,765,-25
472,SIDO,2022-08-04,765,0,795,765,770,5
473,SIDO,2022-08-05,770,0,780,755,760,-10
474,SIDO,2022-08-08,760,0,775,730,750,-10
475,SIDO,2022-08-09,750,0,780,750,775,25
476,SIDO,2022-08-10,775,0,780,770,770,-5
477,SIDO,2022-08-11,770,0,780,765,765,-5
478,SIDO,2022-08-12,765,0,775,765,770,5
479,SIDO,2022-08-15,770,0,785,770,775,5
480,SIDO,2022-08-16,775,0,780,770,770,-5
481,SIDO,2022-08-18,770,0,780,765,775,5
482,SIDO,2022-08-19,775,0,780,770,770,-5
483,SIDO,2022-08-22,770,0,775,750,750,-20
484,SIDO,2022-08-23,750,0,780,745,750,0
485,SIDO,2022-08-24,750,0,755,750,750,0
486,SIDO,2022-08-25,750,0,755,735,735,-15
487,SIDO,2022-08-26,735,0,740,715,715,-20
488,SIDO,2022-08-29,715,0,720,705,705,-10
489,SIDO,2022-08-30,705,0,735,705,720,15
490,SIDO,2022-08-31,720,0,725,710,710,-10
491,SIDO,2022-09-01,710,0,715,705,705,-5
492,SIDO,2022-09-02,705,0,720,705,715,10
493,SIDO,2022-09-05,715,0,720,705,715,0
494,SIDO,2022-09-06,715,0,720,710,715,0
495,SIDO,2022-09-07,715,0,725,710,715,0
496,SIDO,2022-09-08,715,0,720,710,720,5
497,SIDO,2022-09-09,720,0,725,700,705,-15
498,SIDO,2022-09-12,705,0,715,700,710,5
499,SIDO,2022-09-13,710,0,720,710,715,5
500,SIDO,2022-09-14,715,0,715,705,710,-5
501,SIDO,2022-09-15,710,0,715,705,710,0
502,SIDO,2022-09-16,710,0,725,710,710,0
503,SIDO,2022-09-19,710,0,745,710,745,35
504,SIDO,2022-09-20,745,0,760,720,720,-25
505,SIDO,2022-09-21,720,0,735,715,730,10
506,SIDO,2022-09-22,730,0,735,720,720,-10
507,SIDO,2022-09-23,720,0,725,715,720,0
508,SIDO,2022-09-26,720,0,725,710,720,0
509,SIDO,2022-09-27,720,0,720,710,715,-5
510,SIDO,2022-09-28,715,0,720,710,710,-5
511,SIDO,2022-09-29,710,0,715,710,715,5
512,SIDO,2022-09-30,715,0,715,700,710,-5
513,SIDO,2022-10-03,710,0,710,705,705,-5
514,SIDO,2022-10-04,705,0,710,700,705,0
515,SIDO,2022-10-05,705,0,710,700,700,-5
516,SIDO,2022-10-06,700,0,710,700,705,5
517,SIDO,2022-10-07,705,0,720,705,715,10
518,SIDO,2022-10-10,715,0,715,700,705,-10
519,SIDO,2022-10-11,705,0,710,695,700,-5
520,SIDO,2022-10-12,700,0,700,655,660,-40
521,SIDO,2022-10-13,660,0,665,640,655,-5
522,SIDO,2022-10-14,655,0,665,650,655,0
523,SIDO,2022-10-17,655,0,655,630,635,-20
524,SIDO,2022-10-18,635,0,655,635,650,15
525,SIDO,2022-10-19,650,0,685,645,665,15
526,SIDO,2022-10-20,665,0,685,655,655,-10
527,SIDO,2022-10-21,655,0,695,650,675,20
528,SIDO,2022-10-24,675,0,715,675,710,35
529,SIDO,2022-10-25,710,0,725,700,705,-5
530,SIDO,2022-10-26,705,0,720,700,715,10
531,SIDO,2022-10-27,715,0,745,715,740,25
532,SIDO,2022-10-28,740,0,750,730,740,0
533,SIDO,2022-10-31,740,0,745,730,740,0
534,SIDO,2022-11-01,740,0,755,740,750,10
535,SIDO,2022-11-02,750,0,755,740,745,-5
536,SIDO,2022-11-03,745,0,745,730,740,-5
537,SIDO,2022-11-04,740,0,740,730,740,0
538,SIDO,2022-11-07,740,0,745,735,745,5
539,SIDO,2022-11-08,745,0,745,725,730,-15
540,SIDO,2022-11-09,730,0,735,725,730,0
541,SIDO,2022-11-10,730,0,740,720,740,10
542,SIDO,2022-11-11,740,0,745,730,740,0
543,SIDO,2022-11-14,740,0,765,735,765,25
544,SIDO,2022-11-15,765,0,775,760,770,5
545,SIDO,2022-11-16,770,0,780,760,765,-5
546,SIDO,2022-11-17,765,0,775,720,760,-5
547,SIDO,2022-11-18,760,0,765,755,755,-5
548,SIDO,2022-11-21,755,0,775,755,770,15
549,SIDO,2022-11-22,770,0,775,750,770,0
550,SIDO,2022-11-23,770,0,775,765,765,-5
551,SIDO,2022-11-24,765,0,770,760,765,0
552,SIDO,2022-11-25,765,0,775,765,775,10
553,SIDO,2022-11-28,775,0,775,765,775,0
554,SIDO,2022-11-29,775,0,780,770,775,0
555,SIDO,2022-11-30,775,0,790,770,785,10
556,SIDO,2022-12-01,785,0,790,780,790,5
557,SIDO,2022-12-02,790,0,790,780,785,-5
558,SIDO,2022-12-05,785,0,790,755,770,-15
559,SIDO,2022-12-06,770,0,770,740,750,-20
560,SIDO,2022-12-07,750,0,755,730,755,5
561,SIDO,2022-12-08,755,0,770,750,760,5
562,SIDO,2022-12-09,760,0,770,750,765,5
563,SIDO,2022-12-12,765,0,775,760,770,5
564,SIDO,2022-12-13,770,0,770,755,760,-10
565,SIDO,2022-12-14,760,0,770,760,770,10
566,SIDO,2022-12-15,770,0,770,760,760,-10
567,SIDO,2022-12-16,760,0,765,740,755,-5
568,SIDO,2022-12-19,755,0,765,740,740,-15
569,SIDO,2022-12-20,740,0,755,735,755,15
570,SIDO,2022-12-21,755,0,765,755,765,10
571,SIDO,2022-12-22,765,0,785,755,770,5
572,SIDO,2022-12-23,770,0,770,750,750,-20
573,SIDO,2022-12-26,750,0,760,750,755,5
574,SIDO,2022-12-27,755,0,760,750,755,0
575,SIDO,2022-12-28,755,0,760,750,755,0
576,SIDO,2022-12-29,755,0,760,750,755,0
577,SIDO,2022-12-30,755,0,760,750,755,0
