,stock_code,date,prev,open,high,low,close,change
0,HRUM,2024-01-02,1335,1335,1380,1330,1380,45
1,HRUM,2024-01-03,1380,1355,1380,1340,1355,-25
2,HRUM,2024-01-04,1355,1360,1410,1360,1385,30
3,HRUM,2024-01-05,1385,1385,1405,1370,1375,-10
4,HRUM,2024-01-08,1375,1380,1410,1375,1380,5
5,HRUM,2024-01-09,1380,1380,1385,1340,1345,-35
6,HRUM,2024-01-10,1345,1360,1380,1355,1360,15
7,HRUM,2024-01-10,1345,1360,1380,1355,1360,15
8,HRUM,2024-01-11,1360,1350,1360,1340,1345,-15
9,HRUM,2024-01-12,1345,1345,1360,1330,1350,5
10,HRUM,2024-01-15,1350,1360,1375,1335,1340,-10
11,HRUM,2024-01-16,1340,1340,1350,1330,1335,-5
12,HRUM,2024-01-17,1335,1340,1345,1310,1325,-10
13,HRUM,2024-01-18,1325,1320,1330,1310,1310,-15
14,HRUM,2024-01-19,1310,1315,1330,1300,1315,5
15,HRUM,2024-01-22,1315,1315,1320,1275,1285,-30
16,HRUM,2024-01-23,1285,1285,1290,1225,1235,-50
17,HRUM,2024-01-24,1235,1235,1240,1135,1150,-85
18,HRUM,2024-01-25,1150,1150,1215,1150,1180,30
19,HRUM,2024-01-26,1180,1180,1185,1150,1155,-25
20,HRUM,2024-01-29,1155,1155,1170,1120,1150,-5
21,HRUM,2024-01-30,1150,1160,1270,1155,1200,50
22,HRUM,2024-01-31,1200,1220,1230,1160,1175,-25
23,HRUM,2024-02-01,1175,1175,1205,1160,1190,15
24,HRUM,2024-02-02,1190,1195,1195,1155,1180,-10
25,HRUM,2024-02-05,1180,1180,1185,1155,1155,-25
26,HRUM,2024-02-06,1155,1160,1175,1125,1140,-15
27,HRUM,2024-02-07,1140,1140,1140,1090,1105,-35
28,HRUM,2024-02-12,1105,1105,1135,1075,1115,10
29,HRUM,2024-02-13,1115,1130,1150,1110,1135,20
30,HRUM,2024-02-15,1135,1165,1220,1160,1190,55
31,HRUM,2024-02-16,1190,1190,1190,1155,1175,-15
32,HRUM,2024-02-19,1175,1175,1180,1145,1175,0
33,HRUM,2024-02-20,1175,1175,1185,1160,1175,0
34,HRUM,2024-02-21,1175,1175,1205,1155,1155,-20
35,HRUM,2024-02-22,1155,1160,1215,1155,1210,55
36,HRUM,2024-02-23,1210,1230,1235,1205,1225,15
37,HRUM,2024-02-26,1225,1225,1230,1200,1220,-5
38,HRUM,2024-02-27,1220,1235,1240,1190,1200,-20
39,HRUM,2024-02-28,1200,1220,1235,1205,1230,30
40,HRUM,2024-02-29,1230,1240,1265,1215,1250,20
41,HRUM,2024-03-01,1250,1255,1280,1235,1260,10
42,HRUM,2024-03-04,1260,1260,1270,1245,1260,0
43,HRUM,2024-03-05,1260,1260,1285,1240,1240,-20
44,HRUM,2024-03-06,1240,1240,1275,1210,1265,25
45,HRUM,2024-03-07,1265,1265,1335,1245,1320,55
46,HRUM,2024-03-08,1320,1325,1335,1275,1295,-25
47,HRUM,2024-03-13,1295,1300,1375,1290,1360,65
48,HRUM,2024-03-14,1360,1365,1390,1345,1380,20
49,HRUM,2024-03-15,1380,1390,1420,1370,1410,30
50,HRUM,2024-03-18,1410,1410,1445,1370,1440,30
51,HRUM,2024-03-19,1440,1440,1445,1390,1395,-45
52,HRUM,2024-03-20,1395,1395,1415,1345,1365,-30
53,HRUM,2024-03-21,1365,1365,1395,1355,1390,25
54,HRUM,2024-03-22,1390,1390,1395,1345,1385,-5
55,HRUM,2024-03-25,1385,1385,1385,1345,1355,-30
56,HRUM,2024-03-26,1355,1360,1365,1325,1335,-20
57,HRUM,2024-03-27,1335,1340,1390,1330,1380,45
58,HRUM,2024-03-28,1380,1390,1400,1335,1350,-30
59,HRUM,2024-04-01,1350,1350,1365,1330,1355,5
60,HRUM,2024-04-02,1355,1355,1435,1355,1425,70
61,HRUM,2024-04-03,1425,1430,1540,1430,1470,45
62,HRUM,2024-04-04,1470,1475,1510,1445,1455,-15
63,HRUM,2024-04-05,1455,1460,1470,1415,1440,-15
64,HRUM,2024-04-16,1440,1450,1580,1430,1565,125
65,HRUM,2024-04-17,1565,1565,1580,1535,1565,0
66,HRUM,2024-04-18,1565,1570,1590,1345,1370,-195
67,HRUM,2024-04-19,1370,1375,1395,1270,1290,-80
68,HRUM,2024-04-22,1290,1300,1360,1290,1335,45
69,HRUM,2024-04-23,1335,1335,1375,1335,1355,20
70,HRUM,2024-04-24,1355,1365,1375,1300,1300,-55
71,HRUM,2024-04-25,1300,1300,1325,1275,1320,20
72,HRUM,2024-04-26,1320,1320,1325,1285,1300,-20
73,HRUM,2024-04-29,1300,1300,1395,1290,1390,90
74,HRUM,2024-04-30,1390,1390,1420,1375,1410,20
75,HRUM,2024-05-02,1410,1425,1425,1350,1350,-60
76,HRUM,2024-05-03,1350,1365,1395,1345,1375,25
77,HRUM,2024-05-06,1375,1390,1415,1370,1385,10
78,HRUM,2024-05-07,1385,1390,1405,1380,1400,15
79,HRUM,2024-05-08,1400,1405,1410,1345,1345,-55
80,HRUM,2024-05-13,1345,1355,1360,1320,1345,0
81,HRUM,2024-05-14,1345,1345,1360,1330,1345,0
82,HRUM,2024-05-15,1345,1345,1345,1295,1305,-40
83,HRUM,2024-05-16,1305,1315,1320,1285,1300,-5
84,HRUM,2024-05-17,1300,1310,1400,1310,1395,95
85,HRUM,2024-05-20,1395,1415,1445,1395,1410,15
86,HRUM,2024-05-21,1410,1410,1415,1355,1365,-45
87,HRUM,2024-05-22,1365,1365,1365,1325,1330,-35
88,HRUM,2024-05-27,1330,1340,1345,1305,1320,-10
89,HRUM,2024-05-28,1320,1320,1390,1320,1385,65
90,HRUM,2024-05-29,1385,1390,1410,1370,1385,0
91,HRUM,2024-05-30,1385,1400,1400,1335,1365,-20
92,HRUM,2024-05-31,1365,1365,1410,1340,1400,35
93,HRUM,2023-01-02,1620,1620,1635,1610,1620,0
94,HRUM,2023-01-03,1620,1630,1660,1620,1645,25
95,HRUM,2023-01-04,1645,1660,1665,1620,1625,-20
96,HRUM,2023-01-05,1625,1605,1610,1520,1530,-95
97,HRUM,2023-01-06,1530,1500,1555,1480,1520,-10
98,HRUM,2023-01-09,1520,1540,1585,1515,1575,55
99,HRUM,2023-01-10,1575,1565,1635,1560,1630,55
100,HRUM,2023-01-11,1630,1640,1650,1595,1640,10
101,HRUM,2023-01-12,1640,1620,1640,1605,1615,-25
102,HRUM,2023-01-13,1615,1625,1685,1625,1670,55
103,HRUM,2023-01-16,1670,1685,1700,1660,1695,25
104,HRUM,2023-01-17,1695,1695,1740,1685,1730,35
105,HRUM,2023-01-18,1730,1730,1750,1705,1725,-5
106,HRUM,2023-01-19,1725,1730,1755,1730,1745,20
107,HRUM,2023-01-20,1745,1755,1785,1755,1755,10
108,HRUM,2023-01-24,1755,1740,1775,1715,1725,-30
109,HRUM,2023-01-25,1725,1725,1740,1710,1725,0
110,HRUM,2023-01-26,1725,1725,1730,1680,1685,-40
111,HRUM,2023-01-27,1685,1685,1705,1675,1690,5
112,HRUM,2023-01-30,1690,1690,1710,1660,1695,5
113,HRUM,2023-01-31,1695,1695,1750,1690,1730,35
114,HRUM,2023-02-01,1730,1730,1760,1730,1745,15
115,HRUM,2023-02-02,1745,1745,1755,1690,1695,-50
116,HRUM,2023-02-03,1695,1700,1710,1645,1645,-50
117,HRUM,2023-02-06,1645,1630,1670,1610,1640,-5
118,HRUM,2023-02-07,1640,1685,1700,1660,1690,50
119,HRUM,2023-02-08,1690,1700,1705,1665,1695,5
120,HRUM,2023-02-09,1695,1670,1690,1665,1675,-20
121,HRUM,2023-02-10,1675,1660,1660,1575,1650,-25
122,HRUM,2023-02-13,1650,1665,1670,1615,1625,-25
123,HRUM,2023-02-14,1625,1620,1635,1595,1630,5
124,HRUM,2023-02-15,1630,1625,1655,1610,1640,10
125,HRUM,2023-02-16,1640,1650,1655,1605,1605,-35
126,HRUM,2023-02-17,1605,1605,1615,1565,1605,0
127,HRUM,2023-02-20,1605,1600,1625,1575,1615,10
128,HRUM,2023-02-21,1615,1615,1635,1585,1605,-10
129,HRUM,2023-02-22,1605,1625,1630,1575,1575,-30
130,HRUM,2023-02-23,1575,1575,1600,1575,1600,25
131,HRUM,2023-02-24,1600,1600,1610,1590,1590,-10
132,HRUM,2023-02-27,1590,1595,1615,1580,1590,0
133,HRUM,2023-02-28,1590,1600,1635,1595,1630,40
134,HRUM,2023-03-01,1630,1630,1660,1615,1655,25
135,HRUM,2023-03-02,1655,1665,1690,1650,1670,15
136,HRUM,2023-03-03,1670,1675,1695,1675,1690,20
137,HRUM,2023-03-06,1690,1690,1695,1650,1660,-30
138,HRUM,2023-03-07,1660,1660,1665,1625,1665,5
139,HRUM,2023-03-08,1665,1665,1665,1590,1630,-35
140,HRUM,2023-03-09,1630,1620,1630,1605,1610,-20
141,HRUM,2023-03-10,1610,1615,1645,1605,1635,25
142,HRUM,2023-03-13,1635,1635,1655,1620,1625,-10
143,HRUM,2023-03-14,1625,1625,1630,1550,1555,-70
144,HRUM,2023-03-15,1555,1560,1580,1500,1530,-25
145,HRUM,2023-03-16,1530,1525,1565,1425,1425,-105
146,HRUM,2023-03-17,1425,1430,1465,1430,1465,40
147,HRUM,2023-03-20,1465,1465,1470,1430,1440,-25
148,HRUM,2023-03-21,1440,1440,1465,1390,1390,-50
149,HRUM,2023-03-24,1390,1400,1410,1390,1390,0
150,HRUM,2023-03-27,1390,1415,1440,1400,1405,15
151,HRUM,2023-03-28,1405,1410,1470,1410,1460,55
152,HRUM,2023-03-29,1460,1485,1535,1485,1500,40
153,HRUM,2023-03-30,1500,1510,1515,1475,1475,-25
154,HRUM,2023-03-31,1475,1475,1495,1460,1460,-15
155,HRUM,2023-04-03,1460,1485,1520,1475,1485,25
156,HRUM,2023-04-04,1485,1510,1580,1510,1570,85
157,HRUM,2023-04-05,1570,1565,1570,1540,1550,-20
158,HRUM,2023-04-06,1550,1555,1595,1540,1585,35
159,HRUM,2023-04-10,1585,1585,1585,1520,1550,-35
160,HRUM,2023-04-11,1550,1555,1590,1545,1550,0
161,HRUM,2023-04-12,1550,1555,1575,1555,1565,15
162,HRUM,2023-04-13,1565,1585,1585,1535,1575,10
163,HRUM,2023-04-14,1575,1570,1570,1545,1545,-30
164,HRUM,2023-04-17,1545,1545,1550,1500,1500,-45
165,HRUM,2023-04-18,1500,1500,1530,1500,1510,10
166,HRUM,2023-04-26,1510,1510,1540,1510,1540,30
167,HRUM,2023-04-27,1540,1540,1545,1510,1510,-30
168,HRUM,2023-04-28,1510,1520,1530,1510,1510,0
169,HRUM,2023-05-02,1510,1515,1515,1455,1460,-50
170,HRUM,2023-05-03,1460,1460,1480,1425,1445,-15
171,HRUM,2023-05-04,1445,1440,1470,1425,1470,25
172,HRUM,2023-05-05,1470,1455,1465,1370,1380,-90
173,HRUM,2023-05-08,1380,1375,1430,1375,1420,40
174,HRUM,2023-05-09,1420,1425,1440,1415,1430,10
175,HRUM,2023-05-10,1430,1430,1445,1410,1410,-20
176,HRUM,2023-05-11,1410,1410,1415,1375,1375,-35
177,HRUM,2023-05-12,1375,1375,1375,1345,1350,-25
178,HRUM,2023-05-15,1350,1355,1365,1290,1295,-55
179,HRUM,2023-05-16,1295,1300,1305,1230,1250,-45
180,HRUM,2023-05-17,1250,1245,1290,1235,1280,30
181,HRUM,2023-05-19,1280,1295,1295,1215,1260,-20
182,HRUM,2023-05-22,1260,1260,1285,1255,1285,25
183,HRUM,2023-05-23,1285,1285,1310,1270,1300,15
184,HRUM,2023-05-24,1300,1300,1305,1285,1285,-15
185,HRUM,2023-05-25,1285,1280,1285,1250,1280,-5
186,HRUM,2023-05-26,1280,1280,1295,1260,1260,-20
187,HRUM,2023-05-29,1260,1265,1315,1205,1305,45
188,HRUM,2023-05-30,1305,1315,1365,1315,1360,55
189,HRUM,2023-05-31,1360,1365,1410,1340,1410,50
190,HRUM,2023-06-05,1410,1420,1440,1375,1440,30
191,HRUM,2023-06-06,1440,1445,1460,1425,1425,-15
192,HRUM,2023-06-07,1425,1420,1425,1375,1385,-40
193,HRUM,2023-06-08,1385,1400,1495,1400,1480,95
194,HRUM,2023-06-09,1480,1500,1500,1440,1455,-25
195,HRUM,2023-06-12,1455,1450,1485,1425,1485,30
196,HRUM,2023-06-13,1485,1475,1510,1450,1505,20
197,HRUM,2023-06-14,1505,1520,1525,1455,1470,-35
198,HRUM,2023-06-15,1470,1470,1485,1450,1460,-10
199,HRUM,2023-06-16,1460,1465,1480,1440,1460,0
200,HRUM,2023-06-19,1460,1460,1460,1400,1430,-30
201,HRUM,2023-06-20,1430,1430,1445,1395,1410,-20
202,HRUM,2023-06-21,1410,1415,1435,1400,1400,-10
203,HRUM,2023-06-22,1400,1400,1455,1400,1435,35
204,HRUM,2023-06-23,1435,1445,1465,1440,1445,10
205,HRUM,2023-06-26,1445,1450,1450,1410,1415,-30
206,HRUM,2023-06-27,1415,1415,1430,1410,1420,5
207,HRUM,2023-07-03,1420,1425,1505,1425,1495,75
208,HRUM,2023-07-04,1495,1500,1580,1500,1580,85
209,HRUM,2023-07-05,1580,1590,1635,1580,1590,10
210,HRUM,2023-07-06,1590,1600,1645,1600,1620,30
211,HRUM,2023-07-07,1620,1610,1610,1575,1585,-35
212,HRUM,2023-07-10,1585,1585,1635,1585,1605,20
213,HRUM,2023-07-11,1605,1615,1620,1585,1610,5
214,HRUM,2023-07-12,1610,1610,1610,1580,1595,-15
215,HRUM,2023-07-13,1595,1595,1610,1515,1525,-70
216,HRUM,2023-07-14,1525,1530,1555,1515,1525,0
217,HRUM,2023-07-17,1525,1530,1555,1525,1530,5
218,HRUM,2023-07-18,1530,1530,1530,1485,1490,-40
219,HRUM,2023-07-20,1490,1500,1540,1500,1540,50
220,HRUM,2023-07-21,1540,1550,1565,1540,1545,5
221,HRUM,2023-07-24,1545,1545,1565,1540,1555,10
222,HRUM,2023-07-25,1555,1565,1575,1540,1555,0
223,HRUM,2023-07-26,1555,1575,1710,1575,1705,150
224,HRUM,2023-07-27,1705,1705,1705,1650,1655,-50
225,HRUM,2023-07-28,1655,1655,1670,1610,1670,15
226,HRUM,2023-07-31,1670,1675,1695,1640,1660,-10
227,HRUM,2023-08-01,1660,1660,1690,1640,1685,25
228,HRUM,2023-08-02,1685,1685,1690,1625,1630,-55
229,HRUM,2023-08-03,1630,1630,1655,1620,1640,10
230,HRUM,2023-08-04,1640,1640,1665,1600,1605,-35
231,HRUM,2023-08-07,1605,1605,1650,1605,1630,25
232,HRUM,2023-08-08,1630,1645,1660,1630,1640,10
233,HRUM,2023-08-09,1640,1650,1650,1620,1620,-20
234,HRUM,2023-08-10,1620,1625,1645,1610,1635,15
235,HRUM,2023-08-11,1635,1635,1645,1605,1610,-25
236,HRUM,2023-08-14,1610,1610,1620,1565,1570,-40
237,HRUM,2023-08-15,1570,1570,1590,1550,1580,10
238,HRUM,2023-08-16,1580,1580,1590,1575,1585,5
239,HRUM,2023-08-18,1585,1580,1585,1560,1560,-25
240,HRUM,2023-08-21,1560,1565,1615,1565,1580,20
241,HRUM,2023-08-22,1580,1585,1655,1585,1640,60
242,HRUM,2023-08-23,1640,1650,1665,1635,1635,-5
243,HRUM,2023-08-24,1635,1635,1635,1610,1610,-25
244,HRUM,2023-08-25,1610,1600,1610,1570,1600,-10
245,HRUM,2023-08-28,1600,1600,1630,1595,1615,15
246,HRUM,2023-08-29,1615,1625,1635,1600,1600,-15
247,HRUM,2023-08-30,1600,1605,1610,1575,1585,-15
248,HRUM,2023-08-31,1585,1585,1590,1560,1560,-25
249,HRUM,2023-09-01,1560,1560,1585,1560,1575,15
250,HRUM,2023-09-04,1575,1585,1640,1580,1620,45
251,HRUM,2023-09-05,1620,1620,1635,1605,1605,-15
252,HRUM,2023-09-06,1605,1625,1700,1620,1695,90
253,HRUM,2023-09-07,1695,1685,1730,1660,1670,-25
254,HRUM,2023-09-08,1670,1670,1705,1655,1665,-5
255,HRUM,2023-09-11,1665,1665,1730,1610,1695,30
256,HRUM,2023-09-12,1695,1715,1765,1715,1735,40
257,HRUM,2023-09-13,1735,1735,1770,1730,1760,25
258,HRUM,2023-09-14,1760,1775,1845,1770,1800,40
259,HRUM,2023-09-15,1800,1800,1830,1775,1810,10
260,HRUM,2023-09-18,1810,1810,1820,1755,1780,-30
261,HRUM,2023-09-19,1780,1785,1860,1755,1845,65
262,HRUM,2023-09-20,1845,1860,1865,1805,1810,-35
263,HRUM,2023-09-21,1810,1810,1825,1780,1790,-20
264,HRUM,2023-09-22,1790,1780,1830,1775,1820,30
265,HRUM,2023-09-25,1820,1820,1870,1820,1820,0
266,HRUM,2023-09-26,1820,1825,1835,1715,1735,-85
267,HRUM,2023-09-27,1735,1745,1890,1745,1870,135
268,HRUM,2023-09-29,1870,1885,1945,1875,1885,15
269,HRUM,2023-10-02,1885,1895,1920,1815,1820,-65
270,HRUM,2023-10-03,1820,1820,1825,1735,1735,-85
271,HRUM,2023-10-04,1735,1725,1725,1635,1695,-40
272,HRUM,2023-10-05,1695,1685,1735,1625,1635,-60
273,HRUM,2023-10-06,1635,1630,1670,1610,1660,25
274,HRUM,2023-10-09,1660,1685,1705,1660,1680,20
275,HRUM,2023-10-10,1680,1710,1725,1670,1670,-10
276,HRUM,2023-10-11,1670,1680,1695,1655,1675,5
277,HRUM,2023-10-12,1675,1675,1675,1615,1620,-55
278,HRUM,2023-10-13,1620,1630,1695,1630,1670,50
279,HRUM,2023-10-16,1670,1680,1720,1680,1705,35
280,HRUM,2023-10-17,1705,1705,1715,1680,1700,-5
281,HRUM,2023-10-18,1700,1695,1725,1660,1725,25
282,HRUM,2023-10-19,1725,1725,1780,1720,1760,35
283,HRUM,2023-10-20,1760,1760,1775,1705,1760,0
284,HRUM,2023-10-23,1760,1760,1785,1700,1720,-40
285,HRUM,2023-10-24,1720,1720,1755,1710,1735,15
286,HRUM,2023-10-25,1735,1745,1780,1730,1760,25
287,HRUM,2023-10-26,1760,1760,1765,1715,1725,-35
288,HRUM,2023-10-27,1725,1730,1750,1730,1735,10
289,HRUM,2023-10-30,1735,1735,1760,1595,1600,-135
290,HRUM,2023-10-31,1600,1600,1625,1565,1615,15
291,HRUM,2023-11-01,1615,1600,1600,1505,1510,-105
292,HRUM,2023-11-02,1510,1510,1560,1510,1525,15
293,HRUM,2023-11-03,1525,1540,1560,1510,1515,-10
294,HRUM,2023-11-06,1515,1505,1545,1495,1515,0
295,HRUM,2023-11-07,1515,1515,1515,1460,1470,-45
296,HRUM,2023-11-08,1470,1470,1490,1455,1465,-5
297,HRUM,2023-11-09,1465,1480,1510,1465,1475,10
298,HRUM,2023-11-10,1475,1475,1475,1455,1460,-15
299,HRUM,2023-11-13,1460,1455,1460,1430,1445,-15
300,HRUM,2023-11-14,1445,1445,1470,1435,1470,25
301,HRUM,2023-11-15,1470,1470,1485,1450,1450,-20
302,HRUM,2023-11-16,1450,1455,1465,1435,1440,-10
303,HRUM,2023-11-17,1440,1430,1445,1405,1410,-30
304,HRUM,2023-11-20,1410,1415,1440,1410,1415,5
305,HRUM,2023-11-21,1415,1415,1425,1405,1420,5
306,HRUM,2023-11-22,1420,1420,1440,1410,1435,15
307,HRUM,2023-11-23,1435,1430,1435,1405,1415,-20
308,HRUM,2023-11-24,1415,1415,1460,1405,1440,25
309,HRUM,2023-11-27,1440,1445,1475,1435,1445,5
310,HRUM,2023-11-28,1445,1450,1470,1435,1455,10
311,HRUM,2023-11-29,1455,1425,1470,1420,1435,-20
312,HRUM,2023-11-30,1435,1435,1445,1380,1385,-50
313,HRUM,2023-12-01,1385,1385,1405,1385,1400,15
314,HRUM,2023-12-04,1400,1405,1415,1360,1365,-35
315,HRUM,2023-12-05,1365,1365,1370,1315,1320,-45
316,HRUM,2023-12-06,1320,1335,1335,1265,1270,-50
317,HRUM,2023-12-07,1270,1285,1300,1240,1265,-5
318,HRUM,2023-12-08,1265,1285,1345,1280,1330,65
319,HRUM,2023-12-11,1330,1350,1385,1330,1330,0
320,HRUM,2023-12-12,1330,1335,1345,1290,1310,-20
321,HRUM,2023-12-13,1310,1300,1300,1265,1280,-30
322,HRUM,2023-12-14,1280,1295,1335,1285,1320,40
323,HRUM,2023-12-15,1320,1335,1355,1320,1330,10
324,HRUM,2023-12-18,1330,1340,1360,1300,1305,-25
325,HRUM,2023-12-19,1305,1305,1315,1290,1305,0
326,HRUM,2023-12-20,1305,1315,1340,1305,1315,10
327,HRUM,2023-12-21,1315,1305,1325,1290,1310,-5
328,HRUM,2023-12-22,1310,1310,1320,1295,1305,-5
329,HRUM,2023-12-27,1305,1305,1360,1295,1350,45
330,HRUM,2023-12-28,1350,1370,1380,1335,1345,-5
331,HRUM,2023-12-29,1345,1345,1350,1325,1335,-10
332,HRUM,2022-01-03,10325,0,10650,9900,10500,175
333,HRUM,2022-01-04,10500,0,10700,10275,10500,0
334,HRUM,2022-01-05,10500,0,10975,10275,10300,-200
335,HRUM,2022-01-06,10300,0,10425,9600,10000,-300
336,HRUM,2022-01-07,10000,0,10700,10025,10625,625
337,HRUM,2022-01-10,10625,0,10875,10400,10750,125
338,HRUM,2022-01-11,10750,0,11500,10675,10900,150
339,HRUM,2022-01-12,10900,0,11675,11000,11600,700
340,HRUM,2022-01-13,11600,0,11850,10850,10900,-700
341,HRUM,2022-01-14,10900,0,11075,10725,11000,100
342,HRUM,2022-01-17,11000,0,11325,10650,10900,-100
343,HRUM,2022-01-18,10900,0,11100,10250,10500,-400
344,HRUM,2022-01-19,10500,0,11050,10400,10875,375
345,HRUM,2022-01-20,10875,0,11200,10900,11125,250
346,HRUM,2022-01-21,11125,0,11200,10875,10975,-150
347,HRUM,2022-01-24,10975,0,11100,10475,10700,-275
348,HRUM,2022-01-25,10700,0,10725,10075,10250,-450
349,HRUM,2022-01-26,10250,0,10800,10125,10675,425
350,HRUM,2022-01-27,10675,0,11075,10600,10925,250
351,HRUM,2022-01-28,10925,0,11200,10625,10925,0
352,HRUM,2022-01-31,10925,0,11175,10475,10625,-300
353,HRUM,2022-02-02,10625,10650,10850,10500,10650,25
354,HRUM,2022-02-03,10650,10650,10675,10275,10400,-250
355,HRUM,2022-02-04,10400,10400,10550,10375,10450,50
356,HRUM,2022-02-07,10450,10500,10625,10125,10150,-300
357,HRUM,2022-02-08,10150,10250,10525,10000,10475,325
358,HRUM,2022-02-09,10475,10475,10550,10175,10225,-250
359,HRUM,2022-02-10,10225,10325,10400,9750,10025,-200
360,HRUM,2022-02-11,10025,10025,10050,9850,9950,-75
361,HRUM,2022-02-14,9950,9900,10250,9750,10175,225
362,HRUM,2022-02-15,10175,10250,10575,10225,10500,325
363,HRUM,2022-02-16,10500,10700,10850,10625,10700,200
364,HRUM,2022-02-17,10700,10850,10850,10225,10600,-100
365,HRUM,2022-02-18,10600,10600,10750,10475,10650,50
366,HRUM,2022-02-21,10650,10775,11275,10750,11200,550
367,HRUM,2022-02-22,11200,11325,11800,11200,11325,125
368,HRUM,2022-02-23,11325,11600,11750,11350,11675,350
369,HRUM,2022-02-24,11675,11800,12475,11500,12400,725
370,HRUM,2022-02-25,12400,12600,12750,12050,12275,-125
371,HRUM,2022-03-01,12275,12400,12575,11750,11800,-475
372,HRUM,2022-03-02,11800,12150,12200,11300,11600,-200
373,HRUM,2022-03-04,11600,12000,12675,12000,12600,1000
374,HRUM,2022-03-07,12600,13050,13900,13050,13750,1150
375,HRUM,2022-03-08,13750,14300,14750,12800,12800,-950
376,HRUM,2022-03-09,12800,11925,12000,11925,11925,-875
377,HRUM,2022-03-10,11925,11300,11675,11100,11400,-525
378,HRUM,2022-03-11,11400,11400,11775,11100,11125,-275
379,HRUM,2022-03-14,11125,11150,11525,10350,10400,-725
380,HRUM,2022-03-15,10400,10500,10850,10150,10600,200
381,HRUM,2022-03-16,10600,10800,11000,10400,10975,375
382,HRUM,2022-03-17,10975,11050,11075,10500,10500,-475
383,HRUM,2022-03-18,10500,10725,10900,10500,10500,0
384,HRUM,2022-03-21,10500,10700,10950,10350,10900,400
385,HRUM,2022-03-22,10900,10950,11325,10850,11300,400
386,HRUM,2022-03-23,11300,11500,11500,10925,11100,-200
387,HRUM,2022-03-24,11100,11350,11525,11150,11400,300
388,HRUM,2022-03-25,11400,11625,11850,11225,11800,400
389,HRUM,2022-03-28,11800,11900,11925,11400,11400,-400
390,HRUM,2022-03-29,11400,11400,11600,10825,10975,-425
391,HRUM,2022-03-30,10975,11025,11025,10525,10600,-375
392,HRUM,2022-03-31,10600,10800,10800,10425,10700,100
393,HRUM,2022-04-01,10700,10800,10900,10475,10550,-150
394,HRUM,2022-04-04,10550,10700,11750,10575,11700,1150
395,HRUM,2022-04-05,11700,11900,12150,11500,12025,325
396,HRUM,2022-04-06,12025,12100,12625,12050,12475,450
397,HRUM,2022-04-07,12475,12550,12850,12150,12400,-75
398,HRUM,2022-04-08,12400,12550,13425,12475,12900,500
399,HRUM,2022-04-11,12900,12900,13350,12675,12700,-200
400,HRUM,2022-04-12,12700,12625,13350,12250,13200,500
401,HRUM,2022-04-13,13200,13500,13950,13375,13550,350
402,HRUM,2022-04-14,13550,13625,13700,13450,13600,50
403,HRUM,2022-04-18,13600,13725,14125,13675,14075,475
404,HRUM,2022-04-19,14075,14075,14200,13675,13750,-325
405,HRUM,2022-04-20,13750,14000,14300,13650,13850,100
406,HRUM,2022-04-21,13850,13900,13900,12900,12900,-950
407,HRUM,2022-04-22,12900,12800,12925,12375,12575,-325
408,HRUM,2022-04-25,12575,12425,12450,11925,11925,-650
409,HRUM,2022-04-26,11925,11925,12150,11100,11100,-825
410,HRUM,2022-04-27,11100,11100,11625,10600,11500,400
411,HRUM,2022-04-28,11500,11725,11850,11275,11525,25
412,HRUM,2022-05-09,11525,11750,11775,10725,11000,-525
413,HRUM,2022-05-10,11000,10500,10550,10250,10250,-750
414,HRUM,2022-05-11,10250,10375,10775,10150,10350,100
415,HRUM,2022-05-12,10350,10350,10500,9850,10000,-350
416,HRUM,2022-05-13,10000,10300,10725,9950,10525,525
417,HRUM,2022-05-17,10525,10700,10975,10600,10975,450
418,HRUM,2022-05-18,10975,11150,11175,10700,10975,0
419,HRUM,2022-05-19,10975,10500,10825,10375,10700,-275
420,HRUM,2022-05-20,10700,10900,11250,10850,11050,350
421,HRUM,2022-05-23,11050,11250,11300,10800,10900,-150
422,HRUM,2022-05-24,10900,10900,11150,10825,11075,175
423,HRUM,2022-05-25,11075,11000,11000,10400,10425,-650
424,HRUM,2022-05-27,10425,10625,11425,10525,11425,1000
425,HRUM,2022-05-30,11425,11500,11600,11150,11450,25
426,HRUM,2022-05-31,11450,11625,11925,11500,11875,425
427,HRUM,2022-06-02,2380,2380,2400,2300,2310,-70
428,HRUM,2022-06-03,2310,2310,2440,2230,2410,100
429,HRUM,2022-06-06,2410,2410,2470,2310,2330,-80
430,HRUM,2022-06-07,2330,2370,2380,2310,2330,0
431,HRUM,2022-06-08,2330,2330,2340,2170,2180,-150
432,HRUM,2022-06-09,2180,2180,2230,2150,2180,0
433,HRUM,2022-06-10,2180,2140,2160,2080,2100,-80
434,HRUM,2022-06-13,2100,2000,2050,1965,2020,-80
435,HRUM,2022-06-14,2020,2000,2070,1960,2020,0
436,HRUM,2022-06-15,2020,2020,2030,1880,1885,-135
437,HRUM,2022-06-16,1885,1930,1960,1840,1860,-25
438,HRUM,2022-06-17,1860,1815,1815,1730,1730,-130
439,HRUM,2022-06-20,1730,1750,1755,1640,1680,-50
440,HRUM,2022-06-21,1680,1745,1765,1695,1725,45
441,HRUM,2022-06-22,1725,1725,1780,1645,1655,-70
442,HRUM,2022-06-23,1655,1650,1685,1585,1675,20
443,HRUM,2022-06-24,1675,1680,1695,1640,1675,0
444,HRUM,2022-06-27,1675,1625,1645,1565,1585,-90
445,HRUM,2022-06-28,1585,1595,1625,1580,1610,25
446,HRUM,2022-06-29,1610,1610,1615,1535,1550,-60
447,HRUM,2022-06-30,1550,1560,1590,1520,1545,-5
448,HRUM,2022-07-01,1545,1535,1555,1440,1440,-105
449,HRUM,2022-07-04,1440,1415,1455,1375,1380,-60
450,HRUM,2022-07-05,1380,1410,1520,1410,1500,120
451,HRUM,2022-07-06,1500,1500,1525,1445,1470,-30
452,HRUM,2022-07-07,1470,1470,1500,1420,1450,-20
453,HRUM,2022-07-08,1450,1495,1530,1470,1500,50
454,HRUM,2022-07-11,1500,1505,1520,1460,1510,10
455,HRUM,2022-07-12,1510,1525,1535,1495,1510,0
456,HRUM,2022-07-13,1510,1515,1520,1465,1480,-30
457,HRUM,2022-07-14,1480,1470,1510,1450,1485,5
458,HRUM,2022-07-15,1485,1450,1450,1385,1385,-100
459,HRUM,2022-07-18,1385,1385,1395,1335,1360,-25
460,HRUM,2022-07-19,1360,1370,1515,1370,1510,150
461,HRUM,2022-07-20,1510,1550,1585,1530,1580,70
462,HRUM,2022-07-21,1580,1580,1590,1535,1545,-35
463,HRUM,2022-07-22,1545,1560,1630,1555,1625,80
464,HRUM,2022-07-25,1625,1635,1660,1580,1600,-25
465,HRUM,2022-07-26,1600,1615,1655,1610,1635,35
466,HRUM,2022-07-27,1635,1650,1760,1625,1730,95
467,HRUM,2022-07-28,1730,1780,1855,1745,1845,115
468,HRUM,2022-07-29,1845,1845,1875,1805,1845,0
469,HRUM,2022-08-01,1845,1900,1950,1875,1945,100
470,HRUM,2022-08-02,1945,1945,1950,1810,1810,-135
471,HRUM,2022-08-03,1810,1775,1835,1725,1785,-25
472,HRUM,2022-08-04,1785,1795,1815,1725,1730,-55
473,HRUM,2022-08-05,1730,1725,1785,1700,1760,30
474,HRUM,2022-08-08,1760,1760,1795,1730,1775,15
475,HRUM,2022-08-09,1775,1800,1825,1790,1800,25
476,HRUM,2022-08-10,1800,1805,1815,1770,1775,-25
477,HRUM,2022-08-11,1775,1825,1840,1790,1790,15
478,HRUM,2022-08-12,1790,1795,1805,1755,1765,-25
479,HRUM,2022-08-15,1765,1765,1775,1685,1690,-75
480,HRUM,2022-08-16,1690,1685,1690,1625,1630,-60
481,HRUM,2022-08-18,1630,1630,1705,1630,1675,45
482,HRUM,2022-08-19,1675,1695,1695,1665,1665,-10
483,HRUM,2022-08-22,1665,1655,1660,1575,1580,-85
484,HRUM,2022-08-23,1580,1580,1680,1580,1665,85
485,HRUM,2022-08-24,1665,1665,1730,1640,1700,35
486,HRUM,2022-08-25,1700,1710,1730,1680,1710,10
487,HRUM,2022-08-26,1710,1720,1725,1685,1690,-20
488,HRUM,2022-08-29,1690,1665,1730,1625,1725,35
489,HRUM,2022-08-30,1725,1745,1765,1725,1755,30
490,HRUM,2022-08-31,1755,1755,1755,1690,1700,-55
491,HRUM,2022-09-01,1700,1705,1740,1700,1710,10
492,HRUM,2022-09-02,1710,1725,1730,1665,1685,-25
493,HRUM,2022-09-05,1685,1685,1815,1685,1810,125
494,HRUM,2022-09-06,1810,1840,1885,1820,1855,45
495,HRUM,2022-09-07,1855,1855,1855,1780,1810,-45
496,HRUM,2022-09-08,1810,1800,1830,1765,1770,-40
497,HRUM,2022-09-09,1770,1770,1830,1740,1830,60
498,HRUM,2022-09-12,1830,1850,1875,1805,1815,-15
499,HRUM,2022-09-13,1815,1850,1950,1840,1920,105
500,HRUM,2022-09-14,1920,1895,2000,1865,2000,80
501,HRUM,2022-09-15,2000,2000,2050,1965,1970,-30
502,HRUM,2022-09-16,1970,1950,1960,1900,1910,-60
503,HRUM,2022-09-19,1910,1950,1955,1830,1880,-30
504,HRUM,2022-09-20,1880,1885,1910,1840,1850,-30
505,HRUM,2022-09-21,1850,1850,1900,1830,1900,50
506,HRUM,2022-09-22,1900,1870,1960,1865,1940,40
507,HRUM,2022-09-23,1940,1930,2000,1905,1920,-20
508,HRUM,2022-09-26,1920,1865,1875,1790,1825,-95
509,HRUM,2022-09-27,1825,1825,1855,1800,1840,15
510,HRUM,2022-09-28,1840,1830,1835,1755,1760,-80
511,HRUM,2022-09-29,1760,1780,1815,1765,1790,30
512,HRUM,2022-09-30,1790,1770,1785,1715,1780,-10
513,HRUM,2022-10-03,1780,1770,1820,1755,1785,5
514,HRUM,2022-10-04,1785,1820,1845,1815,1835,50
515,HRUM,2022-10-05,1835,1840,1865,1825,1830,-5
516,HRUM,2022-10-06,1830,1830,1860,1825,1825,-5
517,HRUM,2022-10-07,1825,1820,1835,1805,1820,-5
518,HRUM,2022-10-10,1820,1800,1800,1755,1775,-45
519,HRUM,2022-10-11,1775,1780,1780,1730,1730,-45
520,HRUM,2022-10-12,1730,1730,1765,1700,1720,-10
521,HRUM,2022-10-13,1720,1755,1755,1720,1730,10
522,HRUM,2022-10-14,1730,1750,1750,1700,1725,-5
523,HRUM,2022-10-17,1725,1715,1715,1620,1655,-70
524,HRUM,2022-10-18,1655,1680,1680,1600,1610,-45
525,HRUM,2022-10-19,1610,1610,1610,1570,1575,-35
526,HRUM,2022-10-20,1575,1585,1630,1575,1630,55
527,HRUM,2022-10-21,1630,1630,1650,1610,1610,-20
528,HRUM,2022-10-24,1610,1615,1635,1595,1610,0
529,HRUM,2022-10-25,1610,1615,1620,1555,1565,-45
530,HRUM,2022-10-26,1565,1570,1610,1565,1605,40
531,HRUM,2022-10-27,1605,1615,1670,1605,1615,10
532,HRUM,2022-10-28,1615,1620,1625,1585,1590,-25
533,HRUM,2022-10-31,1590,1615,1625,1595,1610,20
534,HRUM,2022-11-01,1610,1595,1595,1505,1505,-105
535,HRUM,2022-11-02,1505,1570,1605,1530,1530,25
536,HRUM,2022-11-03,1530,1540,1585,1540,1580,50
537,HRUM,2022-11-04,1580,1565,1595,1550,1590,10
538,HRUM,2022-11-07,1590,1605,1670,1605,1660,70
539,HRUM,2022-11-08,1660,1660,1675,1630,1665,5
540,HRUM,2022-11-09,1665,1665,1700,1635,1635,-30
541,HRUM,2022-11-10,1635,1610,1610,1560,1565,-70
542,HRUM,2022-11-11,1565,1600,1620,1575,1595,30
543,HRUM,2022-11-14,1595,1635,1690,1620,1660,65
544,HRUM,2022-11-15,1660,1700,1735,1695,1700,40
545,HRUM,2022-11-16,1700,1725,1730,1670,1675,-25
546,HRUM,2022-11-17,1675,1650,1685,1620,1680,5
547,HRUM,2022-11-18,1680,1680,1680,1640,1640,-40
548,HRUM,2022-11-21,1640,1665,1670,1635,1645,5
549,HRUM,2022-11-22,1645,1655,1660,1635,1650,5
550,HRUM,2022-11-23,1650,1670,1715,1670,1685,35
551,HRUM,2022-11-24,1685,1695,1700,1670,1675,-10
552,HRUM,2022-11-25,1675,1680,1685,1635,1655,-20
553,HRUM,2022-11-28,1655,1655,1660,1600,1630,-25
554,HRUM,2022-11-29,1630,1640,1720,1630,1710,80
555,HRUM,2022-11-30,1710,1730,1760,1730,1755,45
556,HRUM,2022-12-01,1755,1770,1775,1755,1770,15
557,HRUM,2022-12-02,1770,1770,1770,1735,1755,-15
558,HRUM,2022-12-05,1755,1780,1810,1760,1775,20
559,HRUM,2022-12-06,1775,1790,1805,1765,1770,-5
560,HRUM,2022-12-07,1770,1785,1795,1750,1760,-10
561,HRUM,2022-12-08,1760,1770,1775,1705,1745,-15
562,HRUM,2022-12-09,1745,1745,1760,1735,1755,10
563,HRUM,2022-12-12,1755,1760,1800,1755,1795,40
564,HRUM,2022-12-13,1795,1800,1810,1755,1770,-25
565,HRUM,2022-12-14,1770,1730,1755,1700,1745,-25
566,HRUM,2022-12-15,1745,1745,1760,1725,1745,0
567,HRUM,2022-12-16,1745,1735,1750,1710,1750,5
568,HRUM,2022-12-19,1750,1750,1755,1710,1725,-25
569,HRUM,2022-12-20,1725,1725,1725,1650,1655,-70
570,HRUM,2022-12-21,1655,1660,1680,1660,1660,5
571,HRUM,2022-12-22,1660,1690,1695,1670,1685,25
572,HRUM,2022-12-23,1685,1685,1685,1650,1665,-20
573,HRUM,2022-12-26,1665,1670,1670,1645,1645,-20
574,HRUM,2022-12-27,1645,1660,1680,1615,1620,-25
575,HRUM,2022-12-28,1620,1620,1630,1600,1605,-15
576,HRUM,2022-12-29,1605,1610,1620,1590,1605,0
577,HRUM,2022-12-30,1605,1615,1635,1610,1620,15
