,stock_code,date,prev,open,high,low,close,change
0,MAPI,2024-01-02,1790,1800,1985,1800,1895,105
1,MAPI,2024-01-03,1895,1905,1955,1880,1900,5
2,MAPI,2024-01-04,1900,1910,1930,1865,1885,-15
3,MAPI,2024-01-05,1885,1885,1895,1785,1795,-90
4,MAPI,2024-01-08,1795,1800,1810,1775,1775,-20
5,MAPI,2024-01-09,1775,1780,1895,1780,1855,80
6,MAPI,2024-01-10,1855,1855,1925,1845,1855,0
7,MAPI,2024-01-10,1855,1855,1925,1845,1855,0
8,MAPI,2024-01-11,1855,1860,1870,1830,1845,-10
9,MAPI,2024-01-12,1845,1845,1855,1815,1820,-25
10,MAPI,2024-01-15,1820,1830,1920,1825,1905,85
11,MAPI,2024-01-16,1905,1920,1995,1920,1940,35
12,MAPI,2024-01-17,1940,1940,1965,1885,1900,-40
13,MAPI,2024-01-18,1900,1900,1945,1890,1920,20
14,MAPI,2024-01-19,1920,1920,1960,1905,1945,25
15,MAPI,2024-01-22,1945,1950,2030,1930,1970,25
16,MAPI,2024-01-23,1970,1975,2030,1960,1995,25
17,MAPI,2024-01-24,1995,2000,2010,1985,1995,0
18,MAPI,2024-01-25,1995,1990,1990,1925,1935,-60
19,MAPI,2024-01-26,1935,1910,1915,1855,1875,-60
20,MAPI,2024-01-29,1875,1875,1915,1875,1900,25
21,MAPI,2024-01-30,1900,1910,2030,1910,1970,70
22,MAPI,2024-01-31,1970,1990,2000,1955,1955,-15
23,MAPI,2024-02-01,1955,1960,1980,1930,1960,5
24,MAPI,2024-02-02,1960,1965,1995,1965,1975,15
25,MAPI,2024-02-05,1975,1985,1995,1910,1930,-45
26,MAPI,2024-02-06,1930,1930,1960,1925,1955,25
27,MAPI,2024-02-07,1955,1960,2010,1955,1975,20
28,MAPI,2024-02-12,1975,1980,1990,1955,1965,-10
29,MAPI,2024-02-13,1965,1965,1970,1930,1970,5
30,MAPI,2024-02-15,1970,1980,2050,1970,2000,30
31,MAPI,2024-02-16,2000,2000,2000,1930,1935,-65
32,MAPI,2024-02-19,1935,1935,1955,1850,1900,-35
33,MAPI,2024-02-20,1900,1900,1920,1875,1885,-15
34,MAPI,2024-02-21,1885,1895,1930,1885,1930,45
35,MAPI,2024-02-22,1930,1950,1980,1935,1975,45
36,MAPI,2024-02-23,1975,1975,1975,1930,1955,-20
37,MAPI,2024-02-26,1955,1950,1950,1910,1915,-40
38,MAPI,2024-02-27,1915,1925,1945,1890,1920,5
39,MAPI,2024-02-28,1920,1930,1940,1915,1935,15
40,MAPI,2024-02-29,1935,1935,1935,1920,1920,-15
41,MAPI,2024-03-01,1920,1930,1975,1925,1970,50
42,MAPI,2024-03-04,1970,1975,2030,1965,1990,20
43,MAPI,2024-03-05,1990,1990,1990,1965,1970,-20
44,MAPI,2024-03-06,1970,1970,1980,1950,1975,5
45,MAPI,2024-03-07,1975,1955,1995,1955,1980,5
46,MAPI,2024-03-08,1980,1980,1985,1860,1885,-95
47,MAPI,2024-03-13,1885,1915,1950,1865,1920,35
48,MAPI,2024-03-14,1920,1940,1960,1915,1935,15
49,MAPI,2024-03-15,1935,1940,1965,1930,1930,-5
50,MAPI,2024-03-18,1930,1930,1940,1895,1905,-25
51,MAPI,2024-03-19,1905,1905,1925,1825,1825,-80
52,MAPI,2024-03-20,1825,1825,1840,1780,1815,-10
53,MAPI,2024-03-21,1815,1815,1870,1805,1805,-10
54,MAPI,2024-03-22,1805,1805,1820,1775,1815,10
55,MAPI,2024-03-25,1815,1820,1835,1805,1815,0
56,MAPI,2024-03-26,1815,1815,1830,1805,1825,10
57,MAPI,2024-03-27,1825,1825,1835,1790,1800,-25
58,MAPI,2024-03-28,1800,1805,1820,1790,1820,20
59,MAPI,2024-04-01,1820,1815,1860,1815,1840,20
60,MAPI,2024-04-02,1840,1865,1910,1860,1895,55
61,MAPI,2024-04-03,1895,1900,1905,1840,1860,-35
62,MAPI,2024-04-04,1860,1880,1910,1850,1900,40
63,MAPI,2024-04-05,1900,1900,1925,1885,1890,-10
64,MAPI,2024-04-16,1890,1830,1835,1805,1810,-80
65,MAPI,2024-04-17,1810,1815,1840,1790,1795,-15
66,MAPI,2024-04-18,1795,1800,1830,1770,1775,-20
67,MAPI,2024-04-19,1775,1770,1775,1655,1695,-80
68,MAPI,2024-04-22,1695,1720,1745,1615,1675,-20
69,MAPI,2024-04-23,1675,1685,1690,1620,1635,-40
70,MAPI,2024-04-24,1635,1650,1700,1650,1675,40
71,MAPI,2024-04-25,1675,1680,1680,1625,1635,-40
72,MAPI,2024-04-26,1635,1635,1660,1530,1555,-80
73,MAPI,2024-04-29,1555,1555,1675,1530,1655,100
74,MAPI,2024-04-30,1655,1665,1665,1570,1575,-80
75,MAPI,2024-05-02,1575,1575,1575,1400,1440,-135
76,MAPI,2024-05-03,1440,1450,1510,1430,1485,45
77,MAPI,2024-05-06,1485,1490,1495,1430,1445,-40
78,MAPI,2024-05-07,1445,1450,1460,1405,1405,-40
79,MAPI,2024-05-08,1405,1410,1525,1405,1495,90
80,MAPI,2024-05-13,1495,1490,1540,1450,1525,30
81,MAPI,2024-05-14,1525,1530,1530,1475,1510,-15
82,MAPI,2024-05-15,1510,1510,1515,1480,1510,0
83,MAPI,2024-05-16,1510,1520,1520,1480,1485,-25
84,MAPI,2024-05-17,1485,1475,1505,1455,1490,5
85,MAPI,2024-05-20,1490,1500,1500,1465,1485,-5
86,MAPI,2024-05-21,1485,1495,1495,1405,1405,-80
87,MAPI,2024-05-22,1405,1420,1430,1390,1390,-15
88,MAPI,2024-05-27,1390,1390,1400,1335,1345,-45
89,MAPI,2024-05-28,1345,1350,1355,1315,1345,0
90,MAPI,2024-05-29,1345,1350,1350,1285,1300,-45
91,MAPI,2024-05-30,1300,1300,1310,1270,1295,-5
92,MAPI,2024-05-31,1295,1295,1315,1240,1270,-25
93,MAPI,2023-01-02,1445,0,1530,1400,1415,-30
94,MAPI,2023-01-03,1415,0,1440,1400,1415,0
95,MAPI,2023-01-04,1415,0,1430,1350,1395,-20
96,MAPI,2023-01-05,1395,0,1400,1320,1345,-50
97,MAPI,2023-01-06,1345,0,1370,1300,1300,-45
98,MAPI,2023-01-09,1300,0,1335,1280,1280,-20
99,MAPI,2023-01-10,1280,0,1280,1195,1210,-70
100,MAPI,2023-01-11,1210,0,1320,1210,1290,80
101,MAPI,2023-01-12,1290,0,1320,1265,1290,0
102,MAPI,2023-01-13,1290,0,1300,1270,1295,5
103,MAPI,2023-01-16,1295,0,1335,1270,1320,25
104,MAPI,2023-01-17,1320,0,1365,1320,1350,30
105,MAPI,2023-01-18,1350,0,1375,1305,1335,-15
106,MAPI,2023-01-19,1335,0,1395,1330,1390,55
107,MAPI,2023-01-20,1390,0,1420,1365,1415,25
108,MAPI,2023-01-24,1415,0,1420,1380,1395,-20
109,MAPI,2023-01-25,1395,0,1405,1315,1335,-60
110,MAPI,2023-01-26,1335,0,1345,1295,1310,-25
111,MAPI,2023-01-27,1310,0,1340,1250,1265,-45
112,MAPI,2023-01-30,1265,0,1325,1270,1315,50
113,MAPI,2023-01-31,1315,0,1335,1295,1300,-15
114,MAPI,2023-02-01,1300,0,1470,1300,1390,90
115,MAPI,2023-02-02,1390,0,1440,1390,1400,10
116,MAPI,2023-02-03,1400,0,1435,1385,1385,-15
117,MAPI,2023-02-06,1385,0,1470,1385,1440,55
118,MAPI,2023-02-07,1440,0,1515,1440,1495,55
119,MAPI,2023-02-08,1495,0,1520,1465,1480,-15
120,MAPI,2023-02-09,1480,0,1480,1420,1440,-40
121,MAPI,2023-02-10,1440,0,1455,1430,1440,0
122,MAPI,2023-02-13,1440,0,1600,1435,1575,135
123,MAPI,2023-02-14,1575,0,1575,1520,1520,-55
124,MAPI,2023-02-15,1520,0,1565,1505,1520,0
125,MAPI,2023-02-16,1520,0,1565,1520,1530,10
126,MAPI,2023-02-17,1530,0,1545,1475,1495,-35
127,MAPI,2023-02-20,1495,0,1560,1485,1540,45
128,MAPI,2023-02-21,1540,0,1575,1540,1550,10
129,MAPI,2023-02-22,1550,0,1565,1520,1550,0
130,MAPI,2023-02-23,1550,0,1635,1550,1590,40
131,MAPI,2023-02-24,1590,0,1665,1580,1600,10
132,MAPI,2023-02-27,1600,0,1610,1550,1590,-10
133,MAPI,2023-02-28,1590,0,1590,1510,1510,-80
134,MAPI,2023-03-01,1510,0,1610,1515,1550,40
135,MAPI,2023-03-02,1550,0,1645,1550,1620,70
136,MAPI,2023-03-03,1620,0,1635,1555,1560,-60
137,MAPI,2023-03-06,1560,0,1595,1555,1570,10
138,MAPI,2023-03-07,1570,0,1610,1555,1600,30
139,MAPI,2023-03-08,1600,0,1615,1565,1570,-30
140,MAPI,2023-03-09,1570,0,1575,1495,1520,-50
141,MAPI,2023-03-10,1520,0,1525,1445,1465,-55
142,MAPI,2023-03-13,1465,0,1540,1425,1540,75
143,MAPI,2023-03-14,1540,0,1580,1450,1465,-75
144,MAPI,2023-03-15,1465,0,1570,1470,1545,80
145,MAPI,2023-03-16,1545,0,1600,1495,1600,55
146,MAPI,2023-03-17,1600,0,1635,1565,1600,0
147,MAPI,2023-03-20,1600,0,1600,1515,1525,-75
148,MAPI,2023-03-21,1525,0,1545,1480,1495,-30
149,MAPI,2023-03-24,1495,0,1560,1495,1515,20
150,MAPI,2023-03-27,1515,0,1530,1495,1500,-15
151,MAPI,2023-03-28,1500,0,1620,1500,1600,100
152,MAPI,2023-03-29,1600,0,1680,1585,1625,25
153,MAPI,2023-03-30,1625,0,1650,1515,1540,-85
154,MAPI,2023-03-31,1540,0,1560,1510,1510,-30
155,MAPI,2023-04-03,1510,0,1540,1450,1450,-60
156,MAPI,2023-04-04,1450,0,1475,1400,1400,-50
157,MAPI,2023-04-05,1400,0,1450,1385,1385,-15
158,MAPI,2023-04-06,1385,0,1430,1340,1415,30
159,MAPI,2023-04-10,1415,0,1440,1360,1365,-50
160,MAPI,2023-04-11,1365,0,1385,1325,1330,-35
161,MAPI,2023-04-12,1330,0,1405,1330,1370,40
162,MAPI,2023-04-13,1370,0,1390,1305,1390,20
163,MAPI,2023-04-14,1390,0,1455,1390,1430,40
164,MAPI,2023-04-17,1430,0,1475,1420,1465,35
165,MAPI,2023-04-18,1465,0,1475,1430,1430,-35
166,MAPI,2023-04-26,1430,0,1495,1400,1410,-20
167,MAPI,2023-04-27,1410,0,1410,1365,1370,-40
168,MAPI,2023-04-28,1370,0,1385,1350,1370,0
169,MAPI,2023-05-02,1370,0,1490,1390,1410,40
170,MAPI,2023-05-03,1410,0,1460,1365,1455,45
171,MAPI,2023-05-04,1455,0,1485,1435,1460,5
172,MAPI,2023-05-05,1460,0,1480,1450,1465,5
173,MAPI,2023-05-08,1465,0,1540,1455,1500,35
174,MAPI,2023-05-09,1500,0,1630,1500,1595,95
175,MAPI,2023-05-10,1595,0,1635,1565,1575,-20
176,MAPI,2023-05-11,1575,0,1700,1550,1670,95
177,MAPI,2023-05-12,1670,0,1710,1665,1665,-5
178,MAPI,2023-05-15,1665,0,1730,1660,1730,65
179,MAPI,2023-05-16,1730,0,1740,1675,1700,-30
180,MAPI,2023-05-17,1700,0,1775,1695,1705,5
181,MAPI,2023-05-19,1705,0,1735,1670,1675,-30
182,MAPI,2023-05-22,1675,0,1705,1625,1655,-20
183,MAPI,2023-05-23,1655,0,1790,1655,1770,115
184,MAPI,2023-05-24,1770,0,1790,1705,1760,-10
185,MAPI,2023-05-25,1760,0,1865,1750,1830,70
186,MAPI,2023-05-26,1830,0,1830,1790,1830,0
187,MAPI,2023-05-29,1830,0,1830,1770,1825,-5
188,MAPI,2023-05-30,1825,0,1845,1805,1805,-20
189,MAPI,2023-05-31,1805,0,1855,1755,1775,-30
190,MAPI,2023-06-05,1775,0,1790,1730,1770,-5
191,MAPI,2023-06-06,1770,0,1815,1750,1800,30
192,MAPI,2023-06-07,1800,0,1925,1785,1880,80
193,MAPI,2023-06-08,1880,0,1900,1850,1875,-5
194,MAPI,2023-06-09,1875,0,1940,1850,1900,25
195,MAPI,2023-06-12,1900,0,1925,1860,1885,-15
196,MAPI,2023-06-13,1885,0,1885,1820,1850,-35
197,MAPI,2023-06-14,1850,0,1850,1800,1805,-45
198,MAPI,2023-06-15,1805,0,1855,1810,1815,10
199,MAPI,2023-06-16,1815,0,1830,1765,1800,-15
200,MAPI,2023-06-19,1800,0,1805,1750,1750,-50
201,MAPI,2023-06-20,1750,0,1750,1655,1695,-55
202,MAPI,2023-06-21,1695,0,1745,1680,1740,45
203,MAPI,2023-06-22,1740,0,1765,1685,1685,-55
204,MAPI,2023-06-23,1685,0,1715,1675,1705,20
205,MAPI,2023-06-26,1705,0,1730,1690,1690,-15
206,MAPI,2023-06-27,1690,0,1700,1640,1690,0
207,MAPI,2023-07-03,1690,0,1705,1660,1675,-15
208,MAPI,2023-07-04,1675,0,1740,1675,1715,40
209,MAPI,2023-07-05,1715,0,1720,1680,1700,-15
210,MAPI,2023-07-06,1700,0,1815,1695,1810,110
211,MAPI,2023-07-07,1810,0,1825,1740,1760,-50
212,MAPI,2023-07-10,1760,0,1780,1745,1750,-10
213,MAPI,2023-07-11,1750,0,1805,1710,1805,55
214,MAPI,2023-07-12,1805,0,1900,1785,1860,55
215,MAPI,2023-07-13,1860,0,1880,1780,1785,-75
216,MAPI,2023-07-14,1785,0,1820,1785,1800,15
217,MAPI,2023-07-17,1800,0,1855,1800,1835,35
218,MAPI,2023-07-18,1835,0,1930,1835,1900,65
219,MAPI,2023-07-20,1900,0,1995,1895,1985,85
220,MAPI,2023-07-21,1985,0,2050,1925,1930,-55
221,MAPI,2023-07-24,1930,0,1965,1850,1915,-15
222,MAPI,2023-07-25,1915,0,1940,1890,1910,-5
223,MAPI,2023-07-26,1910,0,1970,1920,1925,15
224,MAPI,2023-07-27,1925,0,2020,1920,2000,75
225,MAPI,2023-07-28,2000,0,2030,1970,2020,20
226,MAPI,2023-07-31,2020,0,2050,1975,1980,-40
227,MAPI,2023-08-01,1980,1990,2030,1960,2030,50
228,MAPI,2023-08-02,2030,2030,2030,1970,1980,-50
229,MAPI,2023-08-03,1980,2010,2010,1925,1930,-50
230,MAPI,2023-08-04,1930,1935,1975,1925,1945,15
231,MAPI,2023-08-07,1945,1950,1970,1930,1935,-10
232,MAPI,2023-08-08,1935,1935,1955,1920,1935,0
233,MAPI,2023-08-09,1935,1945,1970,1930,1945,10
234,MAPI,2023-08-10,1945,1945,1990,1930,1970,25
235,MAPI,2023-08-11,1970,1970,2030,1970,2030,60
236,MAPI,2023-08-14,2030,2030,2070,2000,2020,-10
237,MAPI,2023-08-15,2020,2020,2020,1985,1995,-25
238,MAPI,2023-08-16,1995,1995,1995,1925,1940,-55
239,MAPI,2023-08-18,1940,1945,1975,1875,1910,-30
240,MAPI,2023-08-21,1910,1910,1910,1860,1885,-25
241,MAPI,2023-08-22,1885,1895,1975,1895,1970,85
242,MAPI,2023-08-23,1970,1970,1995,1935,1995,25
243,MAPI,2023-08-24,1995,1995,2040,1955,1955,-40
244,MAPI,2023-08-25,1955,1965,1995,1920,1970,15
245,MAPI,2023-08-28,1970,1975,2020,1945,2010,40
246,MAPI,2023-08-29,2010,2010,2020,1955,1960,-50
247,MAPI,2023-08-30,1960,1965,1985,1950,1960,0
248,MAPI,2023-08-31,1960,1965,1975,1935,1935,-25
249,MAPI,2023-09-01,1935,1940,1985,1940,1975,40
250,MAPI,2023-09-04,1975,1975,1985,1950,1980,5
251,MAPI,2023-09-05,1980,1990,1995,1950,1960,-20
252,MAPI,2023-09-06,1960,1955,1955,1865,1900,-60
253,MAPI,2023-09-07,1900,1900,1905,1815,1840,-60
254,MAPI,2023-09-08,1840,1815,1870,1790,1840,0
255,MAPI,2023-09-11,1840,1850,1900,1830,1885,45
256,MAPI,2023-09-12,1885,1895,1900,1820,1850,-35
257,MAPI,2023-09-13,1850,1850,1870,1830,1845,-5
258,MAPI,2023-09-14,1845,1845,1860,1815,1825,-20
259,MAPI,2023-09-15,1825,1835,1840,1800,1820,-5
260,MAPI,2023-09-18,1820,1820,1820,1775,1795,-25
261,MAPI,2023-09-19,1795,1795,1835,1790,1800,5
262,MAPI,2023-09-20,1800,1800,1845,1790,1825,25
263,MAPI,2023-09-21,1825,1825,1930,1805,1895,70
264,MAPI,2023-09-22,1895,1910,1915,1845,1875,-20
265,MAPI,2023-09-25,1875,1875,1880,1815,1815,-60
266,MAPI,2023-09-26,1815,1820,1865,1820,1850,35
267,MAPI,2023-09-27,1850,1870,1880,1745,1775,-75
268,MAPI,2023-09-29,1775,1780,1850,1780,1820,45
269,MAPI,2023-10-02,1820,1820,1885,1820,1870,50
270,MAPI,2023-10-03,1870,1875,1950,1875,1950,80
271,MAPI,2023-10-04,1950,1950,1950,1900,1930,-20
272,MAPI,2023-10-05,1930,1930,1950,1910,1915,-15
273,MAPI,2023-10-06,1915,1920,1995,1920,1990,75
274,MAPI,2023-10-09,1990,1995,1995,1935,1960,-30
275,MAPI,2023-10-10,1960,1970,2000,1945,1990,30
276,MAPI,2023-10-11,1990,1995,2020,1970,1980,-10
277,MAPI,2023-10-12,1980,1990,1990,1930,1975,-5
278,MAPI,2023-10-13,1975,1975,1990,1950,1965,-10
279,MAPI,2023-10-16,1965,1950,1960,1880,1890,-75
280,MAPI,2023-10-17,1890,1890,1915,1855,1855,-35
281,MAPI,2023-10-18,1855,1865,1895,1810,1895,40
282,MAPI,2023-10-19,1895,1880,1880,1795,1855,-40
283,MAPI,2023-10-20,1855,1855,1915,1835,1905,50
284,MAPI,2023-10-23,1905,1915,1930,1875,1920,15
285,MAPI,2023-10-24,1920,1920,1965,1880,1950,30
286,MAPI,2023-10-25,1950,1950,1970,1935,1955,5
287,MAPI,2023-10-26,1955,1950,1950,1830,1850,-105
288,MAPI,2023-10-27,1850,1855,1865,1780,1825,-25
289,MAPI,2023-10-30,1825,1820,1820,1750,1755,-70
290,MAPI,2023-10-31,1755,1755,1755,1660,1735,-20
291,MAPI,2023-11-01,1735,1725,1725,1580,1605,-130
292,MAPI,2023-11-02,1605,1650,1745,1605,1710,105
293,MAPI,2023-11-03,1710,1710,1720,1640,1670,-40
294,MAPI,2023-11-06,1670,1700,1705,1615,1685,15
295,MAPI,2023-11-07,1685,1685,1685,1560,1600,-85
296,MAPI,2023-11-08,1600,1600,1670,1580,1655,55
297,MAPI,2023-11-09,1655,1655,1670,1610,1665,10
298,MAPI,2023-11-10,1665,1650,1710,1645,1685,20
299,MAPI,2023-11-13,1685,1685,1685,1600,1610,-75
300,MAPI,2023-11-14,1610,1600,1645,1550,1590,-20
301,MAPI,2023-11-15,1590,1615,1710,1605,1685,95
302,MAPI,2023-11-16,1685,1695,1695,1635,1640,-45
303,MAPI,2023-11-17,1640,1640,1665,1615,1660,20
304,MAPI,2023-11-20,1660,1660,1675,1630,1650,-10
305,MAPI,2023-11-21,1650,1650,1665,1635,1645,-5
306,MAPI,2023-11-22,1645,1655,1680,1620,1675,30
307,MAPI,2023-11-23,1675,1675,1760,1665,1745,70
308,MAPI,2023-11-24,1745,1740,1800,1740,1785,40
309,MAPI,2023-11-27,1785,1800,1815,1765,1780,-5
310,MAPI,2023-11-28,1780,1780,1795,1720,1735,-45
311,MAPI,2023-11-29,1735,1735,1740,1710,1730,-5
312,MAPI,2023-11-30,1730,1740,1765,1695,1745,15
313,MAPI,2023-12-01,1745,1720,1745,1700,1740,-5
314,MAPI,2023-12-04,1740,1730,1735,1640,1670,-70
315,MAPI,2023-12-05,1670,1655,1680,1625,1670,0
316,MAPI,2023-12-06,1670,1670,1690,1635,1640,-30
317,MAPI,2023-12-07,1640,1640,1650,1605,1640,0
318,MAPI,2023-12-08,1640,1645,1680,1635,1660,20
319,MAPI,2023-12-11,1660,1650,1650,1595,1630,-30
320,MAPI,2023-12-12,1630,1630,1630,1560,1615,-15
321,MAPI,2023-12-13,1615,1625,1655,1600,1620,5
322,MAPI,2023-12-14,1620,1645,1725,1640,1720,100
323,MAPI,2023-12-15,1720,1710,1720,1655,1675,-45
324,MAPI,2023-12-18,1675,1680,1685,1645,1675,0
325,MAPI,2023-12-19,1675,1675,1710,1665,1700,25
326,MAPI,2023-12-20,1700,1720,1740,1695,1715,15
327,MAPI,2023-12-21,1715,1715,1720,1690,1715,0
328,MAPI,2023-12-22,1715,1720,1785,1720,1765,50
329,MAPI,2023-12-27,1765,1765,1780,1740,1750,-15
330,MAPI,2023-12-28,1750,1750,1775,1745,1765,15
331,MAPI,2023-12-29,1765,1765,1830,1765,1790,25
332,MAPI,2022-01-03,710,0,730,700,700,-10
333,MAPI,2022-01-04,700,0,785,700,775,75
334,MAPI,2022-01-05,775,0,785,750,780,5
335,MAPI,2022-01-06,780,0,785,740,765,-15
336,MAPI,2022-01-07,765,0,775,750,765,0
337,MAPI,2022-01-10,765,0,770,750,760,-5
338,MAPI,2022-01-11,760,0,775,745,755,-5
339,MAPI,2022-01-12,755,0,765,740,745,-10
340,MAPI,2022-01-13,745,0,750,740,745,0
341,MAPI,2022-01-14,745,0,790,735,790,45
342,MAPI,2022-01-17,790,0,800,760,765,-25
343,MAPI,2022-01-18,765,0,780,750,765,0
344,MAPI,2022-01-19,765,0,775,725,750,-15
345,MAPI,2022-01-20,750,0,760,745,750,0
346,MAPI,2022-01-21,750,0,765,735,750,0
347,MAPI,2022-01-24,750,0,755,725,750,0
348,MAPI,2022-01-25,750,0,760,725,735,-15
349,MAPI,2022-01-26,735,0,755,735,755,20
350,MAPI,2022-01-27,755,0,755,730,735,-20
351,MAPI,2022-01-28,735,0,750,730,750,15
352,MAPI,2022-01-31,750,0,805,725,780,30
353,MAPI,2022-02-02,780,0,810,765,805,25
354,MAPI,2022-02-03,805,0,820,770,790,-15
355,MAPI,2022-02-04,790,0,785,755,760,-30
356,MAPI,2022-02-07,760,0,760,735,740,-20
357,MAPI,2022-02-08,740,0,755,730,740,0
358,MAPI,2022-02-09,740,0,790,740,785,45
359,MAPI,2022-02-10,785,0,820,775,795,10
360,MAPI,2022-02-11,795,0,805,780,785,-10
361,MAPI,2022-02-14,785,0,795,740,750,-35
362,MAPI,2022-02-15,750,0,785,725,780,30
363,MAPI,2022-02-16,780,0,825,780,805,25
364,MAPI,2022-02-17,805,0,820,790,800,-5
365,MAPI,2022-02-18,800,0,845,790,840,40
366,MAPI,2022-02-21,840,0,850,800,815,-25
367,MAPI,2022-02-22,815,0,815,780,800,-15
368,MAPI,2022-02-23,800,0,805,790,800,0
369,MAPI,2022-02-24,800,0,800,760,790,-10
370,MAPI,2022-02-25,790,0,810,780,785,-5
371,MAPI,2022-03-01,785,0,820,780,820,35
372,MAPI,2022-03-02,820,0,820,795,805,-15
373,MAPI,2022-03-04,805,0,820,795,815,10
374,MAPI,2022-03-07,815,0,830,790,800,-15
375,MAPI,2022-03-08,800,0,820,790,800,0
376,MAPI,2022-03-09,800,0,835,790,805,5
377,MAPI,2022-03-10,805,0,870,810,855,50
378,MAPI,2022-03-11,855,0,870,840,855,0
379,MAPI,2022-03-14,855,0,880,840,855,0
380,MAPI,2022-03-15,855,0,880,815,820,-35
381,MAPI,2022-03-16,820,0,830,795,805,-15
382,MAPI,2022-03-17,805,0,850,805,835,30
383,MAPI,2022-03-18,835,0,835,805,815,-20
384,MAPI,2022-03-21,815,0,825,800,815,0
385,MAPI,2022-03-22,815,0,825,805,815,0
386,MAPI,2022-03-23,815,0,820,795,805,-10
387,MAPI,2022-03-24,805,0,860,805,860,55
388,MAPI,2022-03-25,860,0,870,840,845,-15
389,MAPI,2022-03-28,845,0,870,825,835,-10
390,MAPI,2022-03-29,835,0,860,835,840,5
391,MAPI,2022-03-30,840,0,865,845,860,20
392,MAPI,2022-03-31,860,0,880,850,880,20
393,MAPI,2022-04-01,880,0,880,825,840,-40
394,MAPI,2022-04-04,840,0,850,830,840,0
395,MAPI,2022-04-05,840,0,865,840,855,15
396,MAPI,2022-04-06,855,0,855,825,855,0
397,MAPI,2022-04-07,855,0,850,815,845,-10
398,MAPI,2022-04-08,845,0,850,830,845,0
399,MAPI,2022-04-11,845,0,880,840,875,30
400,MAPI,2022-04-12,875,0,915,875,910,35
401,MAPI,2022-04-13,910,0,935,875,890,-20
402,MAPI,2022-04-14,890,0,910,880,890,0
403,MAPI,2022-04-18,890,0,930,885,890,0
404,MAPI,2022-04-19,890,0,910,880,905,15
405,MAPI,2022-04-20,905,0,925,885,885,-20
406,MAPI,2022-04-21,885,0,920,885,920,35
407,MAPI,2022-04-22,920,0,930,905,920,0
408,MAPI,2022-04-25,920,0,940,895,920,0
409,MAPI,2022-04-26,920,0,935,910,920,0
410,MAPI,2022-04-27,920,0,930,900,920,0
411,MAPI,2022-04-28,920,0,915,895,900,-20
412,MAPI,2022-05-09,900,0,910,865,905,5
413,MAPI,2022-05-10,905,0,915,845,905,0
414,MAPI,2022-05-11,905,0,930,875,925,20
415,MAPI,2022-05-12,925,0,925,865,865,-60
416,MAPI,2022-05-13,865,0,905,835,890,25
417,MAPI,2022-05-17,890,0,910,865,865,-25
418,MAPI,2022-05-18,865,0,900,865,900,35
419,MAPI,2022-05-19,900,0,890,840,845,-55
420,MAPI,2022-05-20,845,0,865,820,845,0
421,MAPI,2022-05-23,845,0,910,850,890,45
422,MAPI,2022-05-24,890,0,900,875,900,10
423,MAPI,2022-05-25,900,0,900,875,895,-5
424,MAPI,2022-05-27,895,0,925,890,915,20
425,MAPI,2022-05-30,915,0,920,890,900,-15
426,MAPI,2022-05-31,900,0,905,890,900,0
427,MAPI,2022-06-02,900,0,910,890,895,-5
428,MAPI,2022-06-03,895,0,960,895,935,40
429,MAPI,2022-06-06,935,0,985,930,960,25
430,MAPI,2022-06-07,960,0,980,940,950,-10
431,MAPI,2022-06-08,950,0,985,950,965,15
432,MAPI,2022-06-09,965,0,970,940,950,-15
433,MAPI,2022-06-10,950,0,960,915,925,-25
434,MAPI,2022-06-13,925,0,920,880,900,-25
435,MAPI,2022-06-14,900,0,910,880,890,-10
436,MAPI,2022-06-15,890,0,905,885,900,10
437,MAPI,2022-06-16,900,0,940,900,910,10
438,MAPI,2022-06-17,910,0,915,860,875,-35
439,MAPI,2022-06-20,875,0,920,870,900,25
440,MAPI,2022-06-21,900,0,930,890,900,0
441,MAPI,2022-06-22,900,0,910,890,895,-5
442,MAPI,2022-06-23,895,0,910,880,900,5
443,MAPI,2022-06-24,900,0,915,885,915,15
444,MAPI,2022-06-27,915,0,920,900,910,-5
445,MAPI,2022-06-28,910,0,955,910,925,15
446,MAPI,2022-06-29,925,0,990,925,965,40
447,MAPI,2022-06-30,965,0,990,960,980,15
448,MAPI,2022-07-01,980,0,980,915,915,-65
449,MAPI,2022-07-04,915,0,935,880,900,-15
450,MAPI,2022-07-05,900,0,915,890,900,0
451,MAPI,2022-07-06,900,0,920,885,900,0
452,MAPI,2022-07-07,900,0,925,890,925,25
453,MAPI,2022-07-08,925,0,930,905,910,-15
454,MAPI,2022-07-11,910,0,925,890,895,-15
455,MAPI,2022-07-12,895,0,915,890,895,0
456,MAPI,2022-07-13,895,0,900,850,850,-45
457,MAPI,2022-07-14,850,0,895,830,870,20
458,MAPI,2022-07-15,870,0,900,880,895,25
459,MAPI,2022-07-18,895,0,905,870,880,-15
460,MAPI,2022-07-19,880,0,920,875,920,40
461,MAPI,2022-07-20,920,0,980,915,940,20
462,MAPI,2022-07-21,940,0,960,915,915,-25
463,MAPI,2022-07-22,915,0,935,900,920,5
464,MAPI,2022-07-25,920,0,940,920,940,20
465,MAPI,2022-07-26,940,0,940,910,920,-20
466,MAPI,2022-07-27,920,0,930,905,910,-10
467,MAPI,2022-07-28,910,0,920,880,880,-30
468,MAPI,2022-07-29,880,0,905,880,890,10
469,MAPI,2022-08-01,890,0,930,890,930,40
470,MAPI,2022-08-02,930,0,1000,895,1000,70
471,MAPI,2022-08-03,1000,0,980,930,930,-70
472,MAPI,2022-08-04,930,0,945,915,930,0
473,MAPI,2022-08-05,930,0,975,935,960,30
474,MAPI,2022-08-08,960,0,1060,970,980,20
475,MAPI,2022-08-09,980,0,1040,975,985,5
476,MAPI,2022-08-10,985,0,1000,955,965,-20
477,MAPI,2022-08-11,965,0,1010,970,980,15
478,MAPI,2022-08-12,980,0,1035,980,1020,40
479,MAPI,2022-08-15,1020,0,1040,1015,1020,0
480,MAPI,2022-08-16,1020,0,1075,1010,1025,5
481,MAPI,2022-08-18,1025,0,1075,1020,1065,40
482,MAPI,2022-08-19,1065,0,1105,1060,1070,5
483,MAPI,2022-08-22,1070,0,1080,1000,1020,-50
484,MAPI,2022-08-23,1020,0,1035,1000,1015,-5
485,MAPI,2022-08-24,1015,0,1030,1005,1015,0
486,MAPI,2022-08-25,1015,0,1035,980,990,-25
487,MAPI,2022-08-26,990,0,1015,990,990,0
488,MAPI,2022-08-29,990,0,985,960,970,-20
489,MAPI,2022-08-30,970,0,1005,960,980,10
490,MAPI,2022-08-31,980,0,1035,980,1010,30
491,MAPI,2022-09-01,1010,0,1025,1000,1010,0
492,MAPI,2022-09-02,1010,0,1060,1010,1050,40
493,MAPI,2022-09-05,1050,0,1050,1010,1020,-30
494,MAPI,2022-09-06,1020,0,1030,990,990,-30
495,MAPI,2022-09-07,990,0,1005,955,965,-25
496,MAPI,2022-09-08,965,0,995,965,985,20
497,MAPI,2022-09-09,985,0,995,975,995,10
498,MAPI,2022-09-12,995,0,1060,995,1055,60
499,MAPI,2022-09-13,1055,0,1060,1015,1020,-35
500,MAPI,2022-09-14,1020,0,1050,1005,1050,30
501,MAPI,2022-09-15,1050,0,1115,1050,1095,45
502,MAPI,2022-09-16,1095,0,1125,1065,1080,-15
503,MAPI,2022-09-19,1080,0,1115,1070,1100,20
504,MAPI,2022-09-20,1100,0,1145,1090,1135,35
505,MAPI,2022-09-21,1135,0,1150,1100,1140,5
506,MAPI,2022-09-22,1140,0,1160,1110,1120,-20
507,MAPI,2022-09-23,1120,0,1155,1075,1080,-40
508,MAPI,2022-09-26,1080,0,1130,1065,1120,40
509,MAPI,2022-09-27,1120,0,1130,1080,1115,-5
510,MAPI,2022-09-28,1115,0,1115,1045,1050,-65
511,MAPI,2022-09-29,1050,0,1105,1000,1060,10
512,MAPI,2022-09-30,1060,0,1075,1035,1060,0
513,MAPI,2022-10-03,1060,0,1070,1040,1050,-10
514,MAPI,2022-10-04,1050,0,1085,1015,1020,-30
515,MAPI,2022-10-05,1020,0,1045,1020,1030,10
516,MAPI,2022-10-06,1030,0,1085,1030,1070,40
517,MAPI,2022-10-07,1070,0,1115,1050,1115,45
518,MAPI,2022-10-10,1115,0,1115,1065,1075,-40
519,MAPI,2022-10-11,1075,0,1155,1070,1155,80
520,MAPI,2022-10-12,1155,0,1190,1125,1190,35
521,MAPI,2022-10-13,1190,0,1200,1150,1200,10
522,MAPI,2022-10-14,1200,0,1250,1170,1190,-10
523,MAPI,2022-10-17,1190,0,1200,1125,1160,-30
524,MAPI,2022-10-18,1160,0,1180,1140,1140,-20
525,MAPI,2022-10-19,1140,0,1250,1130,1215,75
526,MAPI,2022-10-20,1215,0,1270,1185,1250,35
527,MAPI,2022-10-21,1250,0,1250,1200,1225,-25
528,MAPI,2022-10-24,1225,0,1265,1205,1240,15
529,MAPI,2022-10-25,1240,0,1240,1190,1200,-40
530,MAPI,2022-10-26,1200,0,1265,1180,1185,-15
531,MAPI,2022-10-27,1185,0,1330,1180,1250,65
532,MAPI,2022-10-28,1250,0,1260,1205,1235,-15
533,MAPI,2022-10-31,1235,0,1260,1205,1205,-30
534,MAPI,2022-11-01,1205,0,1310,1205,1305,100
535,MAPI,2022-11-02,1305,0,1350,1280,1350,45
536,MAPI,2022-11-03,1350,0,1355,1310,1335,-15
537,MAPI,2022-11-04,1335,0,1345,1275,1290,-45
538,MAPI,2022-11-07,1290,0,1320,1290,1305,15
539,MAPI,2022-11-08,1305,0,1310,1265,1290,-15
540,MAPI,2022-11-09,1290,0,1310,1275,1300,10
541,MAPI,2022-11-10,1300,0,1305,1275,1300,0
542,MAPI,2022-11-11,1300,0,1365,1260,1310,10
543,MAPI,2022-11-14,1310,0,1310,1260,1300,-10
544,MAPI,2022-11-15,1300,0,1310,1260,1270,-30
545,MAPI,2022-11-16,1270,0,1285,1235,1250,-20
546,MAPI,2022-11-17,1250,0,1265,1190,1200,-50
547,MAPI,2022-11-18,1200,0,1275,1190,1260,60
548,MAPI,2022-11-21,1260,0,1340,1255,1340,80
549,MAPI,2022-11-22,1340,0,1345,1315,1330,-10
550,MAPI,2022-11-23,1330,0,1385,1305,1345,15
551,MAPI,2022-11-24,1345,0,1385,1340,1365,20
552,MAPI,2022-11-25,1365,0,1385,1340,1365,0
553,MAPI,2022-11-28,1365,0,1375,1335,1375,10
554,MAPI,2022-11-29,1375,0,1530,1355,1390,15
555,MAPI,2022-11-30,1390,0,1480,1390,1450,60
556,MAPI,2022-12-01,1450,0,1455,1410,1425,-25
557,MAPI,2022-12-02,1425,0,1475,1410,1475,50
558,MAPI,2022-12-05,1475,0,1480,1410,1435,-40
559,MAPI,2022-12-06,1435,0,1435,1345,1400,-35
560,MAPI,2022-12-07,1400,0,1440,1390,1420,20
561,MAPI,2022-12-08,1420,0,1470,1400,1460,40
562,MAPI,2022-12-09,1460,0,1475,1390,1425,-35
563,MAPI,2022-12-12,1425,0,1450,1390,1400,-25
564,MAPI,2022-12-13,1400,0,1430,1385,1420,20
565,MAPI,2022-12-14,1420,0,1420,1385,1400,-20
566,MAPI,2022-12-15,1400,0,1400,1350,1360,-40
567,MAPI,2022-12-16,1360,0,1360,1270,1305,-55
568,MAPI,2022-12-19,1305,0,1375,1305,1335,30
569,MAPI,2022-12-20,1335,0,1440,1335,1435,100
570,MAPI,2022-12-21,1435,0,1445,1400,1420,-15
571,MAPI,2022-12-22,1420,0,1460,1420,1425,5
572,MAPI,2022-12-23,1425,0,1445,1420,1445,20
573,MAPI,2022-12-26,1445,0,1455,1370,1380,-65
574,MAPI,2022-12-27,1380,0,1440,1375,1410,30
575,MAPI,2022-12-28,1410,0,1415,1385,1415,5
576,MAPI,2022-12-29,1415,0,1430,1395,1415,0
577,MAPI,2022-12-30,1415,0,1450,1395,1445,30
