,stock_code,date,prev,open,high,low,close,change
0,UNTR,2024-01-02,22625,22600,23575,22600,23475,850
1,UNTR,2024-01-03,23475,23200,23400,22600,23225,-250
2,UNTR,2024-01-04,23225,23225,23500,23225,23275,50
3,UNTR,2024-01-05,23275,23500,23550,23250,23250,-25
4,UNTR,2024-01-08,23250,23300,23525,23000,23025,-225
5,UNTR,2024-01-09,23025,23200,23350,23025,23100,75
6,UNTR,2024-01-10,23100,23100,23450,23100,23300,200
7,UNTR,2024-01-10,23100,23100,23450,23100,23300,200
8,UNTR,2024-01-11,23300,23350,23450,23250,23300,0
9,UNTR,2024-01-12,23300,23350,23925,23325,23900,600
10,UNTR,2024-01-15,23900,23900,24750,23900,24725,825
11,UNTR,2024-01-16,24725,24750,24800,24375,24600,-125
12,UNTR,2024-01-17,24600,25000,25000,24200,24225,-375
13,UNTR,2024-01-18,24225,24225,24550,24050,24100,-125
14,UNTR,2024-01-19,24100,24200,24300,23825,24075,-25
15,UNTR,2024-01-22,24075,24075,24075,23225,23250,-825
16,UNTR,2024-01-23,23250,23275,23425,22400,22700,-550
17,UNTR,2024-01-24,22700,22800,22850,22325,22550,-150
18,UNTR,2024-01-25,22550,22475,23250,22475,23125,575
19,UNTR,2024-01-26,23125,23150,23250,22925,22975,-150
20,UNTR,2024-01-29,22975,23025,23325,23025,23325,350
21,UNTR,2024-01-30,23325,23325,23325,22800,22850,-475
22,UNTR,2024-01-31,22850,23025,23200,22875,22950,100
23,UNTR,2024-02-01,22950,22925,23075,22575,22800,-150
24,UNTR,2024-02-02,22800,22850,22950,22725,22850,50
25,UNTR,2024-02-05,22850,22850,22925,22675,22675,-175
26,UNTR,2024-02-06,22675,22700,22975,22700,22800,125
27,UNTR,2024-02-07,22800,22850,23100,22825,22900,100
28,UNTR,2024-02-12,22900,22900,23325,22900,23225,325
29,UNTR,2024-02-13,23225,23225,23450,23050,23150,-75
30,UNTR,2024-02-15,23150,23325,23450,23125,23200,50
31,UNTR,2024-02-16,23200,23250,23400,23100,23250,50
32,UNTR,2024-02-19,23250,23250,23275,22900,22950,-300
33,UNTR,2024-02-20,22950,22975,23075,22750,22900,-50
34,UNTR,2024-02-21,22900,22925,23175,22900,23025,125
35,UNTR,2024-02-22,23025,23075,23150,23000,23125,100
36,UNTR,2024-02-23,23125,23150,23150,22800,22800,-325
37,UNTR,2024-02-26,22800,22900,23100,22875,23000,200
38,UNTR,2024-02-27,23000,23000,23850,22825,23850,850
39,UNTR,2024-02-28,23850,24000,24350,23800,23850,0
40,UNTR,2024-02-29,23850,23875,23950,23500,23525,-325
41,UNTR,2024-03-01,23525,23525,23775,23450,23725,200
42,UNTR,2024-03-04,23725,23775,24175,23775,24000,275
43,UNTR,2024-03-05,24000,24025,24375,24025,24125,125
44,UNTR,2024-03-06,24125,24200,24400,24025,24325,200
45,UNTR,2024-03-07,24325,24325,24400,24000,24000,-325
46,UNTR,2024-03-08,24000,24025,24325,24025,24175,175
47,UNTR,2024-03-13,24175,24125,24150,23500,23525,-650
48,UNTR,2024-03-14,23525,23575,24125,23550,24125,600
49,UNTR,2024-03-15,24125,24125,24775,24000,24175,50
50,UNTR,2024-03-18,24175,24225,24575,24225,24275,100
51,UNTR,2024-03-19,24275,24300,24475,24275,24375,100
52,UNTR,2024-03-20,24375,24375,24550,24375,24550,175
53,UNTR,2024-03-21,24550,24550,24900,24550,24775,225
54,UNTR,2024-03-22,24775,24775,24775,24525,24600,-175
55,UNTR,2024-03-25,24600,24700,24825,24400,24550,-50
56,UNTR,2024-03-26,24550,24550,24650,24225,24300,-250
57,UNTR,2024-03-27,24300,24450,24700,24450,24600,300
58,UNTR,2024-03-28,24600,24625,24650,24175,24175,-425
59,UNTR,2024-04-01,24175,24350,24350,23850,24025,-150
60,UNTR,2024-04-02,24025,24100,24900,24025,24900,875
61,UNTR,2024-04-03,24900,24900,25375,24700,25250,350
62,UNTR,2024-04-04,25250,25250,25275,25000,25050,-200
63,UNTR,2024-04-05,25050,25125,25425,25125,25250,200
64,UNTR,2024-04-16,25250,25225,26400,25000,26250,1000
65,UNTR,2024-04-17,26250,26300,26300,25575,25575,-675
66,UNTR,2024-04-18,25575,25575,25825,25200,25525,-50
67,UNTR,2024-04-19,25525,25675,25725,25200,25350,-175
68,UNTR,2024-04-22,25350,25525,25675,25225,25300,-50
69,UNTR,2024-04-23,25300,25300,25400,24800,24950,-350
70,UNTR,2024-04-24,24950,25050,25450,24450,24850,-100
71,UNTR,2024-04-25,24850,24850,25000,24100,24250,-600
72,UNTR,2024-04-26,24250,24300,24450,24150,24150,-100
73,UNTR,2024-04-29,24150,24200,25100,23850,24875,725
74,UNTR,2024-04-30,24875,24575,25100,24550,24825,-50
75,UNTR,2024-05-02,24825,24850,24850,24100,24300,-525
76,UNTR,2024-05-03,24300,24300,24425,23850,23950,-350
77,UNTR,2024-05-06,23950,22500,22525,22250,22400,-1550
78,UNTR,2024-05-07,22400,22400,22400,22150,22250,-150
79,UNTR,2024-05-08,22250,22300,22375,22050,22100,-150
80,UNTR,2024-05-13,22100,22100,22300,22050,22200,100
81,UNTR,2024-05-14,22200,22300,22650,22150,22500,300
82,UNTR,2024-05-15,22500,22550,22650,22250,22250,-250
83,UNTR,2024-05-16,22250,22325,22400,22100,22150,-100
84,UNTR,2024-05-17,22150,22150,22350,22150,22300,150
85,UNTR,2024-05-20,22300,22300,22850,22300,22850,550
86,UNTR,2024-05-21,22850,22950,22950,22325,22425,-425
87,UNTR,2024-05-22,22425,22400,22625,22200,22600,175
88,UNTR,2024-05-27,22600,22600,22650,22400,22625,25
89,UNTR,2024-05-28,22625,22675,22700,22325,22475,-150
90,UNTR,2024-05-29,22475,22500,22525,22275,22525,50
91,UNTR,2024-05-30,22525,22500,22500,22125,22275,-250
92,UNTR,2024-05-31,22275,22350,22650,22075,22075,-200
93,UNTR,2023-01-02,26075,26100,26150,25800,25800,-275
94,UNTR,2023-01-03,25800,25850,26000,25700,25900,100
95,UNTR,2023-01-04,25900,25900,26000,24150,24150,-1750
96,UNTR,2023-01-05,24150,24025,24900,23600,24675,525
97,UNTR,2023-01-06,24675,24825,25200,24500,24975,300
98,UNTR,2023-01-09,24975,25000,25200,24275,24700,-275
99,UNTR,2023-01-10,24700,24575,25250,24300,24950,250
100,UNTR,2023-01-11,24950,24725,25075,24400,25075,125
101,UNTR,2023-01-12,25075,24900,25125,24800,24950,-125
102,UNTR,2023-01-13,24950,25000,25025,24025,24150,-800
103,UNTR,2023-01-16,24150,24175,24350,24100,24225,75
104,UNTR,2023-01-17,24225,24225,24600,24225,24325,100
105,UNTR,2023-01-18,24325,24300,24750,24275,24750,425
106,UNTR,2023-01-19,24750,24650,26275,24600,26250,1500
107,UNTR,2023-01-20,26250,26350,26775,25950,26775,525
108,UNTR,2023-01-24,26775,26775,26925,26025,26125,-650
109,UNTR,2023-01-25,26125,26125,26125,25725,26050,-75
110,UNTR,2023-01-26,26050,25900,25900,25250,25250,-800
111,UNTR,2023-01-27,25250,25275,25800,25275,25575,325
112,UNTR,2023-01-30,25575,25275,25775,24950,25250,-325
113,UNTR,2023-01-31,25250,25200,25350,24550,24550,-700
114,UNTR,2023-02-01,24550,24600,25025,24575,24725,175
115,UNTR,2023-02-02,24725,24725,25000,24100,24100,-625
116,UNTR,2023-02-03,24100,24175,24350,23950,24000,-100
117,UNTR,2023-02-06,24000,24000,24225,23800,23925,-75
118,UNTR,2023-02-07,23925,24425,25375,24300,24900,975
119,UNTR,2023-02-08,24900,25100,25275,24650,24800,-100
120,UNTR,2023-02-09,24800,24575,24925,24500,24500,-300
121,UNTR,2023-02-10,24500,24225,24600,24200,24500,0
122,UNTR,2023-02-13,24500,24800,24875,24450,24625,125
123,UNTR,2023-02-14,24625,24650,24750,24450,24750,125
124,UNTR,2023-02-15,24750,24775,25200,24525,24875,125
125,UNTR,2023-02-16,24875,24900,24975,24550,24650,-225
126,UNTR,2023-02-17,24650,24575,24650,24350,24625,-25
127,UNTR,2023-02-20,24625,24525,24525,24000,24300,-325
128,UNTR,2023-02-21,24300,24300,24400,24000,24000,-300
129,UNTR,2023-02-22,24000,24250,24400,24050,24325,325
130,UNTR,2023-02-23,24325,24475,24900,24375,24700,375
131,UNTR,2023-02-24,24700,24900,25200,24800,24950,250
132,UNTR,2023-02-27,24950,25025,25200,24900,25175,225
133,UNTR,2023-02-28,25175,29200,30150,27750,27900,2725
134,UNTR,2023-03-01,27900,28050,28350,27550,27575,-325
135,UNTR,2023-03-02,27575,27700,28450,27650,28325,750
136,UNTR,2023-03-03,28325,28375,28475,28000,28125,-200
137,UNTR,2023-03-06,28125,28175,28275,27650,27650,-475
138,UNTR,2023-03-07,27650,27650,27675,26800,26825,-825
139,UNTR,2023-03-08,26825,26725,26875,26200,26400,-425
140,UNTR,2023-03-09,26400,26825,27425,26600,27025,625
141,UNTR,2023-03-10,27025,27000,27150,26600,26825,-200
142,UNTR,2023-03-13,26825,27300,28175,27125,28075,1250
143,UNTR,2023-03-14,28075,28025,28025,27100,27100,-975
144,UNTR,2023-03-15,27100,27700,27700,27225,27250,150
145,UNTR,2023-03-16,27250,26900,27300,26475,26925,-325
146,UNTR,2023-03-17,26925,27000,28450,27000,28450,1525
147,UNTR,2023-03-20,28450,28250,28275,27425,27700,-750
148,UNTR,2023-03-21,27700,27725,27775,27450,27475,-225
149,UNTR,2023-03-24,27475,27875,28225,27525,27675,200
150,UNTR,2023-03-27,27675,27825,28200,27675,27800,125
151,UNTR,2023-03-28,27800,27825,28650,27700,28575,775
152,UNTR,2023-03-29,28575,28750,29450,28700,29125,550
153,UNTR,2023-03-30,29125,29000,29425,28975,28975,-150
154,UNTR,2023-03-31,28975,29000,29100,28700,29100,125
155,UNTR,2023-04-03,29100,29150,29350,28800,28850,-250
156,UNTR,2023-04-04,28850,29100,29700,29025,29625,775
157,UNTR,2023-04-05,29625,29475,30125,29325,29800,175
158,UNTR,2023-04-06,29800,30000,30075,29725,29800,0
159,UNTR,2023-04-10,29800,30000,30200,29800,30200,400
160,UNTR,2023-04-11,30200,30250,30800,30025,30400,200
161,UNTR,2023-04-12,30400,30600,31700,30200,31250,850
162,UNTR,2023-04-13,31250,31400,31500,31050,31050,-200
163,UNTR,2023-04-14,31050,31000,31150,30225,30225,-825
164,UNTR,2023-04-17,30225,30300,31125,30300,30500,275
165,UNTR,2023-04-18,30500,30650,31250,30650,31075,575
166,UNTR,2023-04-26,31075,31200,31500,31200,31400,325
167,UNTR,2023-04-27,31400,31400,31400,31000,31075,-325
168,UNTR,2023-04-28,31075,28900,28900,28900,28900,-2175
169,UNTR,2023-05-02,28900,26900,26900,26900,26900,-2000
170,UNTR,2023-05-03,26900,25025,25025,25025,25025,-1875
171,UNTR,2023-05-04,25025,24900,24975,24500,24500,-525
172,UNTR,2023-05-05,24500,24400,24400,23975,24150,-350
173,UNTR,2023-05-08,24150,24175,25200,24100,25000,850
174,UNTR,2023-05-09,25000,25025,25400,25025,25275,275
175,UNTR,2023-05-10,25275,25350,25500,25250,25275,0
176,UNTR,2023-05-11,25275,25175,25175,24675,24825,-450
177,UNTR,2023-05-12,24825,24775,25225,24675,24800,-25
178,UNTR,2023-05-15,24800,24800,25000,24450,24500,-300
179,UNTR,2023-05-16,24500,24500,24675,24450,24450,-50
180,UNTR,2023-05-17,24450,24425,24700,24025,24025,-425
181,UNTR,2023-05-19,24025,24025,24525,23300,23300,-725
182,UNTR,2023-05-22,23300,23525,24275,23525,23875,575
183,UNTR,2023-05-23,23875,24050,24800,24050,24500,625
184,UNTR,2023-05-24,24500,24500,24675,24300,24600,100
185,UNTR,2023-05-25,24600,24500,24500,23500,23500,-1100
186,UNTR,2023-05-26,23500,23475,23525,23000,23075,-425
187,UNTR,2023-05-29,23075,23100,23400,22625,22875,-200
188,UNTR,2023-05-30,22875,22800,23000,22500,22500,-375
189,UNTR,2023-05-31,22500,22325,22800,22200,22225,-275
190,UNTR,2023-06-05,22225,22525,23475,22525,22850,625
191,UNTR,2023-06-06,22850,23225,23350,22875,23200,350
192,UNTR,2023-06-07,23200,23050,23125,22775,22850,-350
193,UNTR,2023-06-08,22850,23150,23325,23000,23325,475
194,UNTR,2023-06-09,23325,23700,23775,22825,23075,-250
195,UNTR,2023-06-12,23075,23100,23525,23075,23525,450
196,UNTR,2023-06-13,23525,23600,23600,22925,22975,-550
197,UNTR,2023-06-14,22975,23100,23225,22975,22975,0
198,UNTR,2023-06-15,22975,23150,23225,22925,23150,175
199,UNTR,2023-06-16,23150,23325,23550,22900,22900,-250
200,UNTR,2023-06-19,22900,22950,23150,22725,23150,250
201,UNTR,2023-06-20,23150,23200,23225,22950,23125,-25
202,UNTR,2023-06-21,23125,23175,23375,23000,23350,225
203,UNTR,2023-06-22,23350,23500,23775,23350,23525,175
204,UNTR,2023-06-23,23525,23525,23675,23150,23375,-150
205,UNTR,2023-06-26,23375,23400,23425,23075,23275,-100
206,UNTR,2023-06-27,23275,23275,23325,23125,23275,0
207,UNTR,2023-07-03,23275,23325,23375,22825,23050,-225
208,UNTR,2023-07-04,23050,23150,23250,23050,23100,50
209,UNTR,2023-07-05,23100,23200,23775,23150,23700,600
210,UNTR,2023-07-06,23700,23950,24075,23825,24050,350
211,UNTR,2023-07-07,24050,23900,24000,23600,23750,-300
212,UNTR,2023-07-10,23750,23900,24150,23875,24100,350
213,UNTR,2023-07-11,24100,24100,24475,24075,24475,375
214,UNTR,2023-07-12,24475,24475,24475,24000,24000,-475
215,UNTR,2023-07-13,24000,24000,24225,23975,24150,150
216,UNTR,2023-07-14,24150,24200,24275,24050,24150,0
217,UNTR,2023-07-17,24150,24300,24400,24200,24225,75
218,UNTR,2023-07-18,24225,24250,24450,24050,24250,25
219,UNTR,2023-07-20,24250,24575,24575,24225,24375,125
220,UNTR,2023-07-21,24375,24400,24500,24275,24500,125
221,UNTR,2023-07-24,24500,24525,25600,24525,25400,900
222,UNTR,2023-07-25,25400,25500,25800,25400,25400,0
223,UNTR,2023-07-26,25400,25525,26575,25525,26400,1000
224,UNTR,2023-07-27,26400,26425,26750,26100,26375,-25
225,UNTR,2023-07-28,26375,26400,26650,26025,26650,275
226,UNTR,2023-07-31,26650,27450,27650,27075,27525,875
227,UNTR,2023-08-01,27525,27625,27700,27150,27525,0
228,UNTR,2023-08-02,27525,27500,27500,26500,26725,-800
229,UNTR,2023-08-03,26725,26725,27375,26725,27150,425
230,UNTR,2023-08-04,27150,27250,27725,27250,27325,175
231,UNTR,2023-08-07,27325,27525,27675,27300,27425,100
232,UNTR,2023-08-08,27425,27525,27700,27500,27525,100
233,UNTR,2023-08-09,27525,27575,27850,27575,27750,225
234,UNTR,2023-08-10,27750,27850,27975,27600,27600,-150
235,UNTR,2023-08-11,27600,27600,27625,26800,27100,-500
236,UNTR,2023-08-14,27100,27200,27450,26850,27450,350
237,UNTR,2023-08-15,27450,27500,27500,27150,27375,-75
238,UNTR,2023-08-16,27375,27375,27500,27175,27500,125
239,UNTR,2023-08-18,27500,27325,27375,26800,26800,-700
240,UNTR,2023-08-21,26800,26800,27300,26800,27075,275
241,UNTR,2023-08-22,27075,27225,27650,27150,27600,525
242,UNTR,2023-08-23,27600,27850,28150,27800,27875,275
243,UNTR,2023-08-24,27875,27775,27775,26700,26700,-1175
244,UNTR,2023-08-25,26700,26700,26725,25975,26050,-650
245,UNTR,2023-08-28,26050,26125,26600,26125,26400,350
246,UNTR,2023-08-29,26400,26500,26600,26300,26350,-50
247,UNTR,2023-08-30,26350,26350,26400,26150,26150,-200
248,UNTR,2023-08-31,26150,26150,26250,26000,26000,-150
249,UNTR,2023-09-01,26000,26000,26425,26000,26350,350
250,UNTR,2023-09-04,26350,26425,26875,26425,26825,475
251,UNTR,2023-09-05,26825,26850,27350,26850,27200,375
252,UNTR,2023-09-06,27200,27400,27525,27350,27400,200
253,UNTR,2023-09-07,27400,27400,27425,26950,27150,-250
254,UNTR,2023-09-08,27150,27125,27475,26975,27300,150
255,UNTR,2023-09-11,27300,27325,27350,26850,26900,-400
256,UNTR,2023-09-12,26900,26950,27250,26925,27075,175
257,UNTR,2023-09-13,27075,27150,27275,27075,27175,100
258,UNTR,2023-09-14,27175,27325,27600,27325,27400,225
259,UNTR,2023-09-15,27400,27400,28425,27250,28425,1025
260,UNTR,2023-09-18,28425,28375,28600,28100,28100,-325
261,UNTR,2023-09-19,28100,28150,28450,28025,28325,225
262,UNTR,2023-09-20,28325,28400,28775,28400,28500,175
263,UNTR,2023-09-21,28500,28475,28475,28250,28325,-175
264,UNTR,2023-09-22,28325,28250,28525,28175,28350,25
265,UNTR,2023-09-25,28350,28350,28375,28150,28250,-100
266,UNTR,2023-09-26,28250,28275,28400,27625,27750,-500
267,UNTR,2023-09-27,27750,27700,28300,27475,28300,550
268,UNTR,2023-09-29,28300,28400,28475,28100,28250,-50
269,UNTR,2023-10-02,28250,28225,28350,27850,27925,-325
270,UNTR,2023-10-03,27925,27925,27925,27000,27000,-925
271,UNTR,2023-10-04,27000,26675,26675,26275,26575,-425
272,UNTR,2023-10-05,26575,26575,26575,26150,26150,-425
273,UNTR,2023-10-06,26150,26175,26525,26175,26400,250
274,UNTR,2023-10-09,26400,26600,26875,26600,26700,300
275,UNTR,2023-10-10,26700,26875,26950,26725,26875,175
276,UNTR,2023-10-11,26875,26300,26375,26250,26275,-600
277,UNTR,2023-10-12,26275,26275,26275,25850,25875,-400
278,UNTR,2023-10-13,25875,26000,26325,26000,26075,200
279,UNTR,2023-10-16,26075,26375,26450,26200,26450,375
280,UNTR,2023-10-17,26450,26450,26475,26250,26375,-75
281,UNTR,2023-10-18,26375,26275,26425,26100,26300,-75
282,UNTR,2023-10-19,26300,26400,26400,26000,26025,-275
283,UNTR,2023-10-20,26025,26000,26050,25800,25825,-200
284,UNTR,2023-10-23,25825,25825,25850,25000,25000,-825
285,UNTR,2023-10-24,25000,25000,25425,24850,25250,250
286,UNTR,2023-10-25,25250,25700,26800,25700,26325,1075
287,UNTR,2023-10-26,26325,26200,26500,26000,26175,-150
288,UNTR,2023-10-27,26175,26175,26250,25525,25525,-650
289,UNTR,2023-10-30,25525,25525,25525,24300,24400,-1125
290,UNTR,2023-10-31,24400,24425,25300,24425,25125,725
291,UNTR,2023-11-01,25125,25100,25100,24100,24100,-1025
292,UNTR,2023-11-02,24100,24125,24350,23725,23725,-375
293,UNTR,2023-11-03,23725,23800,24050,23775,23775,50
294,UNTR,2023-11-06,23775,23825,23850,23550,23750,-25
295,UNTR,2023-11-07,23750,23775,24075,23225,23375,-375
296,UNTR,2023-11-08,23375,23375,23400,22700,22800,-575
297,UNTR,2023-11-09,22800,23000,23125,22875,22875,75
298,UNTR,2023-11-10,22875,22900,23175,22900,23100,225
299,UNTR,2023-11-13,23100,23100,23500,23100,23250,150
300,UNTR,2023-11-14,23250,23300,23475,23225,23250,0
301,UNTR,2023-11-15,23250,23300,23900,23300,23400,150
302,UNTR,2023-11-16,23400,23425,23600,23050,23450,50
303,UNTR,2023-11-17,23450,23450,23450,22800,22875,-575
304,UNTR,2023-11-20,22875,22900,23000,22750,22950,75
305,UNTR,2023-11-21,22950,22950,22950,22700,22775,-175
306,UNTR,2023-11-22,22775,22775,22775,22275,22325,-450
307,UNTR,2023-11-23,22325,22500,22575,22325,22525,200
308,UNTR,2023-11-24,22525,22575,22650,22475,22625,100
309,UNTR,2023-11-27,22625,22625,22875,22450,22450,-175
310,UNTR,2023-11-28,22450,22500,22725,22325,22500,50
311,UNTR,2023-11-29,22500,22600,22600,22300,22450,-50
312,UNTR,2023-11-30,22450,22450,22500,21900,21900,-550
313,UNTR,2023-12-01,21900,22025,22350,22000,22150,250
314,UNTR,2023-12-04,22150,22200,22675,22200,22425,275
315,UNTR,2023-12-05,22425,22425,22450,22025,22050,-375
316,UNTR,2023-12-06,22050,22050,22150,21600,21625,-425
317,UNTR,2023-12-07,21625,21675,21850,21425,21700,75
318,UNTR,2023-12-08,21700,21800,22350,21725,22300,600
319,UNTR,2023-12-11,22300,22425,22450,21825,21825,-475
320,UNTR,2023-12-12,21825,22000,22025,21850,21850,25
321,UNTR,2023-12-13,21850,21700,21725,20925,20925,-925
322,UNTR,2023-12-14,20925,21075,21675,21000,21450,525
323,UNTR,2023-12-15,21450,21500,21950,21275,21275,-175
324,UNTR,2023-12-18,21275,21425,21850,21375,21800,525
325,UNTR,2023-12-19,21800,21750,21825,21450,21825,25
326,UNTR,2023-12-20,21825,21875,22250,21800,21800,-25
327,UNTR,2023-12-21,21800,21800,22075,21775,22000,200
328,UNTR,2023-12-22,22000,22050,22150,21850,22025,25
329,UNTR,2023-12-27,22025,22025,22625,21975,22425,400
330,UNTR,2023-12-28,22425,22525,22775,22450,22700,275
331,UNTR,2023-12-29,22700,22700,22750,22500,22625,-75
332,UNTR,2022-01-03,22150,21900,22125,21750,21825,-325
333,UNTR,2022-01-04,21825,21850,22125,21800,21925,100
334,UNTR,2022-01-05,21925,21925,22450,21725,21950,25
335,UNTR,2022-01-06,21950,21850,21950,21450,21725,-225
336,UNTR,2022-01-07,21725,21900,22375,21750,22175,450
337,UNTR,2022-01-10,22175,22300,22300,21800,21800,-375
338,UNTR,2022-01-11,21800,22050,22175,21750,21750,-50
339,UNTR,2022-01-12,21750,22000,22275,21750,22100,350
340,UNTR,2022-01-13,22100,22075,22675,21925,22675,575
341,UNTR,2022-01-14,22675,22575,23550,22475,23525,850
342,UNTR,2022-01-17,23525,23550,23900,23425,23500,-25
343,UNTR,2022-01-18,23500,23500,23700,23050,23650,150
344,UNTR,2022-01-19,23650,23650,23700,23250,23250,-400
345,UNTR,2022-01-20,23250,23100,23475,22675,22850,-400
346,UNTR,2022-01-21,22850,22850,23500,22725,23500,650
347,UNTR,2022-01-24,23500,23650,23650,23225,23400,-100
348,UNTR,2022-01-25,23400,23400,23450,23000,23150,-250
349,UNTR,2022-01-26,23150,23175,23425,22750,22775,-375
350,UNTR,2022-01-27,22775,22725,23275,22525,23250,475
351,UNTR,2022-01-28,23250,23250,23350,23100,23250,0
352,UNTR,2022-01-31,23250,23475,23500,23125,23125,-125
353,UNTR,2022-02-02,23125,23075,23075,22650,22925,-200
354,UNTR,2022-02-03,22925,22725,22925,22250,22825,-100
355,UNTR,2022-02-04,22825,22825,22825,22375,22500,-325
356,UNTR,2022-02-07,22500,22550,22950,22425,22600,100
357,UNTR,2022-02-08,22600,22700,23225,22100,22175,-425
358,UNTR,2022-02-09,22175,22425,22950,22400,22675,500
359,UNTR,2022-02-10,22675,22700,23200,22650,22800,125
360,UNTR,2022-02-11,22800,22775,23050,22600,23050,250
361,UNTR,2022-02-14,23050,23050,23625,23000,23450,400
362,UNTR,2022-02-15,23450,23500,24200,23500,24175,725
363,UNTR,2022-02-16,24175,24175,24225,23800,23800,-375
364,UNTR,2022-02-17,23800,23850,24025,23500,23725,-75
365,UNTR,2022-02-18,23725,23675,24075,23650,23925,200
366,UNTR,2022-02-21,23925,23975,24050,23400,23500,-425
367,UNTR,2022-02-22,23500,23500,23650,22900,23475,-25
368,UNTR,2022-02-23,23475,23500,24000,23200,24000,525
369,UNTR,2022-02-24,24000,24000,25550,23950,25200,1200
370,UNTR,2022-02-25,25200,25400,25750,24600,24900,-300
371,UNTR,2022-03-01,24900,25050,25150,24650,24850,-50
372,UNTR,2022-03-02,24850,25200,26250,25175,25525,675
373,UNTR,2022-03-04,25525,26225,27125,25750,27075,1550
374,UNTR,2022-03-07,27075,27100,27650,27100,27350,275
375,UNTR,2022-03-08,27350,27400,27750,25700,25700,-1650
376,UNTR,2022-03-09,25700,25950,26800,25950,26400,700
377,UNTR,2022-03-10,26400,26400,26400,24950,25950,-450
378,UNTR,2022-03-11,25950,25625,26900,25600,26700,750
379,UNTR,2022-03-14,26700,26700,26700,24850,24850,-1850
380,UNTR,2022-03-15,24850,24850,25175,24400,24475,-375
381,UNTR,2022-03-16,24475,24475,25275,24475,25000,525
382,UNTR,2022-03-17,25000,25225,25725,25125,25250,250
383,UNTR,2022-03-18,25250,25475,25600,25100,25425,175
384,UNTR,2022-03-21,25425,25475,25700,24925,25350,-75
385,UNTR,2022-03-22,25350,25350,25700,25225,25550,200
386,UNTR,2022-03-23,25550,25600,25850,25550,25725,175
387,UNTR,2022-03-24,25725,26225,27250,26200,26600,875
388,UNTR,2022-03-25,26600,26600,26950,26200,26325,-275
389,UNTR,2022-03-28,26325,26325,26950,26325,26600,275
390,UNTR,2022-03-29,26600,26300,26425,26025,26025,-575
391,UNTR,2022-03-30,26025,26000,26250,25600,25875,-150
392,UNTR,2022-03-31,25875,25875,26000,25550,25550,-325
393,UNTR,2022-04-01,25550,25775,26425,25475,25925,375
394,UNTR,2022-04-04,25925,26200,26775,26050,26775,850
395,UNTR,2022-04-05,26775,26800,27200,26550,27200,425
396,UNTR,2022-04-06,27200,27250,27475,27200,27450,250
397,UNTR,2022-04-07,27450,27475,27775,27150,27150,-300
398,UNTR,2022-04-08,27150,27350,29000,27350,28600,1450
399,UNTR,2022-04-11,28600,28700,29125,28225,28450,-150
400,UNTR,2022-04-12,28450,28450,28675,27800,27950,-500
401,UNTR,2022-04-13,27950,28500,29300,28300,29275,1325
402,UNTR,2022-04-14,29275,29500,30000,29300,29800,525
403,UNTR,2022-04-18,29800,29800,30000,29400,30000,200
404,UNTR,2022-04-19,30000,30025,30300,29425,29600,-400
405,UNTR,2022-04-20,29600,29100,29100,28300,28350,-1250
406,UNTR,2022-04-21,28350,28350,29150,28050,28125,-225
407,UNTR,2022-04-22,28125,28125,28700,27825,28300,175
408,UNTR,2022-04-25,28300,28200,28200,27325,27625,-675
409,UNTR,2022-04-26,27625,27650,28750,27650,28750,1125
410,UNTR,2022-04-27,28750,28850,29100,28750,28900,150
411,UNTR,2022-04-28,28900,30000,30800,29825,30275,1375
412,UNTR,2022-05-09,30275,31775,31875,28825,29225,-1050
413,UNTR,2022-05-10,29225,28750,29925,28025,29625,400
414,UNTR,2022-05-11,29625,29625,30400,29625,30225,600
415,UNTR,2022-05-12,30225,29625,30200,28925,29300,-925
416,UNTR,2022-05-13,29300,29300,30325,29300,30225,925
417,UNTR,2022-05-17,30225,30250,30775,29825,30075,-150
418,UNTR,2022-05-18,30075,30300,30400,30000,30300,225
419,UNTR,2022-05-19,30300,30175,30175,29350,29975,-325
420,UNTR,2022-05-20,29975,29725,30500,29700,29900,-75
421,UNTR,2022-05-23,29900,30025,30150,29200,29650,-250
422,UNTR,2022-05-24,29650,29650,30325,29625,30300,650
423,UNTR,2022-05-25,30300,30225,30800,29750,30175,-125
424,UNTR,2022-05-27,30175,30325,30400,30125,30400,225
425,UNTR,2022-05-30,30400,30700,30875,29925,30250,-150
426,UNTR,2022-05-31,30250,30500,31975,30300,31300,1050
427,UNTR,2022-06-02,31300,31975,32500,30975,31625,325
428,UNTR,2022-06-03,31625,32450,32725,31600,32600,975
429,UNTR,2022-06-06,32600,32600,32700,31825,32175,-425
430,UNTR,2022-06-07,32175,32700,33375,32500,32825,650
431,UNTR,2022-06-08,32825,33275,33300,32775,33050,225
432,UNTR,2022-06-09,33050,33050,33075,32275,32400,-650
433,UNTR,2022-06-10,32400,32400,32700,32000,32200,-200
434,UNTR,2022-06-13,32200,32025,32025,30175,30675,-1525
435,UNTR,2022-06-14,30675,30400,31550,30100,31550,875
436,UNTR,2022-06-15,31550,31550,31625,29700,29750,-1800
437,UNTR,2022-06-16,29750,30100,30900,29950,30000,250
438,UNTR,2022-06-17,30000,29525,29550,28800,28800,-1200
439,UNTR,2022-06-20,28800,28800,29125,28525,29000,200
440,UNTR,2022-06-21,29000,29500,29725,28825,29150,150
441,UNTR,2022-06-22,29150,29200,29525,29000,29200,50
442,UNTR,2022-06-23,29200,29450,29450,28650,29275,75
443,UNTR,2022-06-24,29275,29400,29700,29075,29275,0
444,UNTR,2022-06-27,29275,29500,29600,28975,29200,-75
445,UNTR,2022-06-28,29200,29400,29875,29300,29800,600
446,UNTR,2022-06-29,29800,29700,29700,28500,28525,-1275
447,UNTR,2022-06-30,28525,28400,28750,28200,28400,-125
448,UNTR,2022-07-01,28400,28400,28600,26425,26500,-1900
449,UNTR,2022-07-04,26500,26500,27350,26125,26525,25
450,UNTR,2022-07-05,26525,26875,28175,26875,27975,1450
451,UNTR,2022-07-06,27975,27875,27875,26375,26800,-1175
452,UNTR,2022-07-07,26800,26775,26925,26350,26775,-25
453,UNTR,2022-07-08,26775,27200,27600,26925,27450,675
454,UNTR,2022-07-11,27450,27450,27450,26900,27225,-225
455,UNTR,2022-07-12,27225,27250,27750,26775,26925,-300
456,UNTR,2022-07-13,26925,27750,28450,27600,28275,1350
457,UNTR,2022-07-14,28275,28300,29975,28300,29800,1525
458,UNTR,2022-07-15,29800,29700,29700,28925,29025,-775
459,UNTR,2022-07-18,29025,28950,29100,28625,28850,-175
460,UNTR,2022-07-19,28850,28825,29325,28600,29100,250
461,UNTR,2022-07-20,29100,29600,30350,29575,30175,1075
462,UNTR,2022-07-21,30175,30100,30200,29675,30000,-175
463,UNTR,2022-07-22,30000,30000,30225,29850,30075,75
464,UNTR,2022-07-25,30075,30075,30750,30075,30575,500
465,UNTR,2022-07-26,30575,30625,30675,30375,30600,25
466,UNTR,2022-07-27,30600,30625,31375,30500,31100,500
467,UNTR,2022-07-28,31100,31425,31475,30725,31300,200
468,UNTR,2022-07-29,31300,33000,33500,32225,32300,1000
469,UNTR,2022-08-01,32300,32150,32950,32075,32175,-125
470,UNTR,2022-08-02,32175,32400,33000,32325,32875,700
471,UNTR,2022-08-03,32875,32625,34000,32625,33950,1075
472,UNTR,2022-08-04,33950,33950,34050,33100,33200,-750
473,UNTR,2022-08-05,33200,33150,33150,32275,32500,-700
474,UNTR,2022-08-08,32500,32500,32750,32275,32400,-100
475,UNTR,2022-08-09,32400,32700,33675,32375,32375,-25
476,UNTR,2022-08-10,32375,32675,33075,32300,32350,-25
477,UNTR,2022-08-11,32350,32950,32950,31900,31900,-450
478,UNTR,2022-08-12,31900,31600,31850,31225,31600,-300
479,UNTR,2022-08-15,31600,31700,32675,31675,32500,900
480,UNTR,2022-08-16,32500,32600,32775,32025,32400,-100
481,UNTR,2022-08-18,32400,31925,32175,31725,32000,-400
482,UNTR,2022-08-19,32000,31925,32100,31650,31650,-350
483,UNTR,2022-08-22,31650,31925,32025,31450,31800,150
484,UNTR,2022-08-23,31800,31350,32375,31350,32125,325
485,UNTR,2022-08-24,32125,32375,32850,32125,32625,500
486,UNTR,2022-08-25,32625,32850,33000,32450,32950,325
487,UNTR,2022-08-26,32950,33150,33325,33025,33100,150
488,UNTR,2022-08-29,33100,32750,33000,32275,33000,-100
489,UNTR,2022-08-30,33000,33000,33825,32750,33325,325
490,UNTR,2022-08-31,33325,33075,33850,32700,33850,525
491,UNTR,2022-09-01,33850,33750,33750,33275,33275,-575
492,UNTR,2022-09-02,33275,33300,33950,33300,33900,625
493,UNTR,2022-09-05,33900,33850,34975,33675,34350,450
494,UNTR,2022-09-06,34350,34850,35925,34550,35500,1150
495,UNTR,2022-09-07,35500,35425,35425,34700,35075,-425
496,UNTR,2022-09-08,35075,35025,35500,34400,34400,-675
497,UNTR,2022-09-09,34400,34400,34500,34050,34300,-100
498,UNTR,2022-09-12,34300,34325,34825,34275,34500,200
499,UNTR,2022-09-13,34500,34500,34750,34325,34350,-150
500,UNTR,2022-09-14,34350,34000,34175,33750,34000,-350
501,UNTR,2022-09-15,34000,35000,36200,34825,34900,900
502,UNTR,2022-09-16,34900,34900,34900,33925,34325,-575
503,UNTR,2022-09-19,34325,34050,34925,33900,34300,-25
504,UNTR,2022-09-20,34300,34575,34950,34000,34150,-150
505,UNTR,2022-09-21,34150,34000,34450,33425,34325,175
506,UNTR,2022-09-22,34325,34200,35100,33925,35100,775
507,UNTR,2022-09-23,35100,35000,35000,34000,34000,-1100
508,UNTR,2022-09-26,34000,33300,33325,32000,33300,-700
509,UNTR,2022-09-27,33300,33300,33650,33075,33400,100
510,UNTR,2022-09-28,33400,33400,33725,33000,33000,-400
511,UNTR,2022-09-29,33000,33000,33750,32800,33125,125
512,UNTR,2022-09-30,33125,32875,33100,32575,32825,-300
513,UNTR,2022-10-03,32825,32825,33200,32675,33000,175
514,UNTR,2022-10-04,33000,33300,34100,33300,33800,800
515,UNTR,2022-10-05,33800,33125,34000,33075,33075,-725
516,UNTR,2022-10-06,33075,33375,33600,32800,32850,-225
517,UNTR,2022-10-07,32850,32950,33175,32700,33000,150
518,UNTR,2022-10-10,33000,32700,32700,32000,32300,-700
519,UNTR,2022-10-11,32300,32300,32600,32050,32200,-100
520,UNTR,2022-10-12,32200,32300,32600,31400,32350,150
521,UNTR,2022-10-13,32350,32425,32500,32000,32200,-150
522,UNTR,2022-10-14,32200,32350,33750,32350,33750,1550
523,UNTR,2022-10-17,33750,33600,33600,32550,32900,-850
524,UNTR,2022-10-18,32900,32725,32850,32000,32000,-900
525,UNTR,2022-10-19,32000,31700,32075,31500,31800,-200
526,UNTR,2022-10-20,31800,31850,32050,31600,31825,25
527,UNTR,2022-10-21,31825,31900,32525,31900,32000,175
528,UNTR,2022-10-24,32000,32000,32725,32000,32375,375
529,UNTR,2022-10-25,32375,32400,32750,31875,32000,-375
530,UNTR,2022-10-26,32000,32625,33200,32525,33200,1200
531,UNTR,2022-10-27,33200,33200,33725,32750,32750,-450
532,UNTR,2022-10-28,32750,32800,32975,32150,32250,-500
533,UNTR,2022-10-31,32250,32275,32750,32100,32300,50
534,UNTR,2022-11-01,32300,32400,32700,31400,31450,-850
535,UNTR,2022-11-02,31450,31200,31350,30325,30700,-750
536,UNTR,2022-11-03,30700,30675,31000,30150,31000,300
537,UNTR,2022-11-04,31000,31000,31275,30400,31275,275
538,UNTR,2022-11-07,31275,31225,31275,30700,31275,0
539,UNTR,2022-11-08,31275,31275,31275,30800,31175,-100
540,UNTR,2022-11-09,31175,31150,31150,30575,31000,-175
541,UNTR,2022-11-10,31000,30550,30550,29300,29400,-1600
542,UNTR,2022-11-11,29400,29500,29750,29000,29000,-400
543,UNTR,2022-11-14,29000,29000,29200,28500,28700,-300
544,UNTR,2022-11-15,28700,28125,28775,28125,28650,-50
545,UNTR,2022-11-16,28650,28700,28800,28300,28750,100
546,UNTR,2022-11-17,28750,28500,28700,28150,28625,-125
547,UNTR,2022-11-18,28625,28500,29050,28325,28800,175
548,UNTR,2022-11-21,28800,29100,29275,28675,28800,0
549,UNTR,2022-11-22,28800,28800,29200,28800,28950,150
550,UNTR,2022-11-23,28950,29050,29950,29050,29625,675
551,UNTR,2022-11-24,29625,29725,30100,29725,29975,350
552,UNTR,2022-11-25,29975,29950,30000,29500,29850,-125
553,UNTR,2022-11-28,29850,29775,30025,29675,29750,-100
554,UNTR,2022-11-29,29750,29750,30825,29750,30700,950
555,UNTR,2022-11-30,30700,30700,31250,30450,30800,100
556,UNTR,2022-12-01,30800,31000,31175,30525,30675,-125
557,UNTR,2022-12-02,30675,30600,30600,29225,29225,-1450
558,UNTR,2022-12-05,29225,29225,29500,28500,28500,-725
559,UNTR,2022-12-06,28500,28500,28625,27900,28100,-400
560,UNTR,2022-12-07,28100,28125,28650,27525,28050,-50
561,UNTR,2022-12-08,28050,27900,28025,27025,27300,-750
562,UNTR,2022-12-09,27300,27025,27175,26125,26125,-1175
563,UNTR,2022-12-12,26125,26125,26925,26025,26875,750
564,UNTR,2022-12-13,26875,26850,27125,26600,26825,-50
565,UNTR,2022-12-14,26825,26825,27350,26825,26850,25
566,UNTR,2022-12-15,26850,26775,26800,26525,26525,-325
567,UNTR,2022-12-16,26525,26475,26775,26250,26550,25
568,UNTR,2022-12-19,26550,26300,26850,26300,26850,300
569,UNTR,2022-12-20,26850,26850,27025,26400,26650,-200
570,UNTR,2022-12-21,26650,26625,26850,26425,26625,-25
571,UNTR,2022-12-22,26625,26750,27000,26450,27000,375
572,UNTR,2022-12-23,27000,27000,27000,26625,26875,-125
573,UNTR,2022-12-26,26875,26900,26900,26375,26400,-475
574,UNTR,2022-12-27,26400,26400,26850,26375,26625,225
575,UNTR,2022-12-28,26625,26625,26700,26025,26175,-450
576,UNTR,2022-12-29,26175,26125,26350,25675,26275,100
577,UNTR,2022-12-30,26275,26275,26400,26075,26075,-200
