,date,stock_code,prev,open,high,low,close,change
0,2024-01-02,ACES,720,725,730,710,715,-5
1,2024-01-02,AMRT,2930,2930,2940,2840,2890,-40
2,2024-01-02,ASII,5650,5625,5700,5575,5700,50
3,2024-01-02,HRUM,1335,1335,1380,1330,1380,45
4,2024-01-02,INKP,8325,8325,8500,8250,8350,25
5,2024-01-02,INTP,9400,9400,9500,9375,9425,25
6,2024-01-02,MAPI,1790,1800,1985,1800,1895,105
7,2024-01-02,SIDO,525,525,530,510,510,-15
8,2024-01-02,UNTR,22625,22600,23575,22600,23475,850
9,2024-01-02,UNVR,3530,3530,3550,3500,3550,20
10,2024-01-03,ACES,715,720,730,710,715,0
11,2024-01-03,AMRT,2890,2860,2890,2800,2820,-70
12,2024-01-03,ASII,5700,5700,5700,5600,5600,-100
13,2024-01-03,HRUM,1380,1355,1380,1340,1355,-25
14,2024-01-03,INKP,8350,8350,8500,8250,8475,125
15,2024-01-03,INTP,9425,9425,9450,9300,9300,-125
16,2024-01-03,MAPI,1895,1905,1955,1880,1900,5
17,2024-01-03,SIDO,510,510,525,505,525,15
18,2024-01-03,UNTR,23475,23200,23400,22600,23225,-250
19,2024-01-03,UNVR,3550,3550,3560,3520,3530,-20
20,2024-01-04,ACES,715,715,745,715,735,20
21,2024-01-04,AMRT,2820,2830,2870,2820,2870,50
22,2024-01-04,ASII,5600,5600,5750,5600,5700,100
23,2024-01-04,HRUM,1355,1360,1410,1360,1385,30
24,2024-01-04,INKP,8475,8525,8525,8350,8425,-50
25,2024-01-04,INTP,9300,9275,9400,9275,9325,25
26,2024-01-04,MAPI,1900,1910,1930,1865,1885,-15
27,2024-01-04,SIDO,525,525,525,515,520,-5
28,2024-01-04,UNTR,23225,23225,23500,23225,23275,50
29,2024-01-04,UNVR,3530,3530,3560,3520,3520,-10
30,2024-01-05,ACES,735,740,760,735,750,15
31,2024-01-05,AMRT,2870,2870,2870,2790,2790,-80
32,2024-01-05,ASII,5700,5725,5750,5625,5625,-75
33,2024-01-05,HRUM,1385,1385,1405,1370,1375,-10
34,2024-01-05,INKP,8425,8425,8450,8325,8375,-50
35,2024-01-05,INTP,9325,9325,9375,9225,9225,-100
36,2024-01-05,MAPI,1885,1885,1895,1785,1795,-90
37,2024-01-05,SIDO,520,520,525,515,520,0
38,2024-01-05,UNTR,23275,23500,23550,23250,23250,-25
39,2024-01-05,UNVR,3520,3540,3580,3520,3520,0
40,2024-01-08,ACES,750,750,755,730,735,-15
41,2024-01-08,AMRT,2790,2790,2820,2790,2800,10
42,2024-01-08,ASII,5625,5625,5675,5550,5575,-50
43,2024-01-08,HRUM,1375,1380,1410,1375,1380,5
44,2024-01-08,INKP,8375,8375,8450,8125,8125,-250
45,2024-01-08,INTP,9225,9225,9275,9175,9225,0
46,2024-01-08,MAPI,1795,1800,1810,1775,1775,-20
47,2024-01-08,SIDO,520,520,525,515,520,0
48,2024-01-08,UNTR,23250,23300,23525,23000,23025,-225
49,2024-01-08,UNVR,3520,3530,3560,3470,3480,-40
50,2024-01-09,ACES,735,745,765,725,765,30
51,2024-01-09,AMRT,2800,2810,2820,2730,2740,-60
52,2024-01-09,ASII,5575,5600,5600,5525,5575,0
53,2024-01-09,HRUM,1380,1380,1385,1340,1345,-35
54,2024-01-09,INKP,8125,8150,8225,8000,8000,-125
55,2024-01-09,INTP,9225,0,9250,9150,9150,-75
56,2024-01-09,MAPI,1775,1780,1895,1780,1855,80
57,2024-01-09,SIDO,520,520,525,515,520,0
58,2024-01-09,UNTR,23025,23200,23350,23025,23100,75
59,2024-01-09,UNVR,3480,3480,3490,3420,3430,-50
60,2024-01-10,ACES,765,765,780,755,770,5
61,2024-01-10,AMRT,2740,2780,2790,2710,2750,10
62,2024-01-10,ASII,5575,5500,5575,5450,5525,-50
63,2024-01-10,HRUM,1345,1360,1380,1355,1360,15
64,2024-01-10,INKP,8000,7950,8225,7950,8000,0
65,2024-01-10,INTP,9150,9150,9250,9150,9150,0
66,2024-01-10,MAPI,1855,1855,1925,1845,1855,0
67,2024-01-10,SIDO,520,520,525,515,525,5
68,2024-01-10,UNTR,23100,23100,23450,23100,23300,200
69,2024-01-10,UNVR,3430,3430,3480,3410,3410,-20
70,2024-01-10,ACES,765,765,780,755,770,5
71,2024-01-10,AMRT,2740,2780,2790,2710,2750,10
72,2024-01-10,ASII,5575,5500,5575,5450,5525,-50
73,2024-01-10,HRUM,1345,1360,1380,1355,1360,15
74,2024-01-10,INKP,8000,7950,8225,7950,8000,0
75,2024-01-10,INTP,9150,9150,9250,9150,9150,0
76,2024-01-10,MAPI,1855,1855,1925,1845,1855,0
77,2024-01-10,SIDO,520,520,525,515,525,5
78,2024-01-10,UNTR,23100,23100,23450,23100,23300,200
79,2024-01-10,UNVR,3430,3430,3480,3410,3410,-20
80,2024-01-11,ACES,770,770,815,765,810,40
81,2024-01-11,AMRT,2750,2790,2790,2710,2710,-40
82,2024-01-11,ASII,5525,5550,5625,5525,5550,25
83,2024-01-11,HRUM,1360,1350,1360,1340,1345,-15
84,2024-01-11,INKP,8000,8000,8150,8000,8050,50
85,2024-01-11,INTP,9150,9225,9350,9200,9300,150
86,2024-01-11,MAPI,1855,1860,1870,1830,1845,-10
87,2024-01-11,SIDO,525,520,525,515,520,-5
88,2024-01-11,UNTR,23300,23350,23450,23250,23300,0
89,2024-01-11,UNVR,3410,3450,3450,3410,3410,0
90,2024-01-12,ACES,810,810,815,790,810,0
91,2024-01-12,AMRT,2710,2710,2710,2610,2640,-70
92,2024-01-12,ASII,5550,5550,5625,5550,5600,50
93,2024-01-12,HRUM,1345,1345,1360,1330,1350,5
94,2024-01-12,INKP,8050,8075,8150,8050,8100,50
95,2024-01-12,INTP,9300,9350,9350,9250,9275,-25
96,2024-01-12,MAPI,1845,1845,1855,1815,1820,-25
97,2024-01-12,SIDO,520,520,525,515,520,0
98,2024-01-12,UNTR,23300,23350,23925,23325,23900,600
99,2024-01-12,UNVR,3410,3430,3480,3410,3470,60
100,2024-01-15,ACES,810,810,815,795,810,0
101,2024-01-15,AMRT,2640,2640,2650,2570,2630,-10
102,2024-01-15,ASII,5600,5600,5625,5500,5525,-75
103,2024-01-15,HRUM,1350,1360,1375,1335,1340,-10
104,2024-01-15,INKP,8100,8100,8175,8075,8175,75
105,2024-01-15,INTP,9275,9275,9275,9150,9150,-125
106,2024-01-15,MAPI,1820,1830,1920,1825,1905,85
107,2024-01-15,SIDO,520,525,530,515,525,5
108,2024-01-15,UNTR,23900,23900,24750,23900,24725,825
109,2024-01-15,UNVR,3470,3470,3480,3430,3430,-40
110,2024-01-16,ACES,810,810,815,800,810,0
111,2024-01-16,AMRT,2630,2640,2700,2630,2670,40
112,2024-01-16,ASII,5525,5525,5525,5475,5500,-25
113,2024-01-16,HRUM,1340,1340,1350,1330,1335,-5
114,2024-01-16,INKP,8175,8150,8225,8075,8100,-75
115,2024-01-16,INTP,9150,9225,9325,9175,9275,125
116,2024-01-16,MAPI,1905,1920,1995,1920,1940,35
117,2024-01-16,SIDO,525,520,525,520,525,0
118,2024-01-16,UNTR,24725,24750,24800,24375,24600,-125
119,2024-01-16,UNVR,3430,3430,3470,3410,3410,-20
120,2024-01-17,ACES,810,810,810,790,800,-10
121,2024-01-17,AMRT,2670,2670,2680,2630,2650,-20
122,2024-01-17,ASII,5500,5500,5525,5350,5400,-100
123,2024-01-17,HRUM,1335,1340,1345,1310,1325,-10
124,2024-01-17,INKP,8100,8100,8125,7925,7975,-125
125,2024-01-17,INTP,9275,9300,9300,9150,9175,-100
126,2024-01-17,MAPI,1940,1940,1965,1885,1900,-40
127,2024-01-17,SIDO,525,525,530,520,520,-5
128,2024-01-17,UNTR,24600,25000,25000,24200,24225,-375
129,2024-01-17,UNVR,3410,3440,3440,3310,3320,-90
130,2024-01-18,ACES,800,800,805,790,800,0
131,2024-01-18,AMRT,2650,2650,2680,2650,2650,0
132,2024-01-18,ASII,5400,5400,5400,5325,5375,-25
133,2024-01-18,HRUM,1325,1320,1330,1310,1310,-15
134,2024-01-18,INKP,7975,7975,8050,7975,7975,0
135,2024-01-18,INTP,9175,9175,9250,9150,9150,-25
136,2024-01-18,MAPI,1900,1900,1945,1890,1920,20
137,2024-01-18,SIDO,520,520,530,520,520,0
138,2024-01-18,UNTR,24225,24225,24550,24050,24100,-125
139,2024-01-18,UNVR,3320,3330,3340,3290,3300,-20
140,2024-01-19,ACES,800,800,810,780,800,0
141,2024-01-19,AMRT,2650,2670,2700,2640,2640,-10
142,2024-01-19,ASII,5375,5375,5400,5300,5350,-25
143,2024-01-19,HRUM,1310,1315,1330,1300,1315,5
144,2024-01-19,INKP,7975,8050,8050,7900,8000,25
145,2024-01-19,INTP,9150,9225,9225,9125,9175,25
146,2024-01-19,MAPI,1920,1920,1960,1905,1945,25
147,2024-01-19,SIDO,520,520,520,515,515,-5
148,2024-01-19,UNTR,24100,24200,24300,23825,24075,-25
149,2024-01-19,UNVR,3300,3300,3300,3210,3240,-60
150,2024-01-22,ACES,800,800,815,790,810,10
151,2024-01-22,AMRT,2640,2670,2700,2640,2680,40
152,2024-01-22,ASII,5350,5350,5425,5225,5225,-125
153,2024-01-22,HRUM,1315,1315,1320,1275,1285,-30
154,2024-01-22,INKP,8000,8050,8050,7800,7925,-75
155,2024-01-22,INTP,9175,9150,9175,9000,9000,-175
156,2024-01-22,MAPI,1945,1950,2030,1930,1970,25
157,2024-01-22,SIDO,515,520,525,515,515,0
158,2024-01-22,UNTR,24075,24075,24075,23225,23250,-825
159,2024-01-22,UNVR,3240,3220,3240,3120,3120,-120
160,2024-01-23,ACES,810,815,825,805,825,15
161,2024-01-23,AMRT,2680,2700,2730,2650,2720,40
162,2024-01-23,ASII,5225,5150,5200,5075,5125,-100
163,2024-01-23,HRUM,1285,1285,1290,1225,1235,-50
164,2024-01-23,INKP,7925,7925,7950,7600,7675,-250
165,2024-01-23,INTP,9000,9000,9075,8925,9050,50
166,2024-01-23,MAPI,1970,1975,2030,1960,1995,25
167,2024-01-23,SIDO,515,515,520,500,500,-15
168,2024-01-23,UNTR,23250,23275,23425,22400,22700,-550
169,2024-01-23,UNVR,3120,3140,3200,3130,3180,60
170,2024-01-24,ACES,825,825,835,815,825,0
171,2024-01-24,AMRT,2720,2720,2720,2650,2670,-50
172,2024-01-24,ASII,5125,5150,5175,4980,5075,-50
173,2024-01-24,HRUM,1235,1235,1240,1135,1150,-85
174,2024-01-24,INKP,7675,7725,7875,7675,7775,100
175,2024-01-24,INTP,9050,9050,9225,8950,9225,175
176,2024-01-24,MAPI,1995,2000,2010,1985,1995,0
177,2024-01-24,SIDO,500,500,505,492,500,0
178,2024-01-24,UNTR,22700,22800,22850,22325,22550,-150
179,2024-01-24,UNVR,3180,3180,3220,3150,3200,20
180,2024-01-25,ACES,825,830,835,825,825,0
181,2024-01-25,AMRT,2670,2690,2700,2650,2670,0
182,2024-01-25,ASII,5075,5075,5150,5025,5050,-25
183,2024-01-25,HRUM,1150,1150,1215,1150,1180,30
184,2024-01-25,INKP,7775,7775,7775,7600,7600,-175
185,2024-01-25,INTP,9225,9175,9250,9075,9100,-125
186,2024-01-25,MAPI,1995,1990,1990,1925,1935,-60
187,2024-01-25,SIDO,500,500,510,498,505,5
188,2024-01-25,UNTR,22550,22475,23250,22475,23125,575
189,2024-01-25,UNVR,3200,3190,3200,3150,3160,-40
190,2024-01-26,ACES,825,825,835,810,820,-5
191,2024-01-26,AMRT,2670,2660,2670,2620,2630,-40
192,2024-01-26,ASII,5050,5050,5075,4990,5075,25
193,2024-01-26,HRUM,1180,1180,1185,1150,1155,-25
194,2024-01-26,INKP,7600,7600,7950,7600,7900,300
195,2024-01-26,INTP,9100,9375,9375,9100,9225,125
196,2024-01-26,MAPI,1935,1910,1915,1855,1875,-60
197,2024-01-26,SIDO,505,510,510,500,500,-5
198,2024-01-26,UNTR,23125,23150,23250,22925,22975,-150
199,2024-01-26,UNVR,3160,3160,3170,3130,3160,0
200,2024-01-29,ACES,820,820,835,815,835,15
201,2024-01-29,AMRT,2630,2640,2690,2620,2690,60
202,2024-01-29,ASII,5075,5075,5075,4910,4930,-145
203,2024-01-29,HRUM,1155,1155,1170,1120,1150,-5
204,2024-01-29,INKP,7900,7950,7950,7850,7900,0
205,2024-01-29,INTP,9225,9250,9250,9050,9075,-150
206,2024-01-29,MAPI,1875,1875,1915,1875,1900,25
207,2024-01-29,SIDO,500,500,510,498,505,5
208,2024-01-29,UNTR,22975,23025,23325,23025,23325,350
209,2024-01-29,UNVR,3160,3160,3160,3070,3080,-80
210,2024-01-30,ACES,835,835,835,820,830,-5
211,2024-01-30,AMRT,2690,2670,2680,2630,2650,-40
212,2024-01-30,ASII,4930,4920,5175,4900,5100,170
213,2024-01-30,HRUM,1150,1160,1270,1155,1200,50
214,2024-01-30,INKP,7900,7900,7900,7675,7700,-200
215,2024-01-30,INTP,9075,9150,9150,9050,9075,0
216,2024-01-30,MAPI,1900,1910,2030,1910,1970,70
217,2024-01-30,SIDO,505,505,510,500,505,0
218,2024-01-30,UNTR,23325,23325,23325,22800,22850,-475
219,2024-01-30,UNVR,3080,3080,3130,3010,3130,50
220,2024-01-31,ACES,830,830,850,825,850,20
221,2024-01-31,AMRT,2650,2660,2690,2630,2650,0
222,2024-01-31,ASII,5100,5125,5150,5050,5125,25
223,2024-01-31,HRUM,1200,1220,1230,1160,1175,-25
224,2024-01-31,INKP,7700,7725,7825,7650,7825,125
225,2024-01-31,INTP,9075,9075,9125,9025,9025,-50
226,2024-01-31,MAPI,1970,1990,2000,1955,1955,-15
227,2024-01-31,SIDO,505,505,510,505,510,5
228,2024-01-31,UNTR,22850,23025,23200,22875,22950,100
229,2024-01-31,UNVR,3130,3130,3150,3100,3100,-30
230,2024-02-01,ACES,850,850,865,835,855,5
231,2024-02-01,AMRT,2650,2650,2670,2640,2650,0
232,2024-02-01,ASII,5125,5100,5175,5075,5125,0
233,2024-02-01,HRUM,1175,1175,1205,1160,1190,15
234,2024-02-01,INKP,7825,7775,7800,7650,7700,-125
235,2024-02-01,INTP,9025,9025,9050,8925,8925,-100
236,2024-02-01,MAPI,1955,1960,1980,1930,1960,5
237,2024-02-01,SIDO,510,510,510,500,505,-5
238,2024-02-01,UNTR,22950,22925,23075,22575,22800,-150
239,2024-02-01,UNVR,3100,3100,3130,3090,3100,0
240,2024-02-02,ACES,855,855,855,810,820,-35
241,2024-02-02,AMRT,2650,2650,2670,2640,2650,0
242,2024-02-02,ASII,5125,5150,5325,5125,5325,200
243,2024-02-02,HRUM,1190,1195,1195,1155,1180,-10
244,2024-02-02,INKP,7700,7700,8200,7650,8125,425
245,2024-02-02,INTP,8925,8950,9000,8900,8925,0
246,2024-02-02,MAPI,1960,1965,1995,1965,1975,15
247,2024-02-02,SIDO,505,505,505,500,500,-5
248,2024-02-02,UNTR,22800,22850,22950,22725,22850,50
249,2024-02-02,UNVR,3100,3100,3200,3100,3170,70
250,2024-02-05,ACES,820,820,825,800,810,-10
251,2024-02-05,AMRT,2650,2650,2660,2600,2600,-50
252,2024-02-05,ASII,5325,5325,5350,5150,5175,-150
253,2024-02-05,HRUM,1180,1180,1185,1155,1155,-25
254,2024-02-05,INKP,8125,8150,8175,7900,7900,-225
255,2024-02-05,INTP,8925,8975,9025,8875,8900,-25
256,2024-02-05,MAPI,1975,1985,1995,1910,1930,-45
257,2024-02-05,SIDO,500,500,505,500,505,5
258,2024-02-05,UNTR,22850,22850,22925,22675,22675,-175
259,2024-02-05,UNVR,3170,3190,3240,3180,3200,30
260,2024-02-06,ACES,810,820,845,815,830,20
261,2024-02-06,AMRT,2600,2620,2640,2600,2600,0
262,2024-02-06,ASII,5175,5175,5275,5150,5250,75
263,2024-02-06,HRUM,1155,1160,1175,1125,1140,-15
264,2024-02-06,INKP,7900,7950,8075,7875,8000,100
265,2024-02-06,INTP,8900,8900,9125,8875,8950,50
266,2024-02-06,MAPI,1930,1930,1960,1925,1955,25
267,2024-02-06,SIDO,505,505,505,500,500,-5
268,2024-02-06,UNTR,22675,22700,22975,22700,22800,125
269,2024-02-06,UNVR,3200,3220,3270,3170,3250,50
270,2024-02-07,ACES,830,835,845,820,830,0
271,2024-02-07,AMRT,2600,2610,2650,2600,2630,30
272,2024-02-07,ASII,5250,5250,5325,5250,5325,75
273,2024-02-07,HRUM,1140,1140,1140,1090,1105,-35
274,2024-02-07,INKP,8000,8000,8150,7950,7950,-50
275,2024-02-07,INTP,8950,9050,9050,8800,8800,-150
276,2024-02-07,MAPI,1955,1960,2010,1955,1975,20
277,2024-02-07,SIDO,500,505,505,500,500,0
278,2024-02-07,UNTR,22800,22850,23100,22825,22900,100
279,2024-02-07,UNVR,3250,3250,3280,3240,3270,20
280,2024-02-12,ACES,830,830,830,810,815,-15
281,2024-02-12,AMRT,2630,2610,2640,2490,2580,-50
282,2024-02-12,ASII,5325,5300,5350,5225,5300,-25
283,2024-02-12,HRUM,1105,1105,1135,1075,1115,10
284,2024-02-12,INKP,7950,7975,8000,7800,7850,-100
285,2024-02-12,INTP,8800,8800,8975,8800,8900,100
286,2024-02-12,MAPI,1975,1980,1990,1955,1965,-10
287,2024-02-12,SIDO,500,500,510,498,505,5
288,2024-02-12,UNTR,22900,22900,23325,22900,23225,325
289,2024-02-12,UNVR,3270,3170,3170,2920,2920,-350
290,2024-02-13,ACES,815,815,825,810,820,5
291,2024-02-13,AMRT,2580,2570,2630,2510,2610,30
292,2024-02-13,ASII,5300,5300,5300,5150,5200,-100
293,2024-02-13,HRUM,1115,1130,1150,1110,1135,20
294,2024-02-13,INKP,7850,7950,8025,7850,7950,100
295,2024-02-13,INTP,8900,8900,8900,8725,8725,-175
296,2024-02-13,MAPI,1965,1965,1970,1930,1970,5
297,2024-02-13,SIDO,505,505,510,498,500,-5
298,2024-02-13,UNTR,23225,23225,23450,23050,23150,-75
299,2024-02-13,UNVR,2920,2920,2930,2800,2800,-120
300,2024-02-15,ACES,820,825,830,815,825,5
301,2024-02-15,AMRT,2610,2730,2740,2650,2700,90
302,2024-02-15,ASII,5200,5325,5325,5075,5125,-75
303,2024-02-15,HRUM,1135,1165,1220,1160,1190,55
304,2024-02-15,INKP,7950,8050,8150,7825,7875,-75
305,2024-02-15,INTP,8725,8800,9300,8800,9100,375
306,2024-02-15,MAPI,1970,1980,2050,1970,2000,30
307,2024-02-15,SIDO,500,505,525,500,520,20
308,2024-02-15,UNTR,23150,23325,23450,23125,23200,50
309,2024-02-15,UNVR,2800,2860,2940,2830,2930,130
310,2024-02-16,ACES,825,825,825,765,775,-50
311,2024-02-16,AMRT,2700,2730,2800,2710,2770,70
312,2024-02-16,ASII,5125,5125,5200,5100,5200,75
313,2024-02-16,HRUM,1190,1190,1190,1155,1175,-15
314,2024-02-16,INKP,7875,7900,8050,7875,7975,100
315,2024-02-16,INTP,9100,9100,9100,8825,8825,-275
316,2024-02-16,MAPI,2000,2000,2000,1930,1935,-65
317,2024-02-16,SIDO,520,520,560,520,560,40
318,2024-02-16,UNTR,23200,23250,23400,23100,23250,50
319,2024-02-16,UNVR,2930,2930,2940,2830,2830,-100
320,2024-02-19,ACES,775,775,795,760,760,-15
321,2024-02-19,AMRT,2770,2770,2780,2730,2750,-20
322,2024-02-19,ASII,5200,5200,5250,5075,5125,-75
323,2024-02-19,HRUM,1175,1175,1180,1145,1175,0
324,2024-02-19,INKP,7975,8000,8025,7850,7850,-125
325,2024-02-19,INTP,8825,8850,8900,8825,8825,0
326,2024-02-19,MAPI,1935,1935,1955,1850,1900,-35
327,2024-02-19,SIDO,560,560,575,540,570,10
328,2024-02-19,UNTR,23250,23250,23275,22900,22950,-300
329,2024-02-19,UNVR,2830,2830,2870,2800,2800,-30
330,2024-02-20,ACES,760,760,795,760,785,25
331,2024-02-20,AMRT,2750,2750,2790,2730,2790,40
332,2024-02-20,ASII,5125,5125,5250,5125,5200,75
333,2024-02-20,HRUM,1175,1175,1185,1160,1175,0
334,2024-02-20,INKP,7850,7900,7925,7700,7725,-125
335,2024-02-20,INTP,8825,8875,9100,8825,9050,225
336,2024-02-20,MAPI,1900,1900,1920,1875,1885,-15
337,2024-02-20,SIDO,570,600,610,575,580,10
338,2024-02-20,UNTR,22950,22975,23075,22750,22900,-50
339,2024-02-20,UNVR,2800,2800,2820,2760,2760,-40
340,2024-02-21,ACES,785,790,795,775,795,10
341,2024-02-21,AMRT,2790,2790,2810,2670,2770,-20
342,2024-02-21,ASII,5200,5200,5300,5175,5250,50
343,2024-02-21,HRUM,1175,1175,1205,1155,1155,-20
344,2024-02-21,INKP,7725,7775,7775,7700,7775,50
345,2024-02-21,INTP,9050,9050,9075,8900,9025,-25
346,2024-02-21,MAPI,1885,1895,1930,1885,1930,45
347,2024-02-21,SIDO,580,580,605,565,600,20
348,2024-02-21,UNTR,22900,22925,23175,22900,23025,125
349,2024-02-21,UNVR,2760,2760,2770,2650,2690,-70
350,2024-02-22,ACES,795,800,850,800,835,40
351,2024-02-22,AMRT,2770,2760,2760,2710,2750,-20
352,2024-02-22,ASII,5250,5275,5300,5275,5275,25
353,2024-02-22,HRUM,1155,1160,1215,1155,1210,55
354,2024-02-22,INKP,7775,7800,7925,7725,7900,125
355,2024-02-22,INTP,9025,9025,9100,8975,9075,50
356,2024-02-22,MAPI,1930,1950,1980,1935,1975,45
357,2024-02-22,SIDO,600,600,620,590,615,15
358,2024-02-22,UNTR,23025,23075,23150,23000,23125,100
359,2024-02-22,UNVR,2690,2690,2740,2690,2720,30
360,2024-02-23,ACES,835,835,845,830,840,5
361,2024-02-23,AMRT,2750,2750,2750,2660,2680,-70
362,2024-02-23,ASII,5275,5250,5275,5100,5125,-150
363,2024-02-23,HRUM,1210,1230,1235,1205,1225,15
364,2024-02-23,INKP,7900,7975,7975,7825,7925,25
365,2024-02-23,INTP,9075,9075,9075,8900,9050,-25
366,2024-02-23,MAPI,1975,1975,1975,1930,1955,-20
367,2024-02-23,SIDO,615,615,625,610,625,10
368,2024-02-23,UNTR,23125,23150,23150,22800,22800,-325
369,2024-02-23,UNVR,2720,2730,2740,2660,2690,-30
370,2024-02-26,ACES,840,840,860,840,850,10
371,2024-02-26,AMRT,2680,2700,2710,2650,2690,10
372,2024-02-26,ASII,5125,5150,5200,5075,5125,0
373,2024-02-26,HRUM,1225,1225,1230,1200,1220,-5
374,2024-02-26,INKP,7925,7950,7975,7825,7900,-25
375,2024-02-26,INTP,9050,9050,9200,8950,9125,75
376,2024-02-26,MAPI,1955,1950,1950,1910,1915,-40
377,2024-02-26,SIDO,625,625,625,605,620,-5
378,2024-02-26,UNTR,22800,22900,23100,22875,23000,200
379,2024-02-26,UNVR,2690,2690,2690,2590,2590,-100
380,2024-02-27,ACES,850,855,855,835,835,-15
381,2024-02-27,AMRT,2690,2650,2680,2630,2660,-30
382,2024-02-27,ASII,5125,5125,5175,5050,5175,50
383,2024-02-27,HRUM,1220,1235,1240,1190,1200,-20
384,2024-02-27,INKP,7900,7900,7925,7750,7800,-100
385,2024-02-27,INTP,9125,9150,9175,8975,9075,-50
386,2024-02-27,MAPI,1915,1925,1945,1890,1920,5
387,2024-02-27,SIDO,620,620,630,615,620,0
388,2024-02-27,UNTR,23000,23000,23850,22825,23850,850
389,2024-02-27,UNVR,2590,2590,2640,2570,2620,30
390,2024-02-28,ACES,835,845,845,830,830,-5
391,2024-02-28,AMRT,2660,2670,2710,2650,2700,40
392,2024-02-28,ASII,5175,5325,5425,5200,5225,50
393,2024-02-28,HRUM,1200,1220,1235,1205,1230,30
394,2024-02-28,INKP,7800,7825,8125,7750,8125,325
395,2024-02-28,INTP,9075,9075,9125,9025,9100,25
396,2024-02-28,MAPI,1920,1930,1940,1915,1935,15
397,2024-02-28,SIDO,620,620,620,610,615,-5
398,2024-02-28,UNTR,23850,24000,24350,23800,23850,0
399,2024-02-28,UNVR,2620,2620,2720,2610,2700,80
400,2024-02-29,ACES,830,830,845,820,835,5
401,2024-02-29,AMRT,2700,2710,2750,2700,2750,50
402,2024-02-29,ASII,5225,5250,5300,5200,5225,0
403,2024-02-29,HRUM,1230,1240,1265,1215,1250,20
404,2024-02-29,INKP,8125,8150,8850,8125,8725,600
405,2024-02-29,INTP,9100,9100,9125,8975,9075,-25
406,2024-02-29,MAPI,1935,1935,1935,1920,1920,-15
407,2024-02-29,SIDO,615,615,620,600,615,0
408,2024-02-29,UNTR,23850,23875,23950,23500,23525,-325
409,2024-02-29,UNVR,2700,2710,2730,2640,2730,30
410,2024-03-01,ACES,835,840,845,820,825,-10
411,2024-03-01,AMRT,2750,2750,2750,2700,2720,-30
412,2024-03-01,ASII,5225,5225,5275,5150,5225,0
413,2024-03-01,HRUM,1250,1255,1280,1235,1260,10
414,2024-03-01,INKP,8725,8725,9100,8525,8975,250
415,2024-03-01,INTP,9075,8975,9175,8950,9175,100
416,2024-03-01,MAPI,1920,1930,1975,1925,1970,50
417,2024-03-01,SIDO,615,615,615,595,610,-5
418,2024-03-01,UNTR,23525,23525,23775,23450,23725,200
419,2024-03-01,UNVR,2730,2710,2730,2660,2730,0
420,2024-03-04,ACES,825,830,830,810,820,-5
421,2024-03-04,AMRT,2720,2740,2770,2710,2750,30
422,2024-03-04,ASII,5225,5250,5275,5175,5200,-25
423,2024-03-04,HRUM,1260,1260,1270,1245,1260,0
424,2024-03-04,INKP,8975,8950,8950,8625,8725,-250
425,2024-03-04,INTP,9175,9125,9125,8975,8975,-200
426,2024-03-04,MAPI,1970,1975,2030,1965,1990,20
427,2024-03-04,SIDO,610,610,630,600,620,10
428,2024-03-04,UNTR,23725,23775,24175,23775,24000,275
429,2024-03-04,UNVR,2730,2730,2740,2660,2670,-60
430,2024-03-05,ACES,820,820,825,805,805,-15
431,2024-03-05,AMRT,2750,2750,2760,2720,2720,-30
432,2024-03-05,ASII,5200,5225,5225,5100,5100,-100
433,2024-03-05,HRUM,1260,1260,1285,1240,1240,-20
434,2024-03-05,INKP,8725,8725,8800,8450,8575,-150
435,2024-03-05,INTP,8975,9000,9000,8825,8925,-50
436,2024-03-05,MAPI,1990,1990,1990,1965,1970,-20
437,2024-03-05,SIDO,620,620,625,615,620,0
438,2024-03-05,UNTR,24000,24025,24375,24025,24125,125
439,2024-03-05,UNVR,2670,2670,2690,2640,2670,0
440,2024-03-06,ACES,805,810,820,800,800,-5
441,2024-03-06,AMRT,2720,2740,2770,2720,2750,30
442,2024-03-06,ASII,5100,5125,5200,5100,5175,75
443,2024-03-06,HRUM,1240,1240,1275,1210,1265,25
444,2024-03-06,INKP,8575,8575,8600,8250,8300,-275
445,2024-03-06,INTP,8925,8925,8925,8850,8900,-25
446,2024-03-06,MAPI,1970,1970,1980,1950,1975,5
447,2024-03-06,SIDO,620,620,620,600,610,-10
448,2024-03-06,UNTR,24125,24200,24400,24025,24325,200
449,2024-03-06,UNVR,2670,2680,2720,2670,2690,20
450,2024-03-07,ACES,800,805,830,805,820,20
451,2024-03-07,AMRT,2750,2730,2790,2730,2760,10
452,2024-03-07,ASII,5175,5175,5200,5100,5125,-50
453,2024-03-07,HRUM,1265,1265,1335,1245,1320,55
454,2024-03-07,INKP,8300,8300,8500,8250,8375,75
455,2024-03-07,INTP,8900,8850,8900,8750,8750,-150
456,2024-03-07,MAPI,1975,1955,1995,1955,1980,5
457,2024-03-07,SIDO,610,605,620,605,620,10
458,2024-03-07,UNTR,24325,24325,24400,24000,24000,-325
459,2024-03-07,UNVR,2690,2700,2730,2680,2730,40
460,2024-03-08,ACES,820,820,835,820,825,5
461,2024-03-08,AMRT,2760,2760,2810,2750,2790,30
462,2024-03-08,ASII,5125,5150,5175,5125,5150,25
463,2024-03-08,HRUM,1320,1325,1335,1275,1295,-25
464,2024-03-08,INKP,8375,8400,8450,8300,8325,-50
465,2024-03-08,INTP,8750,8750,8825,8700,8725,-25
466,2024-03-08,MAPI,1980,1980,1985,1860,1885,-95
467,2024-03-08,SIDO,620,615,625,610,625,5
468,2024-03-08,UNTR,24000,24025,24325,24025,24175,175
469,2024-03-08,UNVR,2730,2730,2740,2660,2660,-70
470,2024-03-13,ACES,825,830,850,830,835,10
471,2024-03-13,AMRT,2790,2810,2840,2790,2820,30
472,2024-03-13,ASII,5150,5150,5200,5125,5150,0
473,2024-03-13,HRUM,1295,1300,1375,1290,1360,65
474,2024-03-13,INKP,8325,8400,8625,8350,8500,175
475,2024-03-13,INTP,8725,8725,8750,8500,8525,-200
476,2024-03-13,MAPI,1885,1915,1950,1865,1920,35
477,2024-03-13,SIDO,625,625,630,615,620,-5
478,2024-03-13,UNTR,24175,24125,24150,23500,23525,-650
479,2024-03-13,UNVR,2660,2720,2720,2660,2720,60
480,2024-03-14,ACES,835,835,845,820,840,5
481,2024-03-14,AMRT,2820,2830,2900,2820,2900,80
482,2024-03-14,ASII,5150,5175,5300,5150,5275,125
483,2024-03-14,HRUM,1360,1365,1390,1345,1380,20
484,2024-03-14,INKP,8500,8550,8600,8325,8600,100
485,2024-03-14,INTP,8525,8575,8775,8575,8700,175
486,2024-03-14,MAPI,1920,1940,1960,1915,1935,15
487,2024-03-14,SIDO,620,620,620,605,615,-5
488,2024-03-14,UNTR,23525,23575,24125,23550,24125,600
489,2024-03-14,UNVR,2720,2720,2720,2660,2690,-30
490,2024-03-15,ACES,840,840,845,830,835,-5
491,2024-03-15,AMRT,2900,2900,2910,2820,2880,-20
492,2024-03-15,ASII,5275,5300,5300,5175,5175,-100
493,2024-03-15,HRUM,1380,1390,1420,1370,1410,30
494,2024-03-15,INKP,8600,8600,8625,8450,8550,-50
495,2024-03-15,INTP,8700,8775,8775,8625,8625,-75
496,2024-03-15,MAPI,1935,1940,1965,1930,1930,-5
497,2024-03-15,SIDO,615,610,615,600,605,-10
498,2024-03-15,UNTR,24125,24125,24775,24000,24175,50
499,2024-03-15,UNVR,2690,2660,2690,2620,2640,-50
500,2024-03-18,ACES,835,835,845,825,825,-10
501,2024-03-18,AMRT,2880,2890,2900,2840,2870,-10
502,2024-03-18,ASII,5175,5200,5250,5150,5150,-25
503,2024-03-18,HRUM,1410,1410,1445,1370,1440,30
504,2024-03-18,INKP,8550,8550,9225,8550,9150,600
505,2024-03-18,INTP,8625,8625,8725,8625,8625,0
506,2024-03-18,MAPI,1930,1930,1940,1895,1905,-25
507,2024-03-18,SIDO,605,605,610,600,600,-5
508,2024-03-18,UNTR,24175,24225,24575,24225,24275,100
509,2024-03-18,UNVR,2640,2640,2800,2640,2770,130
510,2024-03-19,ACES,825,825,855,825,845,20
511,2024-03-19,AMRT,2870,2860,2930,2860,2890,20
512,2024-03-19,ASII,5150,5150,5250,5150,5225,75
513,2024-03-19,HRUM,1440,1440,1445,1390,1395,-45
514,2024-03-19,INKP,9150,9150,9400,9050,9150,0
515,2024-03-19,INTP,8625,8625,8675,8525,8550,-75
516,2024-03-19,MAPI,1905,1905,1925,1825,1825,-80
517,2024-03-19,SIDO,600,600,610,600,605,5
518,2024-03-19,UNTR,24275,24300,24475,24275,24375,100
519,2024-03-19,UNVR,2770,2780,2790,2740,2740,-30
520,2024-03-20,ACES,845,850,945,850,930,85
521,2024-03-20,AMRT,2890,2900,2920,2870,2900,10
522,2024-03-20,ASII,5225,5225,5275,5225,5275,50
523,2024-03-20,HRUM,1395,1395,1415,1345,1365,-30
524,2024-03-20,INKP,9150,9150,9225,8950,9200,50
525,2024-03-20,INTP,8550,8600,8650,8500,8550,0
526,2024-03-20,MAPI,1825,1825,1840,1780,1815,-10
527,2024-03-20,SIDO,605,605,630,600,630,25
528,2024-03-20,UNTR,24375,24375,24550,24375,24550,175
529,2024-03-20,UNVR,2740,2760,2820,2740,2760,20
530,2024-03-21,ACES,930,930,950,915,920,-10
531,2024-03-21,AMRT,2900,2910,2910,2880,2900,0
532,2024-03-21,ASII,5275,5300,5400,5275,5350,75
533,2024-03-21,HRUM,1365,1365,1395,1355,1390,25
534,2024-03-21,INKP,9200,9300,9325,9075,9150,-50
535,2024-03-21,INTP,8550,8600,8725,8550,8575,25
536,2024-03-21,MAPI,1815,1815,1870,1805,1805,-10
537,2024-03-21,SIDO,630,635,645,625,635,5
538,2024-03-21,UNTR,24550,24550,24900,24550,24775,225
539,2024-03-21,UNVR,2760,2760,2780,2720,2720,-40
540,2024-03-22,ACES,920,925,935,910,915,-5
541,2024-03-22,AMRT,2900,2900,2940,2890,2900,0
542,2024-03-22,ASII,5350,5375,5375,5325,5375,25
543,2024-03-22,HRUM,1390,1390,1395,1345,1385,-5
544,2024-03-22,INKP,9150,9150,9475,9150,9350,200
545,2024-03-22,INTP,8575,8750,8825,8575,8600,25
546,2024-03-22,MAPI,1805,1805,1820,1775,1815,10
547,2024-03-22,SIDO,635,640,640,610,630,-5
548,2024-03-22,UNTR,24775,24775,24775,24525,24600,-175
549,2024-03-22,UNVR,2720,2720,2750,2670,2720,0
550,2024-03-25,ACES,915,910,945,900,930,15
551,2024-03-25,AMRT,2900,2880,2910,2850,2900,0
552,2024-03-25,ASII,5375,5375,5425,5325,5350,-25
553,2024-03-25,HRUM,1385,1385,1385,1345,1355,-30
554,2024-03-25,INKP,9350,9350,9825,9325,9675,325
555,2024-03-25,INTP,8600,8625,8725,8600,8725,125
556,2024-03-25,MAPI,1815,1820,1835,1805,1815,0
557,2024-03-25,SIDO,630,630,630,615,620,-10
558,2024-03-25,UNTR,24600,24700,24825,24400,24550,-50
559,2024-03-25,UNVR,2720,2720,2760,2690,2760,40
560,2024-03-26,ACES,930,930,930,910,925,-5
561,2024-03-26,AMRT,2900,2910,2920,2890,2900,0
562,2024-03-26,ASII,5350,5350,5375,5250,5300,-50
563,2024-03-26,HRUM,1355,1360,1365,1325,1335,-20
564,2024-03-26,INKP,9675,9750,9875,9525,9700,25
565,2024-03-26,INTP,8725,8725,8725,8625,8700,-25
566,2024-03-26,MAPI,1815,1815,1830,1805,1825,10
567,2024-03-26,SIDO,620,620,625,615,615,-5
568,2024-03-26,UNTR,24550,24550,24650,24225,24300,-250
569,2024-03-26,UNVR,2760,2760,2770,2730,2770,10
570,2024-03-27,ACES,925,925,930,905,910,-15
571,2024-03-27,AMRT,2900,2900,2930,2870,2900,0
572,2024-03-27,ASII,5300,5300,5325,5250,5275,-25
573,2024-03-27,HRUM,1335,1340,1390,1330,1380,45
574,2024-03-27,INKP,9700,9800,9875,9575,9775,75
575,2024-03-27,INTP,8700,8700,8775,8650,8750,50
576,2024-03-27,MAPI,1825,1825,1835,1790,1800,-25
577,2024-03-27,SIDO,615,620,635,620,625,10
578,2024-03-27,UNTR,24300,24450,24700,24450,24600,300
579,2024-03-27,UNVR,2770,2730,2770,2720,2730,-40
580,2024-03-28,ACES,910,910,915,880,880,-30
581,2024-03-28,AMRT,2900,2920,2920,2900,2910,10
582,2024-03-28,ASII,5275,5275,5275,5100,5150,-125
583,2024-03-28,HRUM,1380,1390,1400,1335,1350,-30
584,2024-03-28,INKP,9775,9800,9925,9575,9575,-200
585,2024-03-28,INTP,8750,8750,8775,8600,8750,0
586,2024-03-28,MAPI,1800,1805,1820,1790,1820,20
587,2024-03-28,SIDO,625,625,630,620,620,-5
588,2024-03-28,UNTR,24600,24625,24650,24175,24175,-425
589,2024-03-28,UNVR,2730,2730,2740,2650,2700,-30
590,2024-04-01,ACES,880,880,910,855,910,30
591,2024-04-01,AMRT,2910,2910,2920,2890,2910,0
592,2024-04-01,ASII,5150,5175,5225,5150,5200,50
593,2024-04-01,HRUM,1350,1350,1365,1330,1355,5
594,2024-04-01,INKP,9575,9550,9725,9225,9550,-25
595,2024-04-01,INTP,8750,8750,8925,8625,8925,175
596,2024-04-01,MAPI,1820,1815,1860,1815,1840,20
597,2024-04-01,SIDO,620,620,625,600,610,-10
598,2024-04-01,UNTR,24175,24350,24350,23850,24025,-150
599,2024-04-01,UNVR,2700,2700,2730,2630,2730,30
600,2024-04-02,ACES,910,910,965,910,955,45
601,2024-04-02,AMRT,2910,2920,2920,2890,2910,0
602,2024-04-02,ASII,5200,5225,5275,5175,5275,75
603,2024-04-02,HRUM,1355,1355,1435,1355,1425,70
604,2024-04-02,INKP,9550,9500,9725,9250,9650,100
605,2024-04-02,INTP,8925,8800,8825,8700,8825,-100
606,2024-04-02,MAPI,1840,1865,1910,1860,1895,55
607,2024-04-02,SIDO,610,610,615,605,605,-5
608,2024-04-02,UNTR,24025,24100,24900,24025,24900,875
609,2024-04-02,UNVR,2730,2720,2740,2700,2740,10
610,2024-04-03,ACES,955,955,965,945,955,0
611,2024-04-03,AMRT,2910,2910,2910,2880,2890,-20
612,2024-04-03,ASII,5275,5275,5275,5200,5250,-25
613,2024-04-03,HRUM,1425,1430,1540,1430,1470,45
614,2024-04-03,INKP,9650,9550,9975,9450,9900,250
615,2024-04-03,INTP,8825,8825,8825,8675,8700,-125
616,2024-04-03,MAPI,1895,1900,1905,1840,1860,-35
617,2024-04-03,SIDO,605,605,645,605,640,35
618,2024-04-03,UNTR,24900,24900,25375,24700,25250,350
619,2024-04-03,UNVR,2740,2740,2740,2670,2690,-50
620,2024-04-04,ACES,955,955,985,930,965,10
621,2024-04-04,AMRT,2890,2900,2910,2880,2900,10
622,2024-04-04,ASII,5250,5250,5250,5150,5175,-75
623,2024-04-04,HRUM,1470,1475,1510,1445,1455,-15
624,2024-04-04,INKP,9900,9900,9925,9650,9650,-250
625,2024-04-04,INTP,8700,8725,8725,8625,8725,25
626,2024-04-04,MAPI,1860,1880,1910,1850,1900,40
627,2024-04-04,SIDO,640,645,670,640,660,20
628,2024-04-04,UNTR,25250,25250,25275,25000,25050,-200
629,2024-04-04,UNVR,2690,2690,2790,2690,2710,20
630,2024-04-05,ACES,965,960,960,945,950,-15
631,2024-04-05,AMRT,2900,2900,2900,2870,2880,-20
632,2024-04-05,ASII,5175,5150,5325,5150,5275,100
633,2024-04-05,HRUM,1455,1460,1470,1415,1440,-15
634,2024-04-05,INKP,9650,9650,9800,9525,9575,-75
635,2024-04-05,INTP,8725,8675,8675,8600,8625,-100
636,2024-04-05,MAPI,1900,1900,1925,1885,1890,-10
637,2024-04-05,SIDO,660,660,705,655,675,15
638,2024-04-05,UNTR,25050,25125,25425,25125,25250,200
639,2024-04-05,UNVR,2710,2710,2730,2680,2680,-30
640,2024-04-16,ACES,950,935,935,885,910,-40
641,2024-04-16,AMRT,2880,2670,2790,2660,2700,-180
642,2024-04-16,ASII,5275,5175,5225,5100,5100,-175
643,2024-04-16,HRUM,1440,1450,1580,1430,1565,125
644,2024-04-16,INKP,9575,9300,9800,9300,9725,150
645,2024-04-16,INTP,8625,8600,8775,8550,8775,150
646,2024-04-16,MAPI,1890,1830,1835,1805,1810,-80
647,2024-04-16,SIDO,675,670,680,640,675,0
648,2024-04-16,UNTR,25250,25225,26400,25000,26250,1000
649,2024-04-16,UNVR,2680,2600,2630,2540,2540,-140
650,2024-04-17,ACES,910,910,930,910,920,10
651,2024-04-17,AMRT,2700,2740,2820,2710,2790,90
652,2024-04-17,ASII,5100,5150,5175,5100,5125,25
653,2024-04-17,HRUM,1565,1565,1580,1535,1565,0
654,2024-04-17,INKP,9725,9725,9750,9375,9500,-225
655,2024-04-17,INTP,8775,8775,8775,8450,8450,-325
656,2024-04-17,MAPI,1810,1815,1840,1790,1795,-15
657,2024-04-17,SIDO,675,675,675,660,665,-10
658,2024-04-17,UNTR,26250,26300,26300,25575,25575,-675
659,2024-04-17,UNVR,2540,2540,2550,2370,2370,-170
660,2024-04-18,ACES,920,925,950,925,940,20
661,2024-04-18,AMRT,2790,2800,2820,2740,2790,0
662,2024-04-18,ASII,5125,5150,5150,5050,5100,-25
663,2024-04-18,HRUM,1565,1570,1590,1345,1370,-195
664,2024-04-18,INKP,9500,9525,9850,9500,9650,150
665,2024-04-18,INTP,8450,8500,8500,8225,8225,-225
666,2024-04-18,MAPI,1795,1800,1830,1770,1775,-20
667,2024-04-18,SIDO,665,665,675,660,665,0
668,2024-04-18,UNTR,25575,25575,25825,25200,25525,-50
669,2024-04-18,UNVR,2370,2370,2430,2370,2390,20
670,2024-04-19,ACES,940,940,945,915,920,-20
671,2024-04-19,AMRT,2790,2810,2840,2740,2800,10
672,2024-04-19,ASII,5100,5050,5075,4870,4900,-200
673,2024-04-19,HRUM,1370,1375,1395,1270,1290,-80
674,2024-04-19,INKP,9650,9650,9775,9500,9650,0
675,2024-04-19,INTP,8225,8175,8175,7650,7650,-575
676,2024-04-19,MAPI,1775,1770,1775,1655,1695,-80
677,2024-04-19,SIDO,665,665,690,645,685,20
678,2024-04-19,UNTR,25525,25675,25725,25200,25350,-175
679,2024-04-19,UNVR,2390,2380,2440,2330,2380,-10
680,2024-04-22,ACES,920,935,960,930,945,25
681,2024-04-22,AMRT,2800,2830,2890,2800,2880,80
682,2024-04-22,ASII,4900,4940,4990,4940,4950,50
683,2024-04-22,HRUM,1290,1300,1360,1290,1335,45
684,2024-04-22,INKP,9650,9650,9900,9650,9850,200
685,2024-04-22,INTP,7650,7700,7850,7650,7725,75
686,2024-04-22,MAPI,1695,1720,1745,1615,1675,-20
687,2024-04-22,SIDO,685,690,715,690,710,25
688,2024-04-22,UNTR,25350,25525,25675,25225,25300,-50
689,2024-04-22,UNVR,2380,2400,2430,2370,2410,30
690,2024-04-23,ACES,945,950,980,950,970,25
691,2024-04-23,AMRT,2880,2900,2980,2890,2940,60
692,2024-04-23,ASII,4950,4990,5075,4990,5025,75
693,2024-04-23,HRUM,1335,1335,1375,1335,1355,20
694,2024-04-23,INKP,9850,9900,9950,9675,9725,-125
695,2024-04-23,INTP,7725,7775,7900,7750,7825,100
696,2024-04-23,MAPI,1675,1685,1690,1620,1635,-40
697,2024-04-23,SIDO,710,710,715,705,715,5
698,2024-04-23,UNTR,25300,25300,25400,24800,24950,-350
699,2024-04-23,UNVR,2410,2420,2430,2330,2330,-80
700,2024-04-24,ACES,970,975,985,960,970,0
701,2024-04-24,AMRT,2940,2930,2940,2850,2900,-40
702,2024-04-24,ASII,5025,5000,5050,4910,4910,-115
703,2024-04-24,HRUM,1355,1365,1375,1300,1300,-55
704,2024-04-24,INKP,9725,9725,10000,9700,9825,100
705,2024-04-24,INTP,7825,7825,7850,7675,7675,-150
706,2024-04-24,MAPI,1635,1650,1700,1650,1675,40
707,2024-04-24,SIDO,715,715,720,710,720,5
708,2024-04-24,UNTR,24950,25050,25450,24450,24850,-100
709,2024-04-24,UNVR,2330,2350,2420,2350,2390,60
710,2024-04-25,ACES,970,970,995,965,975,5
711,2024-04-25,AMRT,2900,2930,2940,2890,2930,30
712,2024-04-25,ASII,4910,4910,4980,4910,4950,40
713,2024-04-25,HRUM,1300,1300,1325,1275,1320,20
714,2024-04-25,INKP,9825,9925,9925,9625,9650,-175
715,2024-04-25,INTP,7675,7675,7700,7500,7625,-50
716,2024-04-25,MAPI,1675,1680,1680,1625,1635,-40
717,2024-04-25,SIDO,720,720,750,715,725,5
718,2024-04-25,UNTR,24850,24850,25000,24100,24250,-600
719,2024-04-25,UNVR,2390,2500,2690,2500,2640,250
720,2024-04-26,ACES,975,975,975,890,910,-65
721,2024-04-26,AMRT,2930,2940,2940,2840,2840,-90
722,2024-04-26,ASII,4950,4980,4980,4880,4880,-70
723,2024-04-26,HRUM,1320,1320,1325,1285,1300,-20
724,2024-04-26,INKP,9650,9650,9725,8800,8975,-675
725,2024-04-26,INTP,7625,7700,7725,7525,7600,-25
726,2024-04-26,MAPI,1635,1635,1660,1530,1555,-80
727,2024-04-26,SIDO,725,730,745,690,705,-20
728,2024-04-26,UNTR,24250,24300,24450,24150,24150,-100
729,2024-04-26,UNVR,2640,2650,2750,2590,2590,-50
730,2024-04-29,ACES,910,910,940,910,935,25
731,2024-04-29,AMRT,2840,2920,2970,2760,2940,100
732,2024-04-29,ASII,4880,4920,5050,4900,5025,145
733,2024-04-29,HRUM,1300,1300,1395,1290,1390,90
734,2024-04-29,INKP,8975,9000,9525,8675,9475,500
735,2024-04-29,INTP,7600,7600,7700,7575,7625,25
736,2024-04-29,MAPI,1555,1555,1675,1530,1655,100
737,2024-04-29,SIDO,705,705,725,705,725,20
738,2024-04-29,UNTR,24150,24200,25100,23850,24875,725
739,2024-04-29,UNVR,2590,2600,2610,2480,2590,0
740,2024-04-30,ACES,935,935,940,920,935,0
741,2024-04-30,AMRT,2940,2970,2970,2900,2930,-10
742,2024-04-30,ASII,5025,5050,5225,4980,5150,125
743,2024-04-30,HRUM,1390,1390,1420,1375,1410,20
744,2024-04-30,INKP,9475,9475,9625,9225,9375,-100
745,2024-04-30,INTP,7625,7650,7900,7650,7750,125
746,2024-04-30,MAPI,1655,1665,1665,1570,1575,-80
747,2024-04-30,SIDO,725,720,730,715,730,5
748,2024-04-30,UNTR,24875,24575,25100,24550,24825,-50
749,2024-04-30,UNVR,2590,2590,2670,2560,2620,30
750,2024-05-02,ACES,935,935,935,870,910,-25
751,2024-05-02,AMRT,2930,2920,2920,2840,2870,-60
752,2024-05-02,ASII,5150,5225,5275,5175,5175,25
753,2024-05-02,HRUM,1410,1425,1425,1350,1350,-60
754,2024-05-02,INKP,9375,9375,9525,9175,9225,-150
755,2024-05-02,INTP,7750,7550,7625,7100,7225,-525
756,2024-05-02,MAPI,1575,1575,1575,1400,1440,-135
757,2024-05-02,SIDO,730,730,735,705,715,-15
758,2024-05-02,UNTR,24825,24850,24850,24100,24300,-525
759,2024-05-02,UNVR,2620,2620,2640,2570,2640,20
760,2024-05-03,ACES,910,915,925,870,880,-30
761,2024-05-03,AMRT,2870,2880,2910,2870,2900,30
762,2024-05-03,ASII,5175,5225,5250,5200,5225,50
763,2024-05-03,HRUM,1350,1365,1395,1345,1375,25
764,2024-05-03,INKP,9225,9225,9400,9225,9325,100
765,2024-05-03,INTP,7225,7275,7400,7100,7200,-25
766,2024-05-03,MAPI,1440,1450,1510,1430,1485,45
767,2024-05-03,SIDO,715,715,720,705,720,5
768,2024-05-03,UNTR,24300,24300,24425,23850,23950,-350
769,2024-05-03,UNVR,2640,2640,2650,2570,2600,-40
770,2024-05-06,ACES,880,895,900,865,875,-5
771,2024-05-06,AMRT,2900,2940,2950,2890,2900,0
772,2024-05-06,ASII,5225,5250,5250,5075,5100,-125
773,2024-05-06,HRUM,1375,1390,1415,1370,1385,10
774,2024-05-06,INKP,9325,9500,9550,9375,9450,125
775,2024-05-06,INTP,7200,7300,7350,7025,7125,-75
776,2024-05-06,MAPI,1485,1490,1495,1430,1445,-40
777,2024-05-06,SIDO,720,720,725,710,720,0
778,2024-05-06,UNTR,23950,22500,22525,22250,22400,-1550
779,2024-05-06,UNVR,2600,2650,2650,2570,2600,0
780,2024-05-07,ACES,875,875,900,875,890,15
781,2024-05-07,AMRT,2900,2920,2920,2860,2880,-20
782,2024-05-07,ASII,5100,5100,5125,5025,5050,-50
783,2024-05-07,HRUM,1385,1390,1405,1380,1400,15
784,2024-05-07,INKP,9450,9450,9750,9350,9425,-25
785,2024-05-07,INTP,7125,7100,7100,7025,7075,-50
786,2024-05-07,MAPI,1445,1450,1460,1405,1405,-40
787,2024-05-07,SIDO,720,720,725,710,720,0
788,2024-05-07,UNTR,22400,22400,22400,22150,22250,-150
789,2024-05-07,UNVR,2600,2600,2600,2530,2540,-60
790,2024-05-08,ACES,890,895,915,875,875,-15
791,2024-05-08,AMRT,2880,2900,2920,2830,2880,0
792,2024-05-08,ASII,5050,5075,5150,5000,5125,75
793,2024-05-08,HRUM,1400,1405,1410,1345,1345,-55
794,2024-05-08,INKP,9425,9475,9525,9350,9525,100
795,2024-05-08,INTP,7075,7025,7050,6800,6800,-275
796,2024-05-08,MAPI,1405,1410,1525,1405,1495,90
797,2024-05-08,SIDO,720,720,725,710,720,0
798,2024-05-08,UNTR,22250,22300,22375,22050,22100,-150
799,2024-05-08,UNVR,2540,2540,2580,2530,2560,20
800,2024-05-13,ACES,875,880,885,805,855,-20
801,2024-05-13,AMRT,2880,2850,2870,2800,2830,-50
802,2024-05-13,ASII,5125,5150,5175,5075,5075,-50
803,2024-05-13,HRUM,1345,1355,1360,1320,1345,0
804,2024-05-13,INKP,9525,9450,9725,9350,9675,150
805,2024-05-13,INTP,6800,6825,6825,6650,6675,-125
806,2024-05-13,MAPI,1495,1490,1540,1450,1525,30
807,2024-05-13,SIDO,720,720,720,705,715,-5
808,2024-05-13,UNTR,22100,22100,22300,22050,22200,100
809,2024-05-13,UNVR,2560,2560,2690,2560,2650,90
810,2024-05-14,ACES,855,855,875,845,855,0
811,2024-05-14,AMRT,2830,2820,2840,2790,2800,-30
812,2024-05-14,ASII,5075,4680,4690,4580,4580,-495
813,2024-05-14,HRUM,1345,1345,1360,1330,1345,0
814,2024-05-14,INKP,9675,9675,9725,9475,9475,-200
815,2024-05-14,INTP,6675,6725,6775,6575,6625,-50
816,2024-05-14,MAPI,1525,1530,1530,1475,1510,-15
817,2024-05-14,SIDO,715,715,730,705,720,5
818,2024-05-14,UNTR,22200,22300,22650,22150,22500,300
819,2024-05-14,UNVR,2650,2670,2710,2640,2700,50
820,2024-05-15,ACES,855,855,880,855,875,20
821,2024-05-15,AMRT,2800,2800,2820,2750,2790,-10
822,2024-05-15,ASII,4580,4570,4620,4530,4530,-50
823,2024-05-15,HRUM,1345,1345,1345,1295,1305,-40
824,2024-05-15,INKP,9475,9475,9775,9475,9700,225
825,2024-05-15,INTP,6625,6650,6675,6450,6625,0
826,2024-05-15,MAPI,1510,1510,1515,1480,1510,0
827,2024-05-15,SIDO,720,720,720,710,715,-5
828,2024-05-15,UNTR,22500,22550,22650,22250,22250,-250
829,2024-05-15,UNVR,2700,2700,2710,2650,2680,-20
830,2024-05-16,ACES,875,875,885,850,850,-25
831,2024-05-16,AMRT,2790,2810,2890,2800,2850,60
832,2024-05-16,ASII,4530,4590,4720,4540,4710,180
833,2024-05-16,HRUM,1305,1315,1320,1285,1300,-5
834,2024-05-16,INKP,9700,9700,9775,9575,9700,0
835,2024-05-16,INTP,6625,6675,6950,6625,6775,150
836,2024-05-16,MAPI,1510,1520,1520,1480,1485,-25
837,2024-05-16,SIDO,715,715,720,710,715,0
838,2024-05-16,UNTR,22250,22325,22400,22100,22150,-100
839,2024-05-16,UNVR,2680,2680,2700,2660,2700,20
840,2024-05-17,ACES,850,865,865,835,845,-5
841,2024-05-17,AMRT,2850,2810,2840,2760,2800,-50
842,2024-05-17,ASII,4710,4710,4810,4690,4800,90
843,2024-05-17,HRUM,1300,1310,1400,1310,1395,95
844,2024-05-17,INKP,9700,9700,9900,9700,9800,100
845,2024-05-17,INTP,6775,6775,6925,6775,6850,75
846,2024-05-17,MAPI,1485,1475,1505,1455,1490,5
847,2024-05-17,SIDO,715,715,720,710,715,0
848,2024-05-17,UNTR,22150,22150,22350,22150,22300,150
849,2024-05-17,UNVR,2700,2700,2750,2700,2710,10
850,2024-05-20,ACES,845,860,865,845,850,5
851,2024-05-20,AMRT,2800,2800,2840,2800,2800,0
852,2024-05-20,ASII,4800,4800,4830,4730,4740,-60
853,2024-05-20,HRUM,1395,1415,1445,1395,1410,15
854,2024-05-20,INKP,9800,9800,9875,9625,9700,-100
855,2024-05-20,INTP,6850,6850,6875,6750,6875,25
856,2024-05-20,MAPI,1490,1500,1500,1465,1485,-5
857,2024-05-20,SIDO,715,715,715,700,705,-10
858,2024-05-20,UNTR,22300,22300,22850,22300,22850,550
859,2024-05-20,UNVR,2710,2710,2750,2680,2700,-10
860,2024-05-21,ACES,850,855,855,800,800,-50
861,2024-05-21,AMRT,2800,2840,2840,2750,2760,-40
862,2024-05-21,ASII,4740,4750,4770,4700,4700,-40
863,2024-05-21,HRUM,1410,1410,1415,1355,1365,-45
864,2024-05-21,INKP,9700,9725,9800,9550,9625,-75
865,2024-05-21,INTP,6875,6875,7125,6825,7000,125
866,2024-05-21,MAPI,1485,1495,1495,1405,1405,-80
867,2024-05-21,SIDO,705,705,710,670,690,-15
868,2024-05-21,UNTR,22850,22950,22950,22325,22425,-425
869,2024-05-21,UNVR,2700,2710,2910,2700,2910,210
870,2024-05-22,ACES,800,810,810,775,800,0
871,2024-05-22,AMRT,2760,2800,2850,2780,2830,70
872,2024-05-22,ASII,4700,4720,4730,4700,4710,10
873,2024-05-22,HRUM,1365,1365,1365,1325,1330,-35
874,2024-05-22,INKP,9625,9725,9725,9575,9625,0
875,2024-05-22,INTP,7000,7050,7050,6875,7000,0
876,2024-05-22,MAPI,1405,1420,1430,1390,1390,-15
877,2024-05-22,SIDO,690,690,715,690,715,25
878,2024-05-22,UNTR,22425,22400,22625,22200,22600,175
879,2024-05-22,UNVR,2910,2910,3090,2870,3060,150
880,2024-05-27,ACES,800,805,820,800,815,15
881,2024-05-27,AMRT,2830,2880,2880,2770,2800,-30
882,2024-05-27,ASII,4710,4700,4720,4550,4550,-160
883,2024-05-27,HRUM,1330,1340,1345,1305,1320,-10
884,2024-05-27,INKP,9625,9625,9650,9200,9275,-350
885,2024-05-27,INTP,7000,6975,6975,6700,6700,-300
886,2024-05-27,MAPI,1390,1390,1400,1335,1345,-45
887,2024-05-27,SIDO,715,715,715,680,700,-15
888,2024-05-27,UNTR,22600,22600,22650,22400,22625,25
889,2024-05-27,UNVR,3060,3090,3270,3090,3260,200
890,2024-05-28,ACES,815,815,825,800,810,-5
891,2024-05-28,AMRT,2800,2860,2910,2820,2880,80
892,2024-05-28,ASII,4550,4560,4600,4510,4510,-40
893,2024-05-28,HRUM,1320,1320,1390,1320,1385,65
894,2024-05-28,INKP,9275,9250,9675,9125,9600,325
895,2024-05-28,INTP,6700,6625,6775,6625,6700,0
896,2024-05-28,MAPI,1345,1350,1355,1315,1345,0
897,2024-05-28,SIDO,700,690,715,685,705,5
898,2024-05-28,UNTR,22625,22675,22700,22325,22475,-150
899,2024-05-28,UNVR,3260,3290,3390,3160,3280,20
900,2024-05-29,ACES,810,810,835,805,825,15
901,2024-05-29,AMRT,2880,2820,2840,2770,2800,-80
902,2024-05-29,ASII,4510,4800,4800,4370,4460,-50
903,2024-05-29,HRUM,1385,1390,1410,1370,1385,0
904,2024-05-29,INKP,9600,9550,9650,9400,9550,-50
905,2024-05-29,INTP,6700,6675,6675,6575,6575,-125
906,2024-05-29,MAPI,1345,1350,1350,1285,1300,-45
907,2024-05-29,SIDO,705,705,715,690,700,-5
908,2024-05-29,UNTR,22475,22500,22525,22275,22525,50
909,2024-05-29,UNVR,3280,3280,3280,2970,3010,-270
910,2024-05-30,ACES,825,830,835,810,815,-10
911,2024-05-30,AMRT,2800,2820,2850,2760,2760,-40
912,2024-05-30,ASII,4460,4450,4450,4310,4320,-140
913,2024-05-30,HRUM,1385,1400,1400,1335,1365,-20
914,2024-05-30,INKP,9550,9600,9700,9250,9475,-75
915,2024-05-30,INTP,6575,6575,6575,6375,6475,-100
916,2024-05-30,MAPI,1300,1300,1310,1270,1295,-5
917,2024-05-30,SIDO,700,700,700,670,700,0
918,2024-05-30,UNTR,22525,22500,22500,22125,22275,-250
919,2024-05-30,UNVR,3010,3000,3190,2970,3110,100
920,2024-05-31,ACES,815,815,830,815,820,5
921,2024-05-31,AMRT,2760,2780,2820,2650,2650,-110
922,2024-05-31,ASII,4320,4340,4370,4290,4290,-30
923,2024-05-31,HRUM,1365,1365,1410,1340,1400,35
924,2024-05-31,INKP,9475,9475,9525,9100,9100,-375
925,2024-05-31,INTP,6475,6475,6725,6425,6475,0
926,2024-05-31,MAPI,1295,1295,1315,1240,1270,-25
927,2024-05-31,SIDO,700,700,710,680,710,10
928,2024-05-31,UNTR,22275,22350,22650,22075,22075,-200
929,2024-05-31,UNVR,3110,3160,3230,3120,3120,10
930,2023-01-02,ACES,496,0,510,496,510,14
931,2023-01-02,AMRT,2650,2660,2750,2650,2740,90
932,2023-01-02,ASII,5700,5725,5725,5625,5700,0
933,2023-01-02,HRUM,1620,1620,1635,1610,1620,0
934,2023-01-02,INKP,8725,8725,8850,8675,8675,-50
935,2023-01-02,INTP,9900,9900,9950,9800,9950,50
936,2023-01-02,MAPI,1445,0,1530,1400,1415,-30
937,2023-01-02,SIDO,755,0,760,740,745,-10
938,2023-01-02,UNTR,26075,26100,26150,25800,25800,-275
939,2023-01-02,UNVR,4700,4700,4700,4610,4620,-80
940,2023-01-03,ACES,510,0,550,510,510,0
941,2023-01-03,AMRT,2740,2740,2860,2710,2770,30
942,2023-01-03,ASII,5700,5675,5700,5625,5650,-50
943,2023-01-03,HRUM,1620,1630,1660,1620,1645,25
944,2023-01-03,INKP,8675,8675,8850,8675,8750,75
945,2023-01-03,INTP,9950,9950,9950,9825,9850,-100
946,2023-01-03,MAPI,1415,0,1440,1400,1415,0
947,2023-01-03,SIDO,745,0,755,735,745,0
948,2023-01-03,UNTR,25800,25850,26000,25700,25900,100
949,2023-01-03,UNVR,4620,4600,4650,4570,4600,-20
950,2023-01-04,ACES,510,0,525,500,500,-10
951,2023-01-04,AMRT,2770,2780,2840,2740,2740,-30
952,2023-01-04,ASII,5650,5650,5700,5625,5675,25
953,2023-01-04,HRUM,1645,1660,1665,1620,1625,-20
954,2023-01-04,INKP,8750,8750,8800,8300,8400,-350
955,2023-01-04,INTP,9850,9850,9925,9675,9775,-75
956,2023-01-04,MAPI,1415,0,1430,1350,1395,-20
957,2023-01-04,SIDO,745,0,760,740,755,10
958,2023-01-04,UNTR,25900,25900,26000,24150,24150,-1750
959,2023-01-04,UNVR,4600,4610,4690,4610,4640,40
960,2023-01-05,ACES,500,0,505,484,488,-12
961,2023-01-05,AMRT,2740,2750,2820,2670,2810,70
962,2023-01-05,ASII,5675,5650,5700,5375,5375,-300
963,2023-01-05,HRUM,1625,1605,1610,1520,1530,-95
964,2023-01-05,INKP,8400,8400,8475,8125,8325,-75
965,2023-01-05,INTP,9775,9775,9825,9550,9625,-150
966,2023-01-05,MAPI,1395,0,1400,1320,1345,-50
967,2023-01-05,SIDO,755,0,760,735,740,-15
968,2023-01-05,UNTR,24150,24025,24900,23600,24675,525
969,2023-01-05,UNVR,4640,4650,4730,4600,4730,90
970,2023-01-06,ACES,488,0,500,480,490,2
971,2023-01-06,AMRT,2810,2810,2890,2770,2800,-10
972,2023-01-06,ASII,5375,5400,5525,5350,5450,75
973,2023-01-06,HRUM,1530,1500,1555,1480,1520,-10
974,2023-01-06,INKP,8325,8300,8625,8250,8625,300
975,2023-01-06,INTP,9625,9575,10150,9550,10050,425
976,2023-01-06,MAPI,1345,0,1370,1300,1300,-45
977,2023-01-06,SIDO,740,0,745,735,745,5
978,2023-01-06,UNTR,24675,24825,25200,24500,24975,300
979,2023-01-06,UNVR,4730,4720,4760,4670,4760,30
980,2023-01-09,ACES,490,0,505,490,492,2
981,2023-01-09,AMRT,2800,2810,2830,2700,2740,-60
982,2023-01-09,ASII,5450,5500,5500,5275,5350,-100
983,2023-01-09,HRUM,1520,1540,1585,1515,1575,55
984,2023-01-09,INKP,8625,8625,8725,8500,8600,-25
985,2023-01-09,INTP,10050,10125,10275,10000,10275,225
986,2023-01-09,MAPI,1300,0,1335,1280,1280,-20
987,2023-01-09,SIDO,745,0,750,725,730,-15
988,2023-01-09,UNTR,24975,25000,25200,24275,24700,-275
989,2023-01-09,UNVR,4760,4760,4770,4690,4760,0
990,2023-01-10,ACES,492,0,498,470,482,-10
991,2023-01-10,AMRT,2740,2740,2760,2670,2720,-20
992,2023-01-10,ASII,5350,5375,5375,5275,5325,-25
993,2023-01-10,HRUM,1575,1565,1635,1560,1630,55
994,2023-01-10,INKP,8600,8600,8625,8350,8550,-50
995,2023-01-10,INTP,10275,10125,10175,10000,10050,-225
996,2023-01-10,MAPI,1280,0,1280,1195,1210,-70
997,2023-01-10,SIDO,730,0,735,705,710,-20
998,2023-01-10,UNTR,24700,24575,25250,24300,24950,250
999,2023-01-10,UNVR,4760,4760,4770,4660,4690,-70
1000,2023-01-11,ACES,482,0,484,450,450,-32
1001,2023-01-11,AMRT,2720,2720,2730,2610,2670,-50
1002,2023-01-11,ASII,5325,5325,5350,5200,5225,-100
1003,2023-01-11,HRUM,1630,1640,1650,1595,1640,10
1004,2023-01-11,INKP,8550,8550,8575,8400,8550,0
1005,2023-01-11,INTP,10050,10100,10275,9975,10175,125
1006,2023-01-11,MAPI,1210,0,1320,1210,1290,80
1007,2023-01-11,SIDO,710,0,715,700,705,-5
1008,2023-01-11,UNTR,24950,24725,25075,24400,25075,125
1009,2023-01-11,UNVR,4690,4680,4700,4640,4700,10
1010,2023-01-12,ACES,450,0,470,442,466,16
1011,2023-01-12,AMRT,2670,2660,2740,2660,2710,40
1012,2023-01-12,ASII,5225,5200,5375,5200,5350,125
1013,2023-01-12,HRUM,1640,1620,1640,1605,1615,-25
1014,2023-01-12,INKP,8550,8550,8775,8475,8750,200
1015,2023-01-12,INTP,10175,10275,10450,10175,10300,125
1016,2023-01-12,MAPI,1290,0,1320,1265,1290,0
1017,2023-01-12,SIDO,705,0,715,700,715,10
1018,2023-01-12,UNTR,25075,24900,25125,24800,24950,-125
1019,2023-01-12,UNVR,4700,4700,4760,4660,4760,60
1020,2023-01-13,ACES,466,0,470,444,450,-16
1021,2023-01-13,AMRT,2710,2720,2770,2700,2760,50
1022,2023-01-13,ASII,5350,5375,5500,5300,5450,100
1023,2023-01-13,HRUM,1615,1625,1685,1625,1670,55
1024,2023-01-13,INKP,8750,8750,8750,8475,8625,-125
1025,2023-01-13,INTP,10300,10300,10425,10200,10275,-25
1026,2023-01-13,MAPI,1290,0,1300,1270,1295,5
1027,2023-01-13,SIDO,715,0,730,710,730,15
1028,2023-01-13,UNTR,24950,25000,25025,24025,24150,-800
1029,2023-01-13,UNVR,4760,4750,4790,4720,4790,30
1030,2023-01-16,ACES,450,0,456,440,440,-10
1031,2023-01-16,AMRT,2760,2760,2790,2660,2680,-80
1032,2023-01-16,ASII,5450,5525,5600,5475,5600,150
1033,2023-01-16,HRUM,1670,1685,1700,1660,1695,25
1034,2023-01-16,INKP,8625,8650,8650,8500,8625,0
1035,2023-01-16,INTP,10275,10300,10425,10250,10250,-25
1036,2023-01-16,MAPI,1295,0,1335,1270,1320,25
1037,2023-01-16,SIDO,730,0,735,725,725,-5
1038,2023-01-16,UNTR,24150,24175,24350,24100,24225,75
1039,2023-01-16,UNVR,4790,4790,4800,4750,4770,-20
1040,2023-01-17,ACES,440,0,446,432,436,-4
1041,2023-01-17,AMRT,2680,2690,2750,2660,2720,40
1042,2023-01-17,ASII,5600,5600,5650,5500,5550,-50
1043,2023-01-17,HRUM,1695,1695,1740,1685,1730,35
1044,2023-01-17,INKP,8625,8625,8800,8600,8725,100
1045,2023-01-17,INTP,10250,10250,10275,9800,9975,-275
1046,2023-01-17,MAPI,1320,0,1365,1320,1350,30
1047,2023-01-17,SIDO,725,0,735,720,725,0
1048,2023-01-17,UNTR,24225,24225,24600,24225,24325,100
1049,2023-01-17,UNVR,4770,4770,4800,4720,4760,-10
1050,2023-01-18,ACES,436,0,446,436,440,4
1051,2023-01-18,AMRT,2720,2730,2760,2690,2730,10
1052,2023-01-18,ASII,5550,5550,5650,5550,5650,100
1053,2023-01-18,HRUM,1730,1730,1750,1705,1725,-5
1054,2023-01-18,INKP,8725,8700,8875,8625,8875,150
1055,2023-01-18,INTP,9975,9975,9975,9750,9825,-150
1056,2023-01-18,MAPI,1350,0,1375,1305,1335,-15
1057,2023-01-18,SIDO,725,0,730,720,725,0
1058,2023-01-18,UNTR,24325,24300,24750,24275,24750,425
1059,2023-01-18,UNVR,4760,4760,4800,4720,4800,40
1060,2023-01-19,ACES,440,0,442,426,430,-10
1061,2023-01-19,AMRT,2730,2730,2760,2710,2750,20
1062,2023-01-19,ASII,5650,5650,5875,5650,5850,200
1063,2023-01-19,HRUM,1725,1730,1755,1730,1745,20
1064,2023-01-19,INKP,8875,8800,8875,8725,8750,-125
1065,2023-01-19,INTP,9825,9750,10075,9725,10000,175
1066,2023-01-19,MAPI,1335,0,1395,1330,1390,55
1067,2023-01-19,SIDO,725,0,730,720,725,0
1068,2023-01-19,UNTR,24750,24650,26275,24600,26250,1500
1069,2023-01-19,UNVR,4800,4800,4830,4770,4800,0
1070,2023-01-20,ACES,430,0,458,430,458,28
1071,2023-01-20,AMRT,2750,2760,2760,2670,2760,10
1072,2023-01-20,ASII,5850,5875,5900,5775,5900,50
1073,2023-01-20,HRUM,1745,1755,1785,1755,1755,10
1074,2023-01-20,INKP,8750,8800,8975,8700,8825,75
1075,2023-01-20,INTP,10000,9975,9975,9775,9800,-200
1076,2023-01-20,MAPI,1390,0,1420,1365,1415,25
1077,2023-01-20,SIDO,725,0,730,715,725,0
1078,2023-01-20,UNTR,26250,26350,26775,25950,26775,525
1079,2023-01-20,UNVR,4800,4800,4830,4760,4810,10
1080,2023-01-24,ACES,458,0,478,444,450,-8
1081,2023-01-24,AMRT,2760,2740,2740,2660,2670,-90
1082,2023-01-24,ASII,5900,5900,5950,5850,5925,25
1083,2023-01-24,HRUM,1755,1740,1775,1715,1725,-30
1084,2023-01-24,INKP,8825,8900,8925,8725,8800,-25
1085,2023-01-24,INTP,9800,9825,9900,9750,9775,-25
1086,2023-01-24,MAPI,1415,0,1420,1380,1395,-20
1087,2023-01-24,SIDO,725,0,735,720,725,0
1088,2023-01-24,UNTR,26775,26775,26925,26025,26125,-650
1089,2023-01-24,UNVR,4810,4810,4850,4790,4830,20
1090,2023-01-25,ACES,450,0,454,446,450,0
1091,2023-01-25,AMRT,2670,2670,2690,2630,2660,-10
1092,2023-01-25,ASII,5925,5900,5950,5850,5950,25
1093,2023-01-25,HRUM,1725,1725,1740,1710,1725,0
1094,2023-01-25,INKP,8800,8800,8825,8700,8775,-25
1095,2023-01-25,INTP,9775,9775,9900,9750,9850,75
1096,2023-01-25,MAPI,1395,0,1405,1315,1335,-60
1097,2023-01-25,SIDO,725,0,735,720,735,10
1098,2023-01-25,UNTR,26125,26125,26125,25725,26050,-75
1099,2023-01-25,UNVR,4830,4830,4860,4810,4850,20
1100,2023-01-26,ACES,450,0,488,452,486,36
1101,2023-01-26,AMRT,2660,2660,2750,2640,2750,90
1102,2023-01-26,ASII,5950,5925,5950,5850,5900,-50
1103,2023-01-26,HRUM,1725,1725,1730,1680,1685,-40
1104,2023-01-26,INKP,8775,8750,8800,8475,8500,-275
1105,2023-01-26,INTP,9850,9900,10275,9900,10100,250
1106,2023-01-26,MAPI,1335,0,1345,1295,1310,-25
1107,2023-01-26,SIDO,735,0,775,735,770,35
1108,2023-01-26,UNTR,26050,25900,25900,25250,25250,-800
1109,2023-01-26,UNVR,4850,4850,4870,4760,4800,-50
1110,2023-01-27,ACES,486,0,520,484,496,10
1111,2023-01-27,AMRT,2750,2750,2810,2710,2790,40
1112,2023-01-27,ASII,5900,5925,5950,5875,5875,-25
1113,2023-01-27,HRUM,1685,1685,1705,1675,1690,5
1114,2023-01-27,INKP,8500,8500,8775,8500,8525,25
1115,2023-01-27,INTP,10100,10100,10100,9850,9900,-200
1116,2023-01-27,MAPI,1310,0,1340,1250,1265,-45
1117,2023-01-27,SIDO,770,0,775,760,760,-10
1118,2023-01-27,UNTR,25250,25275,25800,25275,25575,325
1119,2023-01-27,UNVR,4800,4800,4820,4750,4750,-50
1120,2023-01-30,ACES,496,0,510,494,498,2
1121,2023-01-30,AMRT,2790,2790,2850,2730,2850,60
1122,2023-01-30,ASII,5875,5875,5900,5775,5875,0
1123,2023-01-30,HRUM,1690,1690,1710,1660,1695,5
1124,2023-01-30,INKP,8525,8600,8625,8400,8500,-25
1125,2023-01-30,INTP,9900,9850,9925,9775,9825,-75
1126,2023-01-30,MAPI,1265,0,1325,1270,1315,50
1127,2023-01-30,SIDO,760,0,775,755,765,5
1128,2023-01-30,UNTR,25575,25275,25775,24950,25250,-325
1129,2023-01-30,UNVR,4750,4750,4780,4710,4760,10
1130,2023-01-31,ACES,498,0,515,490,490,-8
1131,2023-01-31,AMRT,2850,2840,2860,2750,2830,-20
1132,2023-01-31,ASII,5875,5925,6025,5900,6000,125
1133,2023-01-31,HRUM,1695,1695,1750,1690,1730,35
1134,2023-01-31,INKP,8500,8500,8550,8325,8325,-175
1135,2023-01-31,INTP,9825,9825,10050,9825,10000,175
1136,2023-01-31,MAPI,1315,0,1335,1295,1300,-15
1137,2023-01-31,SIDO,765,0,770,750,755,-10
1138,2023-01-31,UNTR,25250,25200,25350,24550,24550,-700
1139,2023-01-31,UNVR,4760,4760,4760,4660,4660,-100
1140,2023-02-01,ACES,490,490,505,476,480,-10
1141,2023-02-01,AMRT,2830,2840,3150,2790,2970,140
1142,2023-02-01,ASII,6000,6000,6000,5925,6000,0
1143,2023-02-01,HRUM,1730,1730,1760,1730,1745,15
1144,2023-02-01,INKP,8325,8400,8650,8400,8450,125
1145,2023-02-01,INTP,10000,10075,10175,9850,9900,-100
1146,2023-02-01,MAPI,1300,0,1470,1300,1390,90
1147,2023-02-01,SIDO,755,760,785,750,780,25
1148,2023-02-01,UNTR,24550,24600,25025,24575,24725,175
1149,2023-02-01,UNVR,4660,4630,4680,4620,4630,-30
1150,2023-02-02,ACES,480,482,505,482,494,14
1151,2023-02-02,AMRT,2970,2970,3020,2920,2950,-20
1152,2023-02-02,ASII,6000,5950,5975,5875,5925,-75
1153,2023-02-02,HRUM,1745,1745,1755,1690,1695,-50
1154,2023-02-02,INKP,8450,8550,8700,8525,8525,75
1155,2023-02-02,INTP,9900,10100,10425,10000,10350,450
1156,2023-02-02,MAPI,1390,0,1440,1390,1400,10
1157,2023-02-02,SIDO,780,780,790,780,780,0
1158,2023-02-02,UNTR,24725,24725,25000,24100,24100,-625
1159,2023-02-02,UNVR,4630,4630,4740,4630,4730,100
1160,2023-02-03,ACES,494,500,500,486,492,-2
1161,2023-02-03,AMRT,2950,2990,2990,2920,2990,40
1162,2023-02-03,ASII,5925,5975,5975,5875,5875,-50
1163,2023-02-03,HRUM,1695,1700,1710,1645,1645,-50
1164,2023-02-03,INKP,8525,8575,8700,8575,8675,150
1165,2023-02-03,INTP,10350,10350,10650,10325,10600,250
1166,2023-02-03,MAPI,1400,0,1435,1385,1385,-15
1167,2023-02-03,SIDO,780,785,790,780,785,5
1168,2023-02-03,UNTR,24100,24175,24350,23950,24000,-100
1169,2023-02-03,UNVR,4730,4740,4740,4680,4690,-40
1170,2023-02-06,ACES,492,494,510,490,498,6
1171,2023-02-06,AMRT,2990,2980,3000,2880,2920,-70
1172,2023-02-06,ASII,5875,5875,5900,5825,5850,-25
1173,2023-02-06,HRUM,1645,1630,1670,1610,1640,-5
1174,2023-02-06,INKP,8675,8675,8675,8525,8625,-50
1175,2023-02-06,INTP,10600,10750,11125,10700,10975,375
1176,2023-02-06,MAPI,1385,0,1470,1385,1440,55
1177,2023-02-06,SIDO,785,785,790,780,785,0
1178,2023-02-06,UNTR,24000,24000,24225,23800,23925,-75
1179,2023-02-06,UNVR,4690,4690,4730,4660,4730,40
1180,2023-02-07,ACES,498,500,500,488,490,-8
1181,2023-02-07,AMRT,2920,2920,2950,2890,2940,20
1182,2023-02-07,ASII,5850,5825,5925,5825,5875,25
1183,2023-02-07,HRUM,1640,1685,1700,1660,1690,50
1184,2023-02-07,INKP,8625,8625,8650,8500,8525,-100
1185,2023-02-07,INTP,10975,10900,11050,10775,10775,-200
1186,2023-02-07,MAPI,1440,0,1515,1440,1495,55
1187,2023-02-07,SIDO,785,785,790,780,790,5
1188,2023-02-07,UNTR,23925,24425,25375,24300,24900,975
1189,2023-02-07,UNVR,4730,4730,4890,4720,4860,130
1190,2023-02-08,ACES,490,492,505,492,496,6
1191,2023-02-08,AMRT,2940,2950,3000,2940,2950,10
1192,2023-02-08,ASII,5875,5875,5900,5775,5800,-75
1193,2023-02-08,HRUM,1690,1700,1705,1665,1695,5
1194,2023-02-08,INKP,8525,8550,8600,8475,8575,50
1195,2023-02-08,INTP,10775,10725,11000,10675,10950,175
1196,2023-02-08,MAPI,1495,0,1520,1465,1480,-15
1197,2023-02-08,SIDO,790,790,800,785,800,10
1198,2023-02-08,UNTR,24900,25100,25275,24650,24800,-100
1199,2023-02-08,UNVR,4860,4860,5025,4810,5025,165
1200,2023-02-09,ACES,496,498,520,494,510,14
1201,2023-02-09,AMRT,2950,2980,2980,2940,2950,0
1202,2023-02-09,ASII,5800,5825,5850,5675,5675,-125
1203,2023-02-09,HRUM,1695,1670,1690,1665,1675,-20
1204,2023-02-09,INKP,8575,8575,8625,8550,8550,-25
1205,2023-02-09,INTP,10950,10950,11125,10825,10975,25
1206,2023-02-09,MAPI,1480,0,1480,1420,1440,-40
1207,2023-02-09,SIDO,800,800,805,795,800,0
1208,2023-02-09,UNTR,24800,24575,24925,24500,24500,-300
1209,2023-02-09,UNVR,5025,5025,5050,4920,4920,-105
1210,2023-02-10,ACES,510,515,515,492,505,-5
1211,2023-02-10,AMRT,2950,2950,2960,2880,2950,0
1212,2023-02-10,ASII,5675,5600,5700,5550,5700,25
1213,2023-02-10,HRUM,1675,1660,1660,1575,1650,-25
1214,2023-02-10,INKP,8550,8550,8600,8400,8600,50
1215,2023-02-10,INTP,10975,11100,11500,11075,11475,500
1216,2023-02-10,MAPI,1440,0,1455,1430,1440,0
1217,2023-02-10,SIDO,800,805,810,790,800,0
1218,2023-02-10,UNTR,24500,24225,24600,24200,24500,0
1219,2023-02-10,UNVR,4920,4770,4770,4580,4580,-340
1220,2023-02-13,ACES,505,505,545,500,545,40
1221,2023-02-13,AMRT,2950,2950,3030,2940,2970,20
1222,2023-02-13,ASII,5700,5700,5750,5675,5725,25
1223,2023-02-13,HRUM,1650,1665,1670,1615,1625,-25
1224,2023-02-13,INKP,8600,8600,8600,8425,8475,-125
1225,2023-02-13,INTP,11475,11450,11575,11275,11400,-75
1226,2023-02-13,MAPI,1440,0,1600,1435,1575,135
1227,2023-02-13,SIDO,800,800,840,795,830,30
1228,2023-02-13,UNTR,24500,24800,24875,24450,24625,125
1229,2023-02-13,UNVR,4580,4580,4580,4490,4520,-60
1230,2023-02-14,ACES,545,550,565,530,540,-5
1231,2023-02-14,AMRT,2970,2980,3010,2960,3010,40
1232,2023-02-14,ASII,5725,5750,5800,5700,5725,0
1233,2023-02-14,HRUM,1625,1620,1635,1595,1630,5
1234,2023-02-14,INKP,8475,8475,8475,8225,8250,-225
1235,2023-02-14,INTP,11400,11425,11850,11425,11700,300
1236,2023-02-14,MAPI,1575,0,1575,1520,1520,-55
1237,2023-02-14,SIDO,830,830,875,830,870,40
1238,2023-02-14,UNTR,24625,24650,24750,24450,24750,125
1239,2023-02-14,UNVR,4520,4520,4570,4520,4560,40
1240,2023-02-15,ACES,540,545,550,540,545,5
1241,2023-02-15,AMRT,3010,3010,3070,2970,3070,60
1242,2023-02-15,ASII,5725,5725,5725,5575,5675,-50
1243,2023-02-15,HRUM,1630,1625,1655,1610,1640,10
1244,2023-02-15,INKP,8250,8275,8300,8075,8175,-75
1245,2023-02-15,INTP,11700,11700,11700,11275,11525,-175
1246,2023-02-15,MAPI,1520,0,1565,1505,1520,0
1247,2023-02-15,SIDO,870,875,880,850,870,0
1248,2023-02-15,UNTR,24750,24775,25200,24525,24875,125
1249,2023-02-15,UNVR,4560,4560,4560,4500,4550,-10
1250,2023-02-16,ACES,545,545,560,540,555,10
1251,2023-02-16,AMRT,3070,3070,3100,2980,2980,-90
1252,2023-02-16,ASII,5675,5700,5700,5625,5700,25
1253,2023-02-16,HRUM,1640,1650,1655,1605,1605,-35
1254,2023-02-16,INKP,8175,8175,8225,8050,8125,-50
1255,2023-02-16,INTP,11525,11550,11575,11300,11400,-125
1256,2023-02-16,MAPI,1520,0,1565,1520,1530,10
1257,2023-02-16,SIDO,870,870,890,865,890,20
1258,2023-02-16,UNTR,24875,24900,24975,24550,24650,-225
1259,2023-02-16,UNVR,4550,4550,4560,4510,4520,-30
1260,2023-02-17,ACES,555,560,565,530,540,-15
1261,2023-02-17,AMRT,2980,2980,3020,2910,2980,0
1262,2023-02-17,ASII,5700,5700,5725,5625,5675,-25
1263,2023-02-17,HRUM,1605,1605,1615,1565,1605,0
1264,2023-02-17,INKP,8125,8100,8100,7950,7950,-175
1265,2023-02-17,INTP,11400,11375,11475,11000,11000,-400
1266,2023-02-17,MAPI,1530,0,1545,1475,1495,-35
1267,2023-02-17,SIDO,890,890,890,835,870,-20
1268,2023-02-17,UNTR,24650,24575,24650,24350,24625,-25
1269,2023-02-17,UNVR,4520,4520,4530,4480,4510,-10
1270,2023-02-20,ACES,540,540,550,530,540,0
1271,2023-02-20,AMRT,2980,2980,3040,2980,3040,60
1272,2023-02-20,ASII,5675,5675,5700,5575,5600,-75
1273,2023-02-20,HRUM,1605,1600,1625,1575,1615,10
1274,2023-02-20,INKP,7950,7900,7975,7850,7925,-25
1275,2023-02-20,INTP,11000,11100,11325,11000,11100,100
1276,2023-02-20,MAPI,1495,0,1560,1485,1540,45
1277,2023-02-20,SIDO,870,865,870,840,860,-10
1278,2023-02-20,UNTR,24625,24525,24525,24000,24300,-325
1279,2023-02-20,UNVR,4510,4520,4560,4500,4540,30
1280,2023-02-21,ACES,540,545,555,540,545,5
1281,2023-02-21,AMRT,3040,3040,3060,3010,3060,20
1282,2023-02-21,ASII,5600,5600,5650,5550,5575,-25
1283,2023-02-21,HRUM,1615,1615,1635,1585,1605,-10
1284,2023-02-21,INKP,7925,7925,8150,7925,8050,125
1285,2023-02-21,INTP,11100,11175,11475,11175,11400,300
1286,2023-02-21,MAPI,1540,0,1575,1540,1550,10
1287,2023-02-21,SIDO,860,860,865,850,865,5
1288,2023-02-21,UNTR,24300,24300,24400,24000,24000,-300
1289,2023-02-21,UNVR,4540,4540,4540,4500,4500,-40
1290,2023-02-22,ACES,545,540,545,520,525,-20
1291,2023-02-22,AMRT,3060,3050,3060,3020,3030,-30
1292,2023-02-22,ASII,5575,5550,5650,5550,5625,50
1293,2023-02-22,HRUM,1605,1625,1630,1575,1575,-30
1294,2023-02-22,INKP,8050,8050,8100,7950,8000,-50
1295,2023-02-22,INTP,11400,11300,11400,11175,11275,-125
1296,2023-02-22,MAPI,1550,0,1565,1520,1550,0
1297,2023-02-22,SIDO,865,860,895,855,880,15
1298,2023-02-22,UNTR,24000,24250,24400,24050,24325,325
1299,2023-02-22,UNVR,4500,4490,4490,4380,4480,-20
1300,2023-02-23,ACES,525,530,535,500,510,-15
1301,2023-02-23,AMRT,3030,3030,3030,2950,2980,-50
1302,2023-02-23,ASII,5625,5650,5700,5575,5650,25
1303,2023-02-23,HRUM,1575,1575,1600,1575,1600,25
1304,2023-02-23,INKP,8000,8000,8050,7875,7950,-50
1305,2023-02-23,INTP,11275,11275,11350,11125,11200,-75
1306,2023-02-23,MAPI,1550,0,1635,1550,1590,40
1307,2023-02-23,SIDO,880,880,880,865,880,0
1308,2023-02-23,UNTR,24325,24475,24900,24375,24700,375
1309,2023-02-23,UNVR,4480,4490,4490,4400,4400,-80
1310,2023-02-24,ACES,510,515,535,510,515,5
1311,2023-02-24,AMRT,2980,3000,3010,2910,2910,-70
1312,2023-02-24,ASII,5650,5675,5800,5650,5750,100
1313,2023-02-24,HRUM,1600,1600,1610,1590,1590,-10
1314,2023-02-24,INKP,7950,7950,8100,7950,8025,75
1315,2023-02-24,INTP,11200,11300,11300,11100,11100,-100
1316,2023-02-24,MAPI,1590,0,1665,1580,1600,10
1317,2023-02-24,SIDO,880,880,880,865,865,-15
1318,2023-02-24,UNTR,24700,24900,25200,24800,24950,250
1319,2023-02-24,UNVR,4400,4400,4440,4350,4350,-50
1320,2023-02-27,ACES,515,515,525,500,510,-5
1321,2023-02-27,AMRT,2910,2920,2950,2840,2950,40
1322,2023-02-27,ASII,5750,5725,5800,5700,5800,50
1323,2023-02-27,HRUM,1590,1595,1615,1580,1590,0
1324,2023-02-27,INKP,8025,8075,8075,7975,8025,0
1325,2023-02-27,INTP,11100,11100,11400,10950,11025,-75
1326,2023-02-27,MAPI,1600,0,1610,1550,1590,-10
1327,2023-02-27,SIDO,865,865,875,850,855,-10
1328,2023-02-27,UNTR,24950,25025,25200,24900,25175,225
1329,2023-02-27,UNVR,4350,4350,4350,4210,4300,-50
1330,2023-02-28,ACES,510,510,515,500,505,-5
1331,2023-02-28,AMRT,2950,2950,2960,2860,2900,-50
1332,2023-02-28,ASII,5800,6200,6275,6100,6100,300
1333,2023-02-28,HRUM,1590,1600,1635,1595,1630,40
1334,2023-02-28,INKP,8025,8000,8000,7900,7925,-100
1335,2023-02-28,INTP,11025,11075,11175,10875,11125,100
1336,2023-02-28,MAPI,1590,0,1590,1510,1510,-80
1337,2023-02-28,SIDO,855,855,880,850,880,25
1338,2023-02-28,UNTR,25175,29200,30150,27750,27900,2725
1339,2023-02-28,UNVR,4300,4300,4320,4180,4180,-120
1340,2023-03-01,ACES,505,505,515,505,505,0
1341,2023-03-01,AMRT,2900,2900,2930,2860,2890,-10
1342,2023-03-01,ASII,6100,6100,6175,6050,6150,50
1343,2023-03-01,HRUM,1630,1630,1660,1615,1655,25
1344,2023-03-01,INKP,7925,7925,8000,7925,8000,75
1345,2023-03-01,INTP,11125,11125,11275,11025,11275,150
1346,2023-03-01,MAPI,1510,0,1610,1515,1550,40
1347,2023-03-01,SIDO,880,875,890,860,885,5
1348,2023-03-01,UNTR,27900,28050,28350,27550,27575,-325
1349,2023-03-01,UNVR,4180,4170,4200,4110,4150,-30
1350,2023-03-02,ACES,505,505,510,492,494,-11
1351,2023-03-02,AMRT,2890,2900,2970,2900,2960,70
1352,2023-03-02,ASII,6150,6150,6175,6075,6150,0
1353,2023-03-02,HRUM,1655,1665,1690,1650,1670,15
1354,2023-03-02,INKP,8000,8025,8050,7925,7925,-75
1355,2023-03-02,INTP,11275,11250,11300,11125,11125,-150
1356,2023-03-02,MAPI,1550,0,1645,1550,1620,70
1357,2023-03-02,SIDO,885,880,915,870,910,25
1358,2023-03-02,UNTR,27575,27700,28450,27650,28325,750
1359,2023-03-02,UNVR,4150,4160,4220,4150,4150,0
1360,2023-03-03,ACES,494,494,510,486,496,2
1361,2023-03-03,AMRT,2960,2960,2980,2770,2770,-190
1362,2023-03-03,ASII,6150,6150,6150,6025,6050,-100
1363,2023-03-03,HRUM,1670,1675,1695,1675,1690,20
1364,2023-03-03,INKP,7925,7950,8000,7850,7850,-75
1365,2023-03-03,INTP,11125,11275,11600,11175,11425,300
1366,2023-03-03,MAPI,1620,0,1635,1555,1560,-60
1367,2023-03-03,SIDO,910,910,915,890,895,-15
1368,2023-03-03,UNTR,28325,28375,28475,28000,28125,-200
1369,2023-03-03,UNVR,4150,4150,4170,4050,4060,-90
1370,2023-03-06,ACES,496,505,510,498,498,2
1371,2023-03-06,AMRT,2770,2800,2860,2790,2820,50
1372,2023-03-06,ASII,6050,6100,6125,6050,6075,25
1373,2023-03-06,HRUM,1690,1690,1695,1650,1660,-30
1374,2023-03-06,INKP,7850,7875,7925,7800,7825,-25
1375,2023-03-06,INTP,11425,11475,11600,11275,11300,-125
1376,2023-03-06,MAPI,1560,0,1595,1555,1570,10
1377,2023-03-06,SIDO,895,895,900,885,900,5
1378,2023-03-06,UNTR,28125,28175,28275,27650,27650,-475
1379,2023-03-06,UNVR,4060,4080,4190,4070,4170,110
1380,2023-03-07,ACES,498,500,505,494,496,-2
1381,2023-03-07,AMRT,2820,2820,2840,2810,2810,-10
1382,2023-03-07,ASII,6075,6050,6075,5900,5950,-125
1383,2023-03-07,HRUM,1660,1660,1665,1625,1665,5
1384,2023-03-07,INKP,7825,7825,7850,7650,7725,-100
1385,2023-03-07,INTP,11300,11250,11400,11125,11250,-50
1386,2023-03-07,MAPI,1570,0,1610,1555,1600,30
1387,2023-03-07,SIDO,900,900,910,895,900,0
1388,2023-03-07,UNTR,27650,27650,27675,26800,26825,-825
1389,2023-03-07,UNVR,4170,4160,4160,4080,4080,-90
1390,2023-03-08,ACES,496,494,496,480,486,-10
1391,2023-03-08,AMRT,2810,2810,2870,2790,2870,60
1392,2023-03-08,ASII,5950,5900,5975,5875,5925,-25
1393,2023-03-08,HRUM,1665,1665,1665,1590,1630,-35
1394,2023-03-08,INKP,7725,7700,7700,7550,7600,-125
1395,2023-03-08,INTP,11250,11250,11475,11200,11475,225
1396,2023-03-08,MAPI,1600,0,1615,1565,1570,-30
1397,2023-03-08,SIDO,900,895,895,880,885,-15
1398,2023-03-08,UNTR,26825,26725,26875,26200,26400,-425
1399,2023-03-08,UNVR,4080,4080,4120,4060,4100,20
1400,2023-03-09,ACES,486,488,505,486,500,14
1401,2023-03-09,AMRT,2870,2880,2890,2830,2830,-40
1402,2023-03-09,ASII,5925,5975,6050,5950,6025,100
1403,2023-03-09,HRUM,1630,1620,1630,1605,1610,-20
1404,2023-03-09,INKP,7600,7600,7775,7575,7575,-25
1405,2023-03-09,INTP,11475,11450,11475,11300,11475,0
1406,2023-03-09,MAPI,1570,0,1575,1495,1520,-50
1407,2023-03-09,SIDO,885,890,900,880,885,0
1408,2023-03-09,UNTR,26400,26825,27425,26600,27025,625
1409,2023-03-09,UNVR,4100,4100,4140,4080,4100,0
1410,2023-03-10,ACES,500,500,505,492,500,0
1411,2023-03-10,AMRT,2830,2840,2880,2790,2810,-20
1412,2023-03-10,ASII,6025,5975,6000,5900,5975,-50
1413,2023-03-10,HRUM,1610,1615,1645,1605,1635,25
1414,2023-03-10,INKP,7575,7575,7600,7375,7400,-175
1415,2023-03-10,INTP,11475,11400,11475,11325,11475,0
1416,2023-03-10,MAPI,1520,0,1525,1445,1465,-55
1417,2023-03-10,SIDO,885,885,900,855,900,15
1418,2023-03-10,UNTR,27025,27000,27150,26600,26825,-200
1419,2023-03-10,UNVR,4100,4100,4140,4080,4110,10
1420,2023-03-13,ACES,500,496,505,494,500,0
1421,2023-03-13,AMRT,2810,2820,2870,2800,2870,60
1422,2023-03-13,ASII,5975,5900,5975,5850,5925,-50
1423,2023-03-13,HRUM,1635,1635,1655,1620,1625,-10
1424,2023-03-13,INKP,7400,7450,7775,7400,7425,25
1425,2023-03-13,INTP,11475,11475,11475,10900,11025,-450
1426,2023-03-13,MAPI,1465,0,1540,1425,1540,75
1427,2023-03-13,SIDO,900,890,890,845,845,-55
1428,2023-03-13,UNTR,26825,27300,28175,27125,28075,1250
1429,2023-03-13,UNVR,4110,4090,4180,4080,4160,50
1430,2023-03-14,ACES,500,498,500,466,468,-32
1431,2023-03-14,AMRT,2870,2870,2890,2840,2840,-30
1432,2023-03-14,ASII,5925,5900,5925,5750,5775,-150
1433,2023-03-14,HRUM,1625,1625,1630,1550,1555,-70
1434,2023-03-14,INKP,7425,7475,7525,7325,7350,-75
1435,2023-03-14,INTP,11025,11000,11150,10800,11000,-25
1436,2023-03-14,MAPI,1540,0,1580,1450,1465,-75
1437,2023-03-14,SIDO,845,855,875,830,835,-10
1438,2023-03-14,UNTR,28075,28025,28025,27100,27100,-975
1439,2023-03-14,UNVR,4160,4140,4240,4130,4210,50
1440,2023-03-15,ACES,468,472,482,436,456,-12
1441,2023-03-15,AMRT,2840,2870,2900,2840,2850,10
1442,2023-03-15,ASII,5775,5850,5875,5775,5775,0
1443,2023-03-15,HRUM,1555,1560,1580,1500,1530,-25
1444,2023-03-15,INKP,7350,7400,7500,7175,7175,-175
1445,2023-03-15,INTP,11000,10900,11000,10250,10250,-750
1446,2023-03-15,MAPI,1465,0,1570,1470,1545,80
1447,2023-03-15,SIDO,835,840,855,840,850,15
1448,2023-03-15,UNTR,27100,27700,27700,27225,27250,150
1449,2023-03-15,UNVR,4210,4210,4230,4100,4100,-110
1450,2023-03-16,ACES,456,452,458,436,440,-16
1451,2023-03-16,AMRT,2850,2870,2900,2790,2800,-50
1452,2023-03-16,ASII,5775,5775,5875,5675,5850,75
1453,2023-03-16,HRUM,1530,1525,1565,1425,1425,-105
1454,2023-03-16,INKP,7175,7150,7150,6775,6825,-350
1455,2023-03-16,INTP,10250,9900,9975,9550,9750,-500
1456,2023-03-16,MAPI,1545,0,1600,1495,1600,55
1457,2023-03-16,SIDO,850,850,850,815,835,-15
1458,2023-03-16,UNTR,27250,26900,27300,26475,26925,-325
1459,2023-03-16,UNVR,4100,4100,4120,4040,4070,-30
1460,2023-03-17,ACES,440,442,454,442,442,2
1461,2023-03-17,AMRT,2800,2810,2920,2810,2860,60
1462,2023-03-17,ASII,5850,5875,5925,5850,5850,0
1463,2023-03-17,HRUM,1425,1430,1465,1430,1465,40
1464,2023-03-17,INKP,6825,6875,7025,6875,6875,50
1465,2023-03-17,INTP,9750,9750,10200,9725,10000,250
1466,2023-03-17,MAPI,1600,0,1635,1565,1600,0
1467,2023-03-17,SIDO,835,835,845,825,825,-10
1468,2023-03-17,UNTR,26925,27000,28450,27000,28450,1525
1469,2023-03-17,UNVR,4070,4070,4170,4070,4160,90
1470,2023-03-20,ACES,442,442,458,438,450,8
1471,2023-03-20,AMRT,2860,2870,2900,2810,2850,-10
1472,2023-03-20,ASII,5850,5850,5900,5800,5875,25
1473,2023-03-20,HRUM,1465,1465,1470,1430,1440,-25
1474,2023-03-20,INKP,6875,6925,7125,6925,7125,250
1475,2023-03-20,INTP,10000,10000,10200,9925,10125,125
1476,2023-03-20,MAPI,1600,0,1600,1515,1525,-75
1477,2023-03-20,SIDO,825,825,830,820,820,-5
1478,2023-03-20,UNTR,28450,28250,28275,27425,27700,-750
1479,2023-03-20,UNVR,4160,4160,4170,4100,4160,0
1480,2023-03-21,ACES,450,452,458,444,450,0
1481,2023-03-21,AMRT,2850,2850,2900,2810,2900,50
1482,2023-03-21,ASII,5875,5850,5975,5850,5875,0
1483,2023-03-21,HRUM,1440,1440,1465,1390,1390,-50
1484,2023-03-21,INKP,7125,7150,7400,7150,7400,275
1485,2023-03-21,INTP,10125,10150,10275,10025,10075,-50
1486,2023-03-21,MAPI,1525,0,1545,1480,1495,-30
1487,2023-03-21,SIDO,820,825,835,820,825,5
1488,2023-03-21,UNTR,27700,27725,27775,27450,27475,-225
1489,2023-03-21,UNVR,4160,4160,4200,4150,4200,40
1490,2023-03-24,ACES,450,454,470,450,468,18
1491,2023-03-24,AMRT,2900,2920,2990,2860,2930,30
1492,2023-03-24,ASII,5875,5925,6000,5900,5950,75
1493,2023-03-24,HRUM,1390,1400,1410,1390,1390,0
1494,2023-03-24,INKP,7400,7400,7500,7325,7350,-50
1495,2023-03-24,INTP,10075,10100,10150,9900,10075,0
1496,2023-03-24,MAPI,1495,0,1560,1495,1515,20
1497,2023-03-24,SIDO,825,825,865,825,845,20
1498,2023-03-24,UNTR,27475,27875,28225,27525,27675,200
1499,2023-03-24,UNVR,4200,4370,4370,4240,4270,70
1500,2023-03-27,ACES,468,470,478,460,468,0
1501,2023-03-27,AMRT,2930,2910,2930,2850,2900,-30
1502,2023-03-27,ASII,5950,5950,5975,5875,5875,-75
1503,2023-03-27,HRUM,1390,1415,1440,1400,1405,15
1504,2023-03-27,INKP,7350,7375,7500,7350,7400,50
1505,2023-03-27,INTP,10075,10075,10075,9800,9950,-125
1506,2023-03-27,MAPI,1515,0,1530,1495,1500,-15
1507,2023-03-27,SIDO,845,845,865,845,855,10
1508,2023-03-27,UNTR,27675,27825,28200,27675,27800,125
1509,2023-03-27,UNVR,4270,4270,4290,4230,4290,20
1510,2023-03-28,ACES,468,472,474,462,466,-2
1511,2023-03-28,AMRT,2900,2920,2990,2900,2980,80
1512,2023-03-28,ASII,5875,5900,5925,5850,5850,-25
1513,2023-03-28,HRUM,1405,1410,1470,1410,1460,55
1514,2023-03-28,INKP,7400,7400,7625,7400,7600,200
1515,2023-03-28,INTP,9950,10125,10750,10100,10725,775
1516,2023-03-28,MAPI,1500,0,1620,1500,1600,100
1517,2023-03-28,SIDO,855,860,875,855,865,10
1518,2023-03-28,UNTR,27800,27825,28650,27700,28575,775
1519,2023-03-28,UNVR,4290,4290,4320,4280,4300,10
1520,2023-03-29,ACES,466,466,472,464,468,2
1521,2023-03-29,AMRT,2980,2970,2980,2910,2950,-30
1522,2023-03-29,ASII,5850,5850,6050,5850,5950,100
1523,2023-03-29,HRUM,1460,1485,1535,1485,1500,40
1524,2023-03-29,INKP,7600,7600,7675,7475,7625,25
1525,2023-03-29,INTP,10725,10750,10850,10575,10625,-100
1526,2023-03-29,MAPI,1600,0,1680,1585,1625,25
1527,2023-03-29,SIDO,865,865,875,860,860,-5
1528,2023-03-29,UNTR,28575,28750,29450,28700,29125,550
1529,2023-03-29,UNVR,4300,4300,4370,4300,4360,60
1530,2023-03-30,ACES,468,470,486,470,482,14
1531,2023-03-30,AMRT,2950,2950,2960,2820,2870,-80
1532,2023-03-30,ASII,5950,5975,5975,5900,5900,-50
1533,2023-03-30,HRUM,1500,1510,1515,1475,1475,-25
1534,2023-03-30,INKP,7625,7650,7750,7550,7650,25
1535,2023-03-30,INTP,10625,10650,10900,10575,10725,100
1536,2023-03-30,MAPI,1625,0,1650,1515,1540,-85
1537,2023-03-30,SIDO,860,860,865,840,840,-20
1538,2023-03-30,UNTR,29125,29000,29425,28975,28975,-150
1539,2023-03-30,UNVR,4360,4360,4370,4260,4260,-100
1540,2023-03-31,ACES,482,484,490,474,478,-4
1541,2023-03-31,AMRT,2870,2880,2960,2870,2880,10
1542,2023-03-31,ASII,5900,5950,6025,5925,6000,100
1543,2023-03-31,HRUM,1475,1475,1495,1460,1460,-15
1544,2023-03-31,INKP,7650,7650,7675,7500,7500,-150
1545,2023-03-31,INTP,10725,10675,10675,10400,10525,-200
1546,2023-03-31,MAPI,1540,0,1560,1510,1510,-30
1547,2023-03-31,SIDO,840,845,870,845,870,30
1548,2023-03-31,UNTR,28975,29000,29100,28700,29100,125
1549,2023-03-31,UNVR,4260,4270,4360,4260,4350,90
1550,2023-04-03,ACES,478,480,490,480,480,2
1551,2023-04-03,AMRT,2880,2920,2940,2890,2920,40
1552,2023-04-03,ASII,6000,6050,6100,5975,6000,0
1553,2023-04-03,HRUM,1460,1485,1520,1475,1485,25
1554,2023-04-03,INKP,7500,7500,7575,7450,7475,-25
1555,2023-04-03,INTP,10525,10575,10675,10200,10500,-25
1556,2023-04-03,MAPI,1510,0,1540,1450,1450,-60
1557,2023-04-03,SIDO,870,870,875,855,860,-10
1558,2023-04-03,UNTR,29100,29150,29350,28800,28850,-250
1559,2023-04-03,UNVR,4350,4350,4350,4250,4290,-60
1560,2023-04-04,ACES,480,480,486,472,474,-6
1561,2023-04-04,AMRT,2920,2920,2940,2840,2870,-50
1562,2023-04-04,ASII,6000,6025,6050,5950,6025,25
1563,2023-04-04,HRUM,1485,1510,1580,1510,1570,85
1564,2023-04-04,INKP,7475,7500,7525,7350,7450,-25
1565,2023-04-04,INTP,10500,10500,10600,10300,10450,-50
1566,2023-04-04,MAPI,1450,0,1475,1400,1400,-50
1567,2023-04-04,SIDO,860,860,865,840,845,-15
1568,2023-04-04,UNTR,28850,29100,29700,29025,29625,775
1569,2023-04-04,UNVR,4290,4280,4290,4220,4290,0
1570,2023-04-05,ACES,474,474,480,464,464,-10
1571,2023-04-05,AMRT,2870,2880,2890,2770,2800,-70
1572,2023-04-05,ASII,6025,6025,6050,5975,6000,-25
1573,2023-04-05,HRUM,1570,1565,1570,1540,1550,-20
1574,2023-04-05,INKP,7450,7425,7425,7225,7275,-175
1575,2023-04-05,INTP,10450,10500,10525,9725,9725,-725
1576,2023-04-05,MAPI,1400,0,1450,1385,1385,-15
1577,2023-04-05,SIDO,845,845,855,835,835,-10
1578,2023-04-05,UNTR,29625,29475,30125,29325,29800,175
1579,2023-04-05,UNVR,4290,4290,4320,4250,4250,-40
1580,2023-04-06,ACES,464,468,470,450,452,-12
1581,2023-04-06,AMRT,2800,2800,2820,2650,2700,-100
1582,2023-04-06,ASII,6000,6000,6000,5925,5925,-75
1583,2023-04-06,HRUM,1550,1555,1595,1540,1585,35
1584,2023-04-06,INKP,7275,7250,7625,7250,7275,0
1585,2023-04-06,INTP,9725,9825,9975,9750,9900,175
1586,2023-04-06,MAPI,1385,0,1430,1340,1415,30
1587,2023-04-06,SIDO,835,835,845,820,830,-5
1588,2023-04-06,UNTR,29800,30000,30075,29725,29800,0
1589,2023-04-06,UNVR,4250,4250,4290,4230,4250,0
1590,2023-04-10,ACES,452,454,456,440,444,-8
1591,2023-04-10,AMRT,2700,2700,2830,2700,2810,110
1592,2023-04-10,ASII,5925,5950,5975,5875,5975,50
1593,2023-04-10,HRUM,1585,1585,1585,1520,1550,-35
1594,2023-04-10,INKP,7275,7300,7450,7250,7425,150
1595,2023-04-10,INTP,9900,9900,9950,9800,9900,0
1596,2023-04-10,MAPI,1415,0,1440,1360,1365,-50
1597,2023-04-10,SIDO,830,825,825,800,805,-25
1598,2023-04-10,UNTR,29800,30000,30200,29800,30200,400
1599,2023-04-10,UNVR,4250,4250,4290,4230,4290,40
1600,2023-04-11,ACES,444,444,452,442,444,0
1601,2023-04-11,AMRT,2810,2820,2830,2760,2810,0
1602,2023-04-11,ASII,5975,5950,6100,5925,6075,100
1603,2023-04-11,HRUM,1550,1555,1590,1545,1550,0
1604,2023-04-11,INKP,7425,7425,7500,7400,7475,50
1605,2023-04-11,INTP,9900,9900,10325,9825,10325,425
1606,2023-04-11,MAPI,1365,0,1385,1325,1330,-35
1607,2023-04-11,SIDO,805,810,840,810,825,20
1608,2023-04-11,UNTR,30200,30250,30800,30025,30400,200
1609,2023-04-11,UNVR,4290,4290,4290,4200,4200,-90
1610,2023-04-12,ACES,444,448,454,446,452,8
1611,2023-04-12,AMRT,2810,2790,2810,2690,2800,-10
1612,2023-04-12,ASII,6075,6150,6300,6125,6250,175
1613,2023-04-12,HRUM,1550,1555,1575,1555,1565,15
1614,2023-04-12,INKP,7475,7475,7650,7425,7625,150
1615,2023-04-12,INTP,10325,10325,10600,10200,10400,75
1616,2023-04-12,MAPI,1330,0,1405,1330,1370,40
1617,2023-04-12,SIDO,825,830,835,815,815,-10
1618,2023-04-12,UNTR,30400,30600,31700,30200,31250,850
1619,2023-04-12,UNVR,4200,4210,4220,4180,4190,-10
1620,2023-04-13,ACES,452,452,454,444,446,-6
1621,2023-04-13,AMRT,2800,2770,2770,2710,2740,-60
1622,2023-04-13,ASII,6250,6225,6275,6175,6250,0
1623,2023-04-13,HRUM,1565,1585,1585,1535,1575,10
1624,2023-04-13,INKP,7625,7650,7700,7500,7500,-125
1625,2023-04-13,INTP,10400,10400,10425,10200,10200,-200
1626,2023-04-13,MAPI,1370,0,1390,1305,1390,20
1627,2023-04-13,SIDO,815,815,830,810,815,0
1628,2023-04-13,UNTR,31250,31400,31500,31050,31050,-200
1629,2023-04-13,UNVR,4190,4160,4180,4100,4100,-90
1630,2023-04-14,ACES,446,446,450,444,446,0
1631,2023-04-14,AMRT,2740,2740,2760,2730,2750,10
1632,2023-04-14,ASII,6250,6275,6300,6200,6200,-50
1633,2023-04-14,HRUM,1575,1570,1570,1545,1545,-30
1634,2023-04-14,INKP,7500,7525,7575,7450,7475,-25
1635,2023-04-14,INTP,10200,10250,10400,10225,10275,75
1636,2023-04-14,MAPI,1390,0,1455,1390,1430,40
1637,2023-04-14,SIDO,815,815,825,810,810,-5
1638,2023-04-14,UNTR,31050,31000,31150,30225,30225,-825
1639,2023-04-14,UNVR,4100,4120,4220,4120,4150,50
1640,2023-04-17,ACES,446,446,452,432,440,-6
1641,2023-04-17,AMRT,2750,2750,2760,2700,2720,-30
1642,2023-04-17,ASII,6200,6200,6275,6200,6225,25
1643,2023-04-17,HRUM,1545,1545,1550,1500,1500,-45
1644,2023-04-17,INKP,7475,7525,7625,7450,7525,50
1645,2023-04-17,INTP,10275,10225,10375,10150,10325,50
1646,2023-04-17,MAPI,1430,0,1475,1420,1465,35
1647,2023-04-17,SIDO,810,810,820,805,820,10
1648,2023-04-17,UNTR,30225,30300,31125,30300,30500,275
1649,2023-04-17,UNVR,4150,4160,4180,4090,4130,-20
1650,2023-04-18,ACES,440,442,444,438,440,0
1651,2023-04-18,AMRT,2720,2710,2740,2700,2720,0
1652,2023-04-18,ASII,6225,6275,6475,6275,6425,200
1653,2023-04-18,HRUM,1500,1500,1530,1500,1510,10
1654,2023-04-18,INKP,7525,7525,7550,7450,7500,-25
1655,2023-04-18,INTP,10325,10325,10450,10325,10350,25
1656,2023-04-18,MAPI,1465,0,1475,1430,1430,-35
1657,2023-04-18,SIDO,820,815,815,800,800,-20
1658,2023-04-18,UNTR,30500,30650,31250,30650,31075,575
1659,2023-04-18,UNVR,4130,4130,4150,4090,4090,-40
1660,2023-04-26,ACES,440,440,444,438,442,2
1661,2023-04-26,AMRT,2720,2790,2910,2740,2910,190
1662,2023-04-26,ASII,6425,6625,6700,6500,6700,275
1663,2023-04-26,HRUM,1510,1510,1540,1510,1540,30
1664,2023-04-26,INKP,7500,7600,7925,7525,7925,425
1665,2023-04-26,INTP,10350,10250,10450,10000,10450,100
1666,2023-04-26,MAPI,1430,0,1495,1400,1410,-20
1667,2023-04-26,SIDO,800,805,820,800,820,20
1668,2023-04-26,UNTR,31075,31200,31500,31200,31400,325
1669,2023-04-26,UNVR,4090,4090,4100,3960,4100,10
1670,2023-04-27,ACES,442,444,448,440,446,4
1671,2023-04-27,AMRT,2910,2900,2900,2810,2840,-70
1672,2023-04-27,ASII,6700,6675,6725,6625,6700,0
1673,2023-04-27,HRUM,1540,1540,1545,1510,1510,-30
1674,2023-04-27,INKP,7925,7925,7950,7775,7900,-25
1675,2023-04-27,INTP,10450,10350,10650,10350,10500,50
1676,2023-04-27,MAPI,1410,0,1410,1365,1370,-40
1677,2023-04-27,SIDO,820,820,820,800,800,-20
1678,2023-04-27,UNTR,31400,31400,31400,31000,31075,-325
1679,2023-04-27,UNVR,4100,4150,4470,4150,4400,300
1680,2023-04-28,ACES,446,446,454,446,450,4
1681,2023-04-28,AMRT,2840,2850,2900,2820,2900,60
1682,2023-04-28,ASII,6700,6700,6750,6675,6750,50
1683,2023-04-28,HRUM,1510,1520,1530,1510,1510,0
1684,2023-04-28,INKP,7900,7900,7975,7750,7775,-125
1685,2023-04-28,INTP,10500,10550,10850,10300,10850,350
1686,2023-04-28,MAPI,1370,0,1385,1350,1370,0
1687,2023-04-28,SIDO,800,800,800,780,790,-10
1688,2023-04-28,UNTR,31075,28900,28900,28900,28900,-2175
1689,2023-04-28,UNVR,4400,4400,4440,4360,4400,0
1690,2023-05-02,ACES,450,450,452,442,444,-6
1691,2023-05-02,AMRT,2900,2900,2920,2840,2910,10
1692,2023-05-02,ASII,6750,6775,6775,6600,6675,-75
1693,2023-05-02,HRUM,1510,1515,1515,1455,1460,-50
1694,2023-05-02,INKP,7775,7775,7800,7550,7650,-125
1695,2023-05-02,INTP,10850,10500,10500,10100,10100,-750
1696,2023-05-02,MAPI,1370,0,1490,1390,1410,40
1697,2023-05-02,SIDO,790,785,800,780,795,5
1698,2023-05-02,UNTR,28900,26900,26900,26900,26900,-2000
1699,2023-05-02,UNVR,4400,4400,4410,4280,4400,0
1700,2023-05-03,ACES,444,444,456,444,450,6
1701,2023-05-03,AMRT,2910,2910,3000,2860,3000,90
1702,2023-05-03,ASII,6675,6700,6725,6550,6625,-50
1703,2023-05-03,HRUM,1460,1460,1480,1425,1445,-15
1704,2023-05-03,INKP,7650,7450,7450,7125,7150,-500
1705,2023-05-03,INTP,10100,10100,10100,9825,10000,-100
1706,2023-05-03,MAPI,1410,0,1460,1365,1455,45
1707,2023-05-03,SIDO,795,795,810,790,805,10
1708,2023-05-03,UNTR,26900,25025,25025,25025,25025,-1875
1709,2023-05-03,UNVR,4400,4400,4420,4350,4400,0
1710,2023-05-04,ACES,450,450,466,448,464,14
1711,2023-05-04,AMRT,3000,3000,3030,2960,3020,20
1712,2023-05-04,ASII,6625,6600,6625,6550,6600,-25
1713,2023-05-04,HRUM,1445,1440,1470,1425,1470,25
1714,2023-05-04,INKP,7150,7150,7250,7075,7175,25
1715,2023-05-04,INTP,10000,10000,10075,9925,10000,0
1716,2023-05-04,MAPI,1455,0,1485,1435,1460,5
1717,2023-05-04,SIDO,805,805,815,800,810,5
1718,2023-05-04,UNTR,25025,24900,24975,24500,24500,-525
1719,2023-05-04,UNVR,4400,4400,4480,4400,4450,50
1720,2023-05-05,ACES,464,464,478,464,472,8
1721,2023-05-05,AMRT,3020,3010,3020,2940,2970,-50
1722,2023-05-05,ASII,6600,6150,6150,6150,6150,-450
1723,2023-05-05,HRUM,1470,1455,1465,1370,1380,-90
1724,2023-05-05,INKP,7175,7175,7250,7075,7100,-75
1725,2023-05-05,INTP,10000,10000,10000,9850,10000,0
1726,2023-05-05,MAPI,1460,0,1480,1450,1465,5
1727,2023-05-05,SIDO,810,810,815,795,800,-10
1728,2023-05-05,UNTR,24500,24400,24400,23975,24150,-350
1729,2023-05-05,UNVR,4450,4450,4490,4390,4490,40
1730,2023-05-08,ACES,472,476,525,476,510,38
1731,2023-05-08,AMRT,2970,2940,2990,2920,2960,-10
1732,2023-05-08,ASII,6150,6150,6175,6050,6125,-25
1733,2023-05-08,HRUM,1380,1375,1430,1375,1420,40
1734,2023-05-08,INKP,7100,7100,7200,7000,7125,25
1735,2023-05-08,INTP,10000,10025,10250,9950,10175,175
1736,2023-05-08,MAPI,1465,0,1540,1455,1500,35
1737,2023-05-08,SIDO,800,800,810,790,805,5
1738,2023-05-08,UNTR,24150,24175,25200,24100,25000,850
1739,2023-05-08,UNVR,4490,4480,4490,4430,4470,-20
1740,2023-05-09,ACES,510,520,560,515,555,45
1741,2023-05-09,AMRT,2960,2960,2960,2930,2950,-10
1742,2023-05-09,ASII,6125,6125,6325,6075,6325,200
1743,2023-05-09,HRUM,1420,1425,1440,1415,1430,10
1744,2023-05-09,INKP,7125,7150,7325,7150,7250,125
1745,2023-05-09,INTP,10175,10175,10450,10125,10350,175
1746,2023-05-09,MAPI,1500,0,1630,1500,1595,95
1747,2023-05-09,SIDO,805,805,805,795,800,-5
1748,2023-05-09,UNTR,25000,25025,25400,25025,25275,275
1749,2023-05-09,UNVR,4470,4470,4470,4360,4390,-80
1750,2023-05-10,ACES,555,560,560,535,550,-5
1751,2023-05-10,AMRT,2950,2940,2970,2880,2920,-30
1752,2023-05-10,ASII,6325,6350,6425,6300,6325,0
1753,2023-05-10,HRUM,1430,1430,1445,1410,1410,-20
1754,2023-05-10,INKP,7250,7300,7375,7275,7375,125
1755,2023-05-10,INTP,10350,10325,10400,10200,10200,-150
1756,2023-05-10,MAPI,1595,0,1635,1565,1575,-20
1757,2023-05-10,SIDO,800,800,805,770,775,-25
1758,2023-05-10,UNTR,25275,25350,25500,25250,25275,0
1759,2023-05-10,UNVR,4390,4420,4500,4400,4500,110
1760,2023-05-11,ACES,550,550,550,525,540,-10
1761,2023-05-11,AMRT,2920,2940,2940,2860,2880,-40
1762,2023-05-11,ASII,6325,6350,6350,6175,6250,-75
1763,2023-05-11,HRUM,1410,1410,1415,1375,1375,-35
1764,2023-05-11,INKP,7375,7375,7375,7175,7200,-175
1765,2023-05-11,INTP,10200,10200,10300,10075,10225,25
1766,2023-05-11,MAPI,1575,0,1700,1550,1670,95
1767,2023-05-11,SIDO,775,775,775,755,775,0
1768,2023-05-11,UNTR,25275,25175,25175,24675,24825,-450
1769,2023-05-11,UNVR,4500,4500,4500,4370,4430,-70
1770,2023-05-12,ACES,540,540,550,530,535,-5
1771,2023-05-12,AMRT,2880,2890,3000,2890,2940,60
1772,2023-05-12,ASII,6250,6225,6275,6175,6225,-25
1773,2023-05-12,HRUM,1375,1375,1375,1345,1350,-25
1774,2023-05-12,INKP,7200,7225,7300,7200,7250,50
1775,2023-05-12,INTP,10225,10225,10400,10100,10200,-25
1776,2023-05-12,MAPI,1670,0,1710,1665,1665,-5
1777,2023-05-12,SIDO,775,775,785,765,775,0
1778,2023-05-12,UNTR,24825,24775,25225,24675,24800,-25
1779,2023-05-12,UNVR,4430,4430,4430,4370,4400,-30
1780,2023-05-15,ACES,535,535,565,535,565,30
1781,2023-05-15,AMRT,2940,2990,3030,2930,2940,0
1782,2023-05-15,ASII,6225,6275,6350,6175,6350,125
1783,2023-05-15,HRUM,1350,1355,1365,1290,1295,-55
1784,2023-05-15,INKP,7250,7250,7325,7175,7250,0
1785,2023-05-15,INTP,10200,10200,10200,10100,10200,0
1786,2023-05-15,MAPI,1665,0,1730,1660,1730,65
1787,2023-05-15,SIDO,775,775,785,765,775,0
1788,2023-05-15,UNTR,24800,24800,25000,24450,24500,-300
1789,2023-05-15,UNVR,4400,4450,4530,4400,4500,100
1790,2023-05-16,ACES,565,570,575,545,570,5
1791,2023-05-16,AMRT,2940,2950,2970,2910,2940,0
1792,2023-05-16,ASII,6350,6350,6400,6250,6275,-75
1793,2023-05-16,HRUM,1295,1300,1305,1230,1250,-45
1794,2023-05-16,INKP,7250,7250,7375,7250,7350,100
1795,2023-05-16,INTP,10200,10200,10300,10150,10275,75
1796,2023-05-16,MAPI,1730,0,1740,1675,1700,-30
1797,2023-05-16,SIDO,775,775,780,765,770,-5
1798,2023-05-16,UNTR,24500,24500,24675,24450,24450,-50
1799,2023-05-16,UNVR,4500,4500,4510,4460,4510,10
1800,2023-05-17,ACES,570,570,600,560,595,25
1801,2023-05-17,AMRT,2940,2950,2970,2920,2930,-10
1802,2023-05-17,ASII,6275,6350,6350,6275,6325,50
1803,2023-05-17,HRUM,1250,1245,1290,1235,1280,30
1804,2023-05-17,INKP,7350,7375,7450,7250,7250,-100
1805,2023-05-17,INTP,10275,10325,10500,10250,10375,100
1806,2023-05-17,MAPI,1700,0,1775,1695,1705,5
1807,2023-05-17,SIDO,770,770,775,765,770,0
1808,2023-05-17,UNTR,24450,24425,24700,24025,24025,-425
1809,2023-05-17,UNVR,4510,4500,4510,4420,4460,-50
1810,2023-05-19,ACES,595,595,615,575,585,-10
1811,2023-05-19,AMRT,2930,2930,2950,2880,2900,-30
1812,2023-05-19,ASII,6325,6400,6550,6350,6475,150
1813,2023-05-19,HRUM,1280,1295,1295,1215,1260,-20
1814,2023-05-19,INKP,7250,7250,7325,7175,7225,-25
1815,2023-05-19,INTP,10375,10250,10325,10000,10200,-175
1816,2023-05-19,MAPI,1705,0,1735,1670,1675,-30
1817,2023-05-19,SIDO,770,770,770,760,765,-5
1818,2023-05-19,UNTR,24025,24025,24525,23300,23300,-725
1819,2023-05-19,UNVR,4460,4460,4500,4430,4430,-30
1820,2023-05-22,ACES,585,585,635,580,630,45
1821,2023-05-22,AMRT,2900,2900,2940,2820,2880,-20
1822,2023-05-22,ASII,6475,6525,6650,6425,6600,125
1823,2023-05-22,HRUM,1260,1260,1285,1255,1285,25
1824,2023-05-22,INKP,7225,7175,7475,7175,7450,225
1825,2023-05-22,INTP,10200,10200,10425,10150,10300,100
1826,2023-05-22,MAPI,1675,0,1705,1625,1655,-20
1827,2023-05-22,SIDO,765,765,780,760,760,-5
1828,2023-05-22,UNTR,23300,23525,24275,23525,23875,575
1829,2023-05-22,UNVR,4430,4430,4480,4390,4420,-10
1830,2023-05-23,ACES,630,630,645,595,605,-25
1831,2023-05-23,AMRT,2880,2880,2920,2830,2860,-20
1832,2023-05-23,ASII,6600,6600,6650,6550,6600,0
1833,2023-05-23,HRUM,1285,1285,1310,1270,1300,15
1834,2023-05-23,INKP,7450,7450,7750,7375,7525,75
1835,2023-05-23,INTP,10300,10275,10275,9925,9975,-325
1836,2023-05-23,MAPI,1655,0,1790,1655,1770,115
1837,2023-05-23,SIDO,760,765,775,760,770,10
1838,2023-05-23,UNTR,23875,24050,24800,24050,24500,625
1839,2023-05-23,UNVR,4420,4420,4480,4420,4450,30
1840,2023-05-24,ACES,605,605,625,600,615,10
1841,2023-05-24,AMRT,2860,2860,2870,2780,2810,-50
1842,2023-05-24,ASII,6600,6575,6675,6500,6675,75
1843,2023-05-24,HRUM,1300,1300,1305,1285,1285,-15
1844,2023-05-24,INKP,7525,7550,7600,7425,7425,-100
1845,2023-05-24,INTP,9975,9975,10075,9900,10050,75
1846,2023-05-24,MAPI,1770,0,1790,1705,1760,-10
1847,2023-05-24,SIDO,770,775,780,770,780,10
1848,2023-05-24,UNTR,24500,24500,24675,24300,24600,100
1849,2023-05-24,UNVR,4450,4450,4450,4390,4410,-40
1850,2023-05-25,ACES,615,620,635,615,635,20
1851,2023-05-25,AMRT,2810,2810,2810,2720,2720,-90
1852,2023-05-25,ASII,6675,6700,6700,6525,6600,-75
1853,2023-05-25,HRUM,1285,1280,1285,1250,1280,-5
1854,2023-05-25,INKP,7425,7425,7450,7250,7250,-175
1855,2023-05-25,INTP,10050,10050,10200,10000,10075,25
1856,2023-05-25,MAPI,1760,0,1865,1750,1830,70
1857,2023-05-25,SIDO,780,780,780,770,775,-5
1858,2023-05-25,UNTR,24600,24500,24500,23500,23500,-1100
1859,2023-05-25,UNVR,4410,4410,4450,4370,4410,0
1860,2023-05-26,ACES,635,640,655,635,655,20
1861,2023-05-26,AMRT,2720,2720,2760,2710,2740,20
1862,2023-05-26,ASII,6600,6600,6600,6525,6600,0
1863,2023-05-26,HRUM,1280,1280,1295,1260,1260,-20
1864,2023-05-26,INKP,7250,7200,7325,7200,7275,25
1865,2023-05-26,INTP,10075,10075,10175,10050,10050,-25
1866,2023-05-26,MAPI,1830,0,1830,1790,1830,0
1867,2023-05-26,SIDO,775,775,780,760,765,-10
1868,2023-05-26,UNTR,23500,23475,23525,23000,23075,-425
1869,2023-05-26,UNVR,4410,4410,4430,4380,4380,-30
1870,2023-05-29,ACES,655,660,660,615,630,-25
1871,2023-05-29,AMRT,2740,2740,2760,2680,2740,0
1872,2023-05-29,ASII,6600,6625,6625,6475,6600,0
1873,2023-05-29,HRUM,1260,1265,1315,1205,1305,45
1874,2023-05-29,INKP,7275,7300,7400,7250,7325,50
1875,2023-05-29,INTP,10050,9950,10200,9925,10200,150
1876,2023-05-29,MAPI,1830,0,1830,1770,1825,-5
1877,2023-05-29,SIDO,765,765,770,755,765,0
1878,2023-05-29,UNTR,23075,23100,23400,22625,22875,-200
1879,2023-05-29,UNVR,4380,4400,4550,4380,4550,170
1880,2023-05-30,ACES,630,635,635,615,620,-10
1881,2023-05-30,AMRT,2740,2710,2730,2660,2670,-70
1882,2023-05-30,ASII,6600,6575,6600,6500,6500,-100
1883,2023-05-30,HRUM,1305,1315,1365,1315,1360,55
1884,2023-05-30,INKP,7325,7275,7325,7225,7275,-50
1885,2023-05-30,INTP,10200,10175,10300,10075,10250,50
1886,2023-05-30,MAPI,1825,0,1845,1805,1805,-20
1887,2023-05-30,SIDO,765,765,770,760,760,-5
1888,2023-05-30,UNTR,22875,22800,23000,22500,22500,-375
1889,2023-05-30,UNVR,4550,4550,4600,4510,4540,-10
1890,2023-05-31,ACES,620,625,640,600,630,10
1891,2023-05-31,AMRT,2670,2680,2700,2640,2640,-30
1892,2023-05-31,ASII,6500,6500,6600,6450,6450,-50
1893,2023-05-31,HRUM,1360,1365,1410,1340,1410,50
1894,2023-05-31,INKP,7275,7250,7275,6900,6900,-375
1895,2023-05-31,INTP,10250,10175,10200,9900,9900,-350
1896,2023-05-31,MAPI,1805,0,1855,1755,1775,-30
1897,2023-05-31,SIDO,760,760,765,725,725,-35
1898,2023-05-31,UNTR,22500,22325,22800,22200,22225,-275
1899,2023-05-31,UNVR,4540,4540,4580,4500,4530,-10
1900,2023-06-05,ACES,630,630,635,610,630,0
1901,2023-06-05,AMRT,2640,2680,2810,2680,2720,80
1902,2023-06-05,ASII,6450,6525,7000,6500,6825,375
1903,2023-06-05,HRUM,1410,1420,1440,1375,1440,30
1904,2023-06-05,INKP,6900,7000,7125,6950,7025,125
1905,2023-06-05,INTP,9900,9950,9975,9825,9900,0
1906,2023-06-05,MAPI,1775,0,1790,1730,1770,-5
1907,2023-06-05,SIDO,725,725,740,710,720,-5
1908,2023-06-05,UNTR,22225,22525,23475,22525,22850,625
1909,2023-06-05,UNVR,4530,4530,4550,4460,4500,-30
1910,2023-06-06,ACES,630,630,645,620,645,15
1911,2023-06-06,AMRT,2720,2750,2760,2680,2680,-40
1912,2023-06-06,ASII,6825,6800,6925,6750,6800,-25
1913,2023-06-06,HRUM,1440,1445,1460,1425,1425,-15
1914,2023-06-06,INKP,7025,7025,7025,6950,7000,-25
1915,2023-06-06,INTP,9900,9850,9900,9775,9775,-125
1916,2023-06-06,MAPI,1770,0,1815,1750,1800,30
1917,2023-06-06,SIDO,720,720,755,720,750,30
1918,2023-06-06,UNTR,22850,23225,23350,22875,23200,350
1919,2023-06-06,UNVR,4500,4500,4510,4440,4460,-40
1920,2023-06-07,ACES,645,645,705,640,700,55
1921,2023-06-07,AMRT,2680,2690,2750,2660,2680,0
1922,2023-06-07,ASII,6800,6800,6850,6675,6800,0
1923,2023-06-07,HRUM,1425,1420,1425,1375,1385,-40
1924,2023-06-07,INKP,7000,7050,7100,7000,7100,100
1925,2023-06-07,INTP,9775,9775,9850,9600,9700,-75
1926,2023-06-07,MAPI,1800,0,1925,1785,1880,80
1927,2023-06-07,SIDO,750,755,755,730,735,-15
1928,2023-06-07,UNTR,23200,23050,23125,22775,22850,-350
1929,2023-06-07,UNVR,4460,4470,4570,4460,4570,110
1930,2023-06-08,ACES,700,700,710,665,680,-20
1931,2023-06-08,AMRT,2680,2660,2750,2660,2740,60
1932,2023-06-08,ASII,6800,6725,6775,6700,6775,-25
1933,2023-06-08,HRUM,1385,1400,1495,1400,1480,95
1934,2023-06-08,INKP,7100,7125,7350,7050,7325,225
1935,2023-06-08,INTP,9700,9700,9725,9550,9575,-125
1936,2023-06-08,MAPI,1880,0,1900,1850,1875,-5
1937,2023-06-08,SIDO,735,740,755,740,755,20
1938,2023-06-08,UNTR,22850,23150,23325,23000,23325,475
1939,2023-06-08,UNVR,4570,4570,4630,4540,4600,30
1940,2023-06-09,ACES,680,680,695,670,685,5
1941,2023-06-09,AMRT,2740,2740,2750,2680,2700,-40
1942,2023-06-09,ASII,6775,6750,6800,6700,6800,25
1943,2023-06-09,HRUM,1480,1500,1500,1440,1455,-25
1944,2023-06-09,INKP,7325,7325,7475,7275,7400,75
1945,2023-06-09,INTP,9575,9600,9675,9450,9625,50
1946,2023-06-09,MAPI,1875,0,1940,1850,1900,25
1947,2023-06-09,SIDO,755,755,765,740,765,10
1948,2023-06-09,UNTR,23325,23700,23775,22825,23075,-250
1949,2023-06-09,UNVR,4600,4580,4600,4540,4550,-50
1950,2023-06-12,ACES,685,685,705,675,680,-5
1951,2023-06-12,AMRT,2700,2720,2780,2700,2730,30
1952,2023-06-12,ASII,6800,6800,6800,6675,6775,-25
1953,2023-06-12,HRUM,1455,1450,1485,1425,1485,30
1954,2023-06-12,INKP,7400,7400,7500,7350,7400,0
1955,2023-06-12,INTP,9625,9625,9825,9625,9800,175
1956,2023-06-12,MAPI,1900,0,1925,1860,1885,-15
1957,2023-06-12,SIDO,765,765,770,745,765,0
1958,2023-06-12,UNTR,23075,23100,23525,23075,23525,450
1959,2023-06-12,UNVR,4550,4590,4610,4560,4610,60
1960,2023-06-13,ACES,680,680,685,630,645,-35
1961,2023-06-13,AMRT,2730,2760,2760,2700,2740,10
1962,2023-06-13,ASII,6775,6775,6825,6750,6750,-25
1963,2023-06-13,HRUM,1485,1475,1510,1450,1505,20
1964,2023-06-13,INKP,7400,7375,7425,7275,7325,-75
1965,2023-06-13,INTP,9800,9825,9900,9800,9800,0
1966,2023-06-13,MAPI,1885,0,1885,1820,1850,-35
1967,2023-06-13,SIDO,765,765,765,750,760,-5
1968,2023-06-13,UNTR,23525,23600,23600,22925,22975,-550
1969,2023-06-13,UNVR,4610,4610,4630,4480,4510,-100
1970,2023-06-14,ACES,645,645,685,635,685,40
1971,2023-06-14,AMRT,2740,2740,2750,2670,2700,-40
1972,2023-06-14,ASII,6750,6750,6900,6750,6900,150
1973,2023-06-14,HRUM,1505,1520,1525,1455,1470,-35
1974,2023-06-14,INKP,7325,7325,7850,7325,7775,450
1975,2023-06-14,INTP,9800,9800,9875,9725,9775,-25
1976,2023-06-14,MAPI,1850,0,1850,1800,1805,-45
1977,2023-06-14,SIDO,760,755,760,750,760,0
1978,2023-06-14,UNTR,22975,23100,23225,22975,22975,0
1979,2023-06-14,UNVR,4510,4500,4510,4410,4440,-70
1980,2023-06-15,ACES,685,690,700,660,660,-25
1981,2023-06-15,AMRT,2700,2700,2700,2640,2650,-50
1982,2023-06-15,ASII,6900,6900,6900,6825,6875,-25
1983,2023-06-15,HRUM,1470,1470,1485,1450,1460,-10
1984,2023-06-15,INKP,7775,7775,8100,7700,7850,75
1985,2023-06-15,INTP,9775,9825,9925,9775,9925,150
1986,2023-06-15,MAPI,1805,0,1855,1810,1815,10
1987,2023-06-15,SIDO,760,760,760,745,745,-15
1988,2023-06-15,UNTR,22975,23150,23225,22925,23150,175
1989,2023-06-15,UNVR,4440,4440,4520,4410,4520,80
1990,2023-06-16,ACES,660,665,670,645,650,-10
1991,2023-06-16,AMRT,2650,2650,2650,2530,2580,-70
1992,2023-06-16,ASII,6875,6850,6875,6775,6850,-25
1993,2023-06-16,HRUM,1460,1465,1480,1440,1460,0
1994,2023-06-16,INKP,7850,7900,8100,7775,7950,100
1995,2023-06-16,INTP,9925,9900,9900,9750,9750,-175
1996,2023-06-16,MAPI,1815,0,1830,1765,1800,-15
1997,2023-06-16,SIDO,745,745,750,725,735,-10
1998,2023-06-16,UNTR,23150,23325,23550,22900,22900,-250
1999,2023-06-16,UNVR,4520,4500,4500,4390,4390,-130
2000,2023-06-19,ACES,650,650,660,630,635,-15
2001,2023-06-19,AMRT,2580,2580,2630,2580,2600,20
2002,2023-06-19,ASII,6850,6800,6875,6775,6875,25
2003,2023-06-19,HRUM,1460,1460,1460,1400,1430,-30
2004,2023-06-19,INKP,7950,8000,8225,8000,8175,225
2005,2023-06-19,INTP,9750,9825,9900,9775,9875,125
2006,2023-06-19,MAPI,1800,0,1805,1750,1750,-50
2007,2023-06-19,SIDO,735,735,740,720,730,-5
2008,2023-06-19,UNTR,22900,22950,23150,22725,23150,250
2009,2023-06-19,UNVR,4390,4390,4420,4320,4380,-10
2010,2023-06-20,ACES,635,635,645,605,605,-30
2011,2023-06-20,AMRT,2600,2610,2610,2550,2580,-20
2012,2023-06-20,ASII,6875,6825,6850,6775,6800,-75
2013,2023-06-20,HRUM,1430,1430,1445,1395,1410,-20
2014,2023-06-20,INKP,8175,8175,8200,7950,8000,-175
2015,2023-06-20,INTP,9875,9875,9875,9750,9775,-100
2016,2023-06-20,MAPI,1750,0,1750,1655,1695,-55
2017,2023-06-20,SIDO,730,730,740,725,730,0
2018,2023-06-20,UNTR,23150,23200,23225,22950,23125,-25
2019,2023-06-20,UNVR,4380,4380,4390,4300,4300,-80
2020,2023-06-21,ACES,605,610,700,610,690,85
2021,2023-06-21,AMRT,2580,2560,2610,2550,2590,10
2022,2023-06-21,ASII,6800,6775,6975,6750,6925,125
2023,2023-06-21,HRUM,1410,1415,1435,1400,1400,-10
2024,2023-06-21,INKP,8000,8050,8150,7950,8000,0
2025,2023-06-21,INTP,9775,9775,9800,9625,9800,25
2026,2023-06-21,MAPI,1695,0,1745,1680,1740,45
2027,2023-06-21,SIDO,730,730,740,720,720,-10
2028,2023-06-21,UNTR,23125,23175,23375,23000,23350,225
2029,2023-06-21,UNVR,4300,4300,4370,4300,4360,60
2030,2023-06-22,ACES,690,690,690,660,670,-20
2031,2023-06-22,AMRT,2590,2590,2630,2590,2590,0
2032,2023-06-22,ASII,6925,6875,6900,6775,6775,-150
2033,2023-06-22,HRUM,1400,1400,1455,1400,1435,35
2034,2023-06-22,INKP,8000,8000,8100,7925,7925,-75
2035,2023-06-22,INTP,9800,9775,9850,9750,9775,-25
2036,2023-06-22,MAPI,1740,0,1765,1685,1685,-55
2037,2023-06-22,SIDO,720,725,735,720,725,5
2038,2023-06-22,UNTR,23350,23500,23775,23350,23525,175
2039,2023-06-22,UNVR,4360,4370,4370,4250,4250,-110
2040,2023-06-23,ACES,670,670,680,660,670,0
2041,2023-06-23,AMRT,2590,2600,2620,2560,2610,20
2042,2023-06-23,ASII,6775,6775,6825,6700,6775,0
2043,2023-06-23,HRUM,1435,1445,1465,1440,1445,10
2044,2023-06-23,INKP,7925,7900,8350,7900,8275,350
2045,2023-06-23,INTP,9775,9750,9950,9750,9800,25
2046,2023-06-23,MAPI,1685,0,1715,1675,1705,20
2047,2023-06-23,SIDO,725,725,740,725,735,10
2048,2023-06-23,UNTR,23525,23525,23675,23150,23375,-150
2049,2023-06-23,UNVR,4250,4250,4290,4210,4270,20
2050,2023-06-26,ACES,670,670,690,670,680,10
2051,2023-06-26,AMRT,2610,2610,2630,2570,2600,-10
2052,2023-06-26,ASII,6775,6800,6900,6775,6800,25
2053,2023-06-26,HRUM,1445,1450,1450,1410,1415,-30
2054,2023-06-26,INKP,8275,8350,8625,8225,8500,225
2055,2023-06-26,INTP,9800,9850,9875,9750,9750,-50
2056,2023-06-26,MAPI,1705,0,1730,1690,1690,-15
2057,2023-06-26,SIDO,735,735,740,725,730,-5
2058,2023-06-26,UNTR,23375,23400,23425,23075,23275,-100
2059,2023-06-26,UNVR,4270,4270,4270,4230,4230,-40
2060,2023-06-27,ACES,680,680,685,670,675,-5
2061,2023-06-27,AMRT,2600,2600,2620,2550,2580,-20
2062,2023-06-27,ASII,6800,6800,6850,6775,6775,-25
2063,2023-06-27,HRUM,1415,1415,1430,1410,1420,5
2064,2023-06-27,INKP,8500,8600,8775,8450,8500,0
2065,2023-06-27,INTP,9750,9800,9925,9725,9925,175
2066,2023-06-27,MAPI,1690,0,1700,1640,1690,0
2067,2023-06-27,SIDO,730,730,745,730,730,0
2068,2023-06-27,UNTR,23275,23275,23325,23125,23275,0
2069,2023-06-27,UNVR,4230,4230,4280,4230,4260,30
2070,2023-07-03,ACES,675,675,690,670,670,-5
2071,2023-07-03,AMRT,2580,2600,2630,2550,2590,10
2072,2023-07-03,ASII,6775,6775,6825,6750,6825,50
2073,2023-07-03,HRUM,1420,1425,1505,1425,1495,75
2074,2023-07-03,INKP,8500,8475,8625,8375,8400,-100
2075,2023-07-03,INTP,9925,9925,9925,9650,9675,-250
2076,2023-07-03,MAPI,1690,0,1705,1660,1675,-15
2077,2023-07-03,SIDO,730,730,740,720,725,-5
2078,2023-07-03,UNTR,23275,23325,23375,22825,23050,-225
2079,2023-07-03,UNVR,4260,4250,4310,4210,4310,50
2080,2023-07-04,ACES,670,670,685,640,655,-15
2081,2023-07-04,AMRT,2590,2590,2650,2570,2600,10
2082,2023-07-04,ASII,6825,6825,6825,6700,6775,-50
2083,2023-07-04,HRUM,1495,1500,1580,1500,1580,85
2084,2023-07-04,INKP,8400,8400,8550,8375,8475,75
2085,2023-07-04,INTP,9675,9700,9700,9550,9600,-75
2086,2023-07-04,MAPI,1675,0,1740,1675,1715,40
2087,2023-07-04,SIDO,725,725,730,720,725,0
2088,2023-07-04,UNTR,23050,23150,23250,23050,23100,50
2089,2023-07-04,UNVR,4310,4320,4340,4300,4330,20
2090,2023-07-05,ACES,655,635,650,625,640,-15
2091,2023-07-05,AMRT,2600,2600,2620,2580,2620,20
2092,2023-07-05,ASII,6775,6775,6775,6700,6775,0
2093,2023-07-05,HRUM,1580,1590,1635,1580,1590,10
2094,2023-07-05,INKP,8475,8475,8750,8400,8725,250
2095,2023-07-05,INTP,9600,9600,9775,9550,9725,125
2096,2023-07-05,MAPI,1715,0,1720,1680,1700,-15
2097,2023-07-05,SIDO,725,725,730,720,720,-5
2098,2023-07-05,UNTR,23100,23200,23775,23150,23700,600
2099,2023-07-05,UNVR,4330,4330,4330,4280,4310,-20
2100,2023-07-06,ACES,640,645,665,635,655,15
2101,2023-07-06,AMRT,2620,2630,2750,2590,2740,120
2102,2023-07-06,ASII,6775,6775,6800,6750,6800,25
2103,2023-07-06,HRUM,1590,1600,1645,1600,1620,30
2104,2023-07-06,INKP,8725,8725,8850,8625,8775,50
2105,2023-07-06,INTP,9725,9750,9950,9750,9900,175
2106,2023-07-06,MAPI,1700,0,1815,1695,1810,110
2107,2023-07-06,SIDO,720,725,735,720,730,10
2108,2023-07-06,UNTR,23700,23950,24075,23825,24050,350
2109,2023-07-06,UNVR,4310,4260,4290,4220,4250,-60
2110,2023-07-07,ACES,655,655,745,640,720,65
2111,2023-07-07,AMRT,2740,2740,2740,2680,2680,-60
2112,2023-07-07,ASII,6800,6775,6825,6750,6825,25
2113,2023-07-07,HRUM,1620,1610,1610,1575,1585,-35
2114,2023-07-07,INKP,8775,8700,8950,8650,8850,75
2115,2023-07-07,INTP,9900,9900,10175,9875,10125,225
2116,2023-07-07,MAPI,1810,0,1825,1740,1760,-50
2117,2023-07-07,SIDO,730,730,735,725,730,0
2118,2023-07-07,UNTR,24050,23900,24000,23600,23750,-300
2119,2023-07-07,UNVR,4250,4230,4240,4210,4240,-10
2120,2023-07-10,ACES,720,725,735,705,710,-10
2121,2023-07-10,AMRT,2680,2680,2730,2680,2710,30
2122,2023-07-10,ASII,6825,6825,6825,6775,6775,-50
2123,2023-07-10,HRUM,1585,1585,1635,1585,1605,20
2124,2023-07-10,INKP,8850,8850,9000,8725,8975,125
2125,2023-07-10,INTP,10125,10125,10225,10050,10100,-25
2126,2023-07-10,MAPI,1760,0,1780,1745,1750,-10
2127,2023-07-10,SIDO,730,730,735,730,730,0
2128,2023-07-10,UNTR,23750,23900,24150,23875,24100,350
2129,2023-07-10,UNVR,4240,4240,4320,4240,4250,10
2130,2023-07-11,ACES,710,710,725,705,710,0
2131,2023-07-11,AMRT,2710,2710,2780,2700,2770,60
2132,2023-07-11,ASII,6775,6775,6800,6750,6800,25
2133,2023-07-11,HRUM,1605,1615,1620,1585,1610,5
2134,2023-07-11,INKP,8975,8975,9475,8975,9475,500
2135,2023-07-11,INTP,10100,10125,10275,10050,10275,175
2136,2023-07-11,MAPI,1750,0,1805,1710,1805,55
2137,2023-07-11,SIDO,730,735,755,730,745,15
2138,2023-07-11,UNTR,24100,24100,24475,24075,24475,375
2139,2023-07-11,UNVR,4250,4260,4280,4240,4250,0
2140,2023-07-12,ACES,710,715,735,715,725,15
2141,2023-07-12,AMRT,2770,2770,2800,2720,2780,10
2142,2023-07-12,ASII,6800,6775,6825,6750,6775,-25
2143,2023-07-12,HRUM,1610,1610,1610,1580,1595,-15
2144,2023-07-12,INKP,9475,9475,9650,9250,9400,-75
2145,2023-07-12,INTP,10275,10275,10350,10150,10150,-125
2146,2023-07-12,MAPI,1805,0,1900,1785,1860,55
2147,2023-07-12,SIDO,745,745,755,740,745,0
2148,2023-07-12,UNTR,24475,24475,24475,24000,24000,-475
2149,2023-07-12,UNVR,4250,4250,4260,4200,4210,-40
2150,2023-07-13,ACES,725,730,730,700,715,-10
2151,2023-07-13,AMRT,2780,2780,2810,2730,2780,0
2152,2023-07-13,ASII,6775,6775,6825,6750,6800,25
2153,2023-07-13,HRUM,1595,1595,1610,1515,1525,-70
2154,2023-07-13,INKP,9400,9300,9450,9000,9150,-250
2155,2023-07-13,INTP,10150,10150,10325,10150,10250,100
2156,2023-07-13,MAPI,1860,0,1880,1780,1785,-75
2157,2023-07-13,SIDO,745,745,750,720,725,-20
2158,2023-07-13,UNTR,24000,24000,24225,23975,24150,150
2159,2023-07-13,UNVR,4210,4220,4250,4210,4250,40
2160,2023-07-14,ACES,715,715,730,710,720,5
2161,2023-07-14,AMRT,2780,2780,2790,2730,2770,-10
2162,2023-07-14,ASII,6800,6775,6825,6700,6750,-50
2163,2023-07-14,HRUM,1525,1530,1555,1515,1525,0
2164,2023-07-14,INKP,9150,9150,9200,8875,8950,-200
2165,2023-07-14,INTP,10250,10375,10450,10250,10350,100
2166,2023-07-14,MAPI,1785,0,1820,1785,1800,15
2167,2023-07-14,SIDO,725,725,730,715,720,-5
2168,2023-07-14,UNTR,24150,24200,24275,24050,24150,0
2169,2023-07-14,UNVR,4250,4250,4290,4230,4250,0
2170,2023-07-17,ACES,720,720,765,720,755,35
2171,2023-07-17,AMRT,2770,2770,2800,2760,2770,0
2172,2023-07-17,ASII,6750,6750,6775,6675,6675,-75
2173,2023-07-17,HRUM,1525,1530,1555,1525,1530,5
2174,2023-07-17,INKP,8950,8975,9100,8700,8800,-150
2175,2023-07-17,INTP,10350,10350,10450,10225,10275,-75
2176,2023-07-17,MAPI,1800,0,1855,1800,1835,35
2177,2023-07-17,SIDO,720,725,735,720,720,0
2178,2023-07-17,UNTR,24150,24300,24400,24200,24225,75
2179,2023-07-17,UNVR,4250,4260,4290,4250,4270,20
2180,2023-07-18,ACES,755,760,780,735,750,-5
2181,2023-07-18,AMRT,2770,2770,2770,2730,2750,-20
2182,2023-07-18,ASII,6675,6675,6700,6475,6575,-100
2183,2023-07-18,HRUM,1530,1530,1530,1485,1490,-40
2184,2023-07-18,INKP,8800,8800,8975,8675,8725,-75
2185,2023-07-18,INTP,10275,10275,10325,10100,10275,0
2186,2023-07-18,MAPI,1835,0,1930,1835,1900,65
2187,2023-07-18,SIDO,720,725,730,710,715,-5
2188,2023-07-18,UNTR,24225,24250,24450,24050,24250,25
2189,2023-07-18,UNVR,4270,4270,4300,4230,4270,0
2190,2023-07-20,ACES,750,750,795,695,695,-55
2191,2023-07-20,AMRT,2750,2770,2820,2750,2800,50
2192,2023-07-20,ASII,6575,6575,6575,6450,6525,-50
2193,2023-07-20,HRUM,1490,1500,1540,1500,1540,50
2194,2023-07-20,INKP,8725,8800,9075,8750,8925,200
2195,2023-07-20,INTP,10275,10300,10300,10075,10175,-100
2196,2023-07-20,MAPI,1900,0,1995,1895,1985,85
2197,2023-07-20,SIDO,715,715,720,685,690,-25
2198,2023-07-20,UNTR,24250,24575,24575,24225,24375,125
2199,2023-07-20,UNVR,4270,4260,4270,4210,4220,-50
2200,2023-07-21,ACES,695,695,715,690,705,10
2201,2023-07-21,AMRT,2800,2810,2880,2800,2870,70
2202,2023-07-21,ASII,6525,6500,6525,6375,6450,-75
2203,2023-07-21,HRUM,1540,1550,1565,1540,1545,5
2204,2023-07-21,INKP,8925,8925,9000,8725,9000,75
2205,2023-07-21,INTP,10175,10200,10375,10050,10350,175
2206,2023-07-21,MAPI,1985,0,2050,1925,1930,-55
2207,2023-07-21,SIDO,690,690,700,690,700,10
2208,2023-07-21,UNTR,24375,24400,24500,24275,24500,125
2209,2023-07-21,UNVR,4220,4220,4290,4220,4290,70
2210,2023-07-24,ACES,705,710,745,710,735,30
2211,2023-07-24,AMRT,2870,2870,2890,2810,2840,-30
2212,2023-07-24,ASII,6450,6400,6600,6400,6550,100
2213,2023-07-24,HRUM,1545,1545,1565,1540,1555,10
2214,2023-07-24,INKP,9000,9050,9100,8950,8950,-50
2215,2023-07-24,INTP,10350,10375,10425,10250,10350,0
2216,2023-07-24,MAPI,1930,0,1965,1850,1915,-15
2217,2023-07-24,SIDO,700,700,700,695,700,0
2218,2023-07-24,UNTR,24500,24525,25600,24525,25400,900
2219,2023-07-24,UNVR,4290,4290,4340,4270,4290,0
2220,2023-07-25,ACES,735,745,780,730,750,15
2221,2023-07-25,AMRT,2840,2840,2890,2810,2810,-30
2222,2023-07-25,ASII,6550,6600,6625,6500,6500,-50
2223,2023-07-25,HRUM,1555,1565,1575,1540,1555,0
2224,2023-07-25,INKP,8950,8950,9000,8900,8950,0
2225,2023-07-25,INTP,10350,10300,10550,10275,10450,100
2226,2023-07-25,MAPI,1915,0,1940,1890,1910,-5
2227,2023-07-25,SIDO,700,700,700,690,695,-5
2228,2023-07-25,UNTR,25400,25500,25800,25400,25400,0
2229,2023-07-25,UNVR,4290,4190,4190,4020,4050,-240
2230,2023-07-26,ACES,750,755,765,735,740,-10
2231,2023-07-26,AMRT,2810,2810,2830,2760,2830,20
2232,2023-07-26,ASII,6500,6575,6625,6500,6600,100
2233,2023-07-26,HRUM,1555,1575,1710,1575,1705,150
2234,2023-07-26,INKP,8950,8950,8950,8800,8850,-100
2235,2023-07-26,INTP,10450,10500,10500,10325,10325,-125
2236,2023-07-26,MAPI,1910,0,1970,1920,1925,15
2237,2023-07-26,SIDO,695,695,700,680,685,-10
2238,2023-07-26,UNTR,25400,25525,26575,25525,26400,1000
2239,2023-07-26,UNVR,4050,4050,4070,3950,3970,-80
2240,2023-07-27,ACES,740,745,755,735,755,15
2241,2023-07-27,AMRT,2830,2790,2820,2690,2750,-80
2242,2023-07-27,ASII,6600,6600,6600,6500,6525,-75
2243,2023-07-27,HRUM,1705,1705,1705,1650,1655,-50
2244,2023-07-27,INKP,8850,8850,9050,8825,8925,75
2245,2023-07-27,INTP,10325,10350,10375,10175,10200,-125
2246,2023-07-27,MAPI,1925,0,2020,1920,2000,75
2247,2023-07-27,SIDO,685,685,685,650,650,-35
2248,2023-07-27,UNTR,26400,26425,26750,26100,26375,-25
2249,2023-07-27,UNVR,3970,3970,4000,3840,3840,-130
2250,2023-07-28,ACES,755,760,765,735,735,-20
2251,2023-07-28,AMRT,2750,2740,2750,2640,2730,-20
2252,2023-07-28,ASII,6525,6500,6625,6475,6625,100
2253,2023-07-28,HRUM,1655,1655,1670,1610,1670,15
2254,2023-07-28,INKP,8925,8925,8975,8850,8875,-50
2255,2023-07-28,INTP,10200,10200,10400,10200,10400,200
2256,2023-07-28,MAPI,2000,0,2030,1970,2020,20
2257,2023-07-28,SIDO,650,650,650,635,640,-10
2258,2023-07-28,UNTR,26375,26400,26650,26025,26650,275
2259,2023-07-28,UNVR,3840,3850,3900,3810,3870,30
2260,2023-07-31,ACES,735,735,745,715,720,-15
2261,2023-07-31,AMRT,2730,2730,2740,2650,2700,-30
2262,2023-07-31,ASII,6625,6750,6950,6725,6850,225
2263,2023-07-31,HRUM,1670,1675,1695,1640,1660,-10
2264,2023-07-31,INKP,8875,8900,9250,8825,9150,275
2265,2023-07-31,INTP,10400,10400,10525,10275,10425,25
2266,2023-07-31,MAPI,2020,0,2050,1975,1980,-40
2267,2023-07-31,SIDO,640,640,660,635,640,0
2268,2023-07-31,UNTR,26650,27450,27650,27075,27525,875
2269,2023-07-31,UNVR,3870,3870,3890,3830,3850,-20
2270,2023-08-01,ACES,720,715,730,675,675,-45
2271,2023-08-01,AMRT,2700,2750,2860,2730,2860,160
2272,2023-08-01,ASII,6850,6875,6900,6800,6875,25
2273,2023-08-01,HRUM,1660,1660,1690,1640,1685,25
2274,2023-08-01,INKP,9150,9100,9350,9000,9300,150
2275,2023-08-01,INTP,10425,10500,10525,10275,10425,0
2276,2023-08-01,MAPI,1980,1990,2030,1960,2030,50
2277,2023-08-01,SIDO,640,640,655,640,640,0
2278,2023-08-01,UNTR,27525,27625,27700,27150,27525,0
2279,2023-08-01,UNVR,3850,3830,3850,3770,3770,-80
2280,2023-08-02,ACES,675,675,700,655,665,-10
2281,2023-08-02,AMRT,2860,2830,2900,2810,2880,20
2282,2023-08-02,ASII,6875,6825,6850,6775,6850,-25
2283,2023-08-02,HRUM,1685,1685,1690,1625,1630,-55
2284,2023-08-02,INKP,9300,9200,9350,9050,9075,-225
2285,2023-08-02,INTP,10425,10425,10575,10275,10575,150
2286,2023-08-02,MAPI,2030,2030,2030,1970,1980,-50
2287,2023-08-02,SIDO,640,640,645,610,615,-25
2288,2023-08-02,UNTR,27525,27500,27500,26500,26725,-800
2289,2023-08-02,UNVR,3770,3770,3800,3680,3690,-80
2290,2023-08-03,ACES,665,670,695,670,690,25
2291,2023-08-03,AMRT,2880,2900,2940,2840,2880,0
2292,2023-08-03,ASII,6850,6800,6900,6775,6825,-25
2293,2023-08-03,HRUM,1630,1630,1655,1620,1640,10
2294,2023-08-03,INKP,9075,9075,9400,9075,9400,325
2295,2023-08-03,INTP,10575,10600,11500,10575,11100,525
2296,2023-08-03,MAPI,1980,2010,2010,1925,1930,-50
2297,2023-08-03,SIDO,615,615,650,615,640,25
2298,2023-08-03,UNTR,26725,26725,27375,26725,27150,425
2299,2023-08-03,UNVR,3690,3690,3830,3670,3770,80
2300,2023-08-04,ACES,690,695,700,680,680,-10
2301,2023-08-04,AMRT,2880,2870,2870,2770,2820,-60
2302,2023-08-04,ASII,6825,6825,6850,6750,6800,-25
2303,2023-08-04,HRUM,1640,1640,1665,1600,1605,-35
2304,2023-08-04,INKP,9400,9400,9400,9250,9275,-125
2305,2023-08-04,INTP,11100,11125,11275,11075,11100,0
2306,2023-08-04,MAPI,1930,1935,1975,1925,1945,15
2307,2023-08-04,SIDO,640,640,655,635,640,0
2308,2023-08-04,UNTR,27150,27250,27725,27250,27325,175
2309,2023-08-04,UNVR,3770,3780,3810,3730,3740,-30
2310,2023-08-07,ACES,680,690,735,690,730,50
2311,2023-08-07,AMRT,2820,2890,2890,2770,2780,-40
2312,2023-08-07,ASII,6800,6825,6900,6750,6875,75
2313,2023-08-07,HRUM,1605,1605,1650,1605,1630,25
2314,2023-08-07,INKP,9275,9275,9750,9275,9625,350
2315,2023-08-07,INTP,11100,11100,11225,10825,10825,-275
2316,2023-08-07,MAPI,1945,1950,1970,1930,1935,-10
2317,2023-08-07,SIDO,640,645,655,640,650,10
2318,2023-08-07,UNTR,27325,27525,27675,27300,27425,100
2319,2023-08-07,UNVR,3740,3740,3770,3720,3720,-20
2320,2023-08-08,ACES,730,730,740,715,720,-10
2321,2023-08-08,AMRT,2780,2760,2830,2760,2780,0
2322,2023-08-08,ASII,6875,6850,6900,6825,6850,-25
2323,2023-08-08,HRUM,1630,1645,1660,1630,1640,10
2324,2023-08-08,INKP,9625,9625,9725,9550,9550,-75
2325,2023-08-08,INTP,10825,10800,11100,10625,10725,-100
2326,2023-08-08,MAPI,1935,1935,1955,1920,1935,0
2327,2023-08-08,SIDO,650,650,660,650,655,5
2328,2023-08-08,UNTR,27425,27525,27700,27500,27525,100
2329,2023-08-08,UNVR,3720,3730,3790,3730,3750,30
2330,2023-08-09,ACES,720,720,725,705,715,-5
2331,2023-08-09,AMRT,2780,2790,2870,2770,2850,70
2332,2023-08-09,ASII,6850,6850,6875,6825,6875,25
2333,2023-08-09,HRUM,1640,1650,1650,1620,1620,-20
2334,2023-08-09,INKP,9550,9550,9750,9550,9750,200
2335,2023-08-09,INTP,10725,10950,11050,10750,10975,250
2336,2023-08-09,MAPI,1935,1945,1970,1930,1945,10
2337,2023-08-09,SIDO,655,655,655,640,640,-15
2338,2023-08-09,UNTR,27525,27575,27850,27575,27750,225
2339,2023-08-09,UNVR,3750,3750,3770,3720,3720,-30
2340,2023-08-10,ACES,715,715,720,690,700,-15
2341,2023-08-10,AMRT,2850,2850,2860,2780,2780,-70
2342,2023-08-10,ASII,6875,6850,6875,6750,6750,-125
2343,2023-08-10,HRUM,1620,1625,1645,1610,1635,15
2344,2023-08-10,INKP,9750,9800,9875,9725,9800,50
2345,2023-08-10,INTP,10975,10900,11025,10850,11000,25
2346,2023-08-10,MAPI,1945,1945,1990,1930,1970,25
2347,2023-08-10,SIDO,640,640,650,640,640,0
2348,2023-08-10,UNTR,27750,27850,27975,27600,27600,-150
2349,2023-08-10,UNVR,3720,3720,3730,3680,3680,-40
2350,2023-08-11,ACES,700,700,700,685,700,0
2351,2023-08-11,AMRT,2780,2800,2870,2780,2830,50
2352,2023-08-11,ASII,6750,6750,6775,6650,6750,0
2353,2023-08-11,HRUM,1635,1635,1645,1605,1610,-25
2354,2023-08-11,INKP,9800,9825,9825,9600,9700,-100
2355,2023-08-11,INTP,11000,10900,11150,10900,11025,25
2356,2023-08-11,MAPI,1970,1970,2030,1970,2030,60
2357,2023-08-11,SIDO,640,640,650,640,640,0
2358,2023-08-11,UNTR,27600,27600,27625,26800,27100,-500
2359,2023-08-11,UNVR,3680,3680,3720,3680,3700,20
2360,2023-08-14,ACES,700,700,700,690,690,-10
2361,2023-08-14,AMRT,2830,2850,2910,2820,2890,60
2362,2023-08-14,ASII,6750,6700,6800,6700,6800,50
2363,2023-08-14,HRUM,1610,1610,1620,1565,1570,-40
2364,2023-08-14,INKP,9700,9750,10000,9750,9950,250
2365,2023-08-14,INTP,11025,11050,11275,10900,11275,250
2366,2023-08-14,MAPI,2030,2030,2070,2000,2020,-10
2367,2023-08-14,SIDO,640,640,650,640,645,5
2368,2023-08-14,UNTR,27100,27200,27450,26850,27450,350
2369,2023-08-14,UNVR,3700,3700,3730,3630,3730,30
2370,2023-08-15,ACES,690,695,730,690,720,30
2371,2023-08-15,AMRT,2890,2890,2940,2890,2910,20
2372,2023-08-15,ASII,6800,6725,6775,6675,6725,-75
2373,2023-08-15,HRUM,1570,1570,1590,1550,1580,10
2374,2023-08-15,INKP,9950,9925,10125,9900,10075,125
2375,2023-08-15,INTP,11275,11275,11325,11125,11225,-50
2376,2023-08-15,MAPI,2020,2020,2020,1985,1995,-25
2377,2023-08-15,SIDO,645,645,655,640,645,0
2378,2023-08-15,UNTR,27450,27500,27500,27150,27375,-75
2379,2023-08-15,UNVR,3730,3750,3750,3690,3730,0
2380,2023-08-16,ACES,720,720,730,710,715,-5
2381,2023-08-16,AMRT,2910,2910,3030,2910,2940,30
2382,2023-08-16,ASII,6725,6675,6750,6650,6750,25
2383,2023-08-16,HRUM,1580,1580,1590,1575,1585,5
2384,2023-08-16,INKP,10075,10025,10025,9625,9750,-325
2385,2023-08-16,INTP,11225,11200,11250,11000,11250,25
2386,2023-08-16,MAPI,1995,1995,1995,1925,1940,-55
2387,2023-08-16,SIDO,645,645,650,640,640,-5
2388,2023-08-16,UNTR,27375,27375,27500,27175,27500,125
2389,2023-08-16,UNVR,3730,3730,3730,3680,3730,0
2390,2023-08-18,ACES,715,715,730,710,710,-5
2391,2023-08-18,AMRT,2940,2980,3010,2880,2900,-40
2392,2023-08-18,ASII,6750,6675,6700,6500,6525,-225
2393,2023-08-18,HRUM,1585,1580,1585,1560,1560,-25
2394,2023-08-18,INKP,9750,9725,9725,9250,9375,-375
2395,2023-08-18,INTP,11250,11225,11225,11000,11200,-50
2396,2023-08-18,MAPI,1940,1945,1975,1875,1910,-30
2397,2023-08-18,SIDO,640,640,655,640,650,10
2398,2023-08-18,UNTR,27500,27325,27375,26800,26800,-700
2399,2023-08-18,UNVR,3730,3680,3720,3680,3690,-40
2400,2023-08-21,ACES,710,710,745,710,730,20
2401,2023-08-21,AMRT,2900,2920,3020,2920,2990,90
2402,2023-08-21,ASII,6525,6525,6550,6425,6475,-50
2403,2023-08-21,HRUM,1560,1565,1615,1565,1580,20
2404,2023-08-21,INKP,9375,9375,9425,9000,9075,-300
2405,2023-08-21,INTP,11200,11150,11150,10975,11000,-200
2406,2023-08-21,MAPI,1910,1910,1910,1860,1885,-25
2407,2023-08-21,SIDO,650,650,655,645,645,-5
2408,2023-08-21,UNTR,26800,26800,27300,26800,27075,275
2409,2023-08-21,UNVR,3690,3700,3730,3690,3710,20
2410,2023-08-22,ACES,730,750,765,735,750,20
2411,2023-08-22,AMRT,2990,2940,2980,2910,2910,-80
2412,2023-08-22,ASII,6475,6450,6600,6450,6550,75
2413,2023-08-22,HRUM,1580,1585,1655,1585,1640,60
2414,2023-08-22,INKP,9075,9125,9500,9125,9450,375
2415,2023-08-22,INTP,11000,11000,11075,11000,11025,25
2416,2023-08-22,MAPI,1885,1895,1975,1895,1970,85
2417,2023-08-22,SIDO,645,645,655,645,650,5
2418,2023-08-22,UNTR,27075,27225,27650,27150,27600,525
2419,2023-08-22,UNVR,3710,3710,3720,3700,3710,0
2420,2023-08-23,ACES,750,750,760,730,755,5
2421,2023-08-23,AMRT,2910,2910,3000,2910,2930,20
2422,2023-08-23,ASII,6550,6550,6600,6525,6550,0
2423,2023-08-23,HRUM,1640,1650,1665,1635,1635,-5
2424,2023-08-23,INKP,9450,9450,9650,9325,9325,-125
2425,2023-08-23,INTP,11025,11000,11125,11000,11075,50
2426,2023-08-23,MAPI,1970,1970,1995,1935,1995,25
2427,2023-08-23,SIDO,650,650,655,645,650,0
2428,2023-08-23,UNTR,27600,27850,28150,27800,27875,275
2429,2023-08-23,UNVR,3710,3710,3780,3700,3750,40
2430,2023-08-24,ACES,755,760,770,755,760,5
2431,2023-08-24,AMRT,2930,2930,2970,2890,2890,-40
2432,2023-08-24,ASII,6550,6550,6600,6475,6475,-75
2433,2023-08-24,HRUM,1635,1635,1635,1610,1610,-25
2434,2023-08-24,INKP,9325,9325,9475,9325,9400,75
2435,2023-08-24,INTP,11075,11100,11375,11100,11150,75
2436,2023-08-24,MAPI,1995,1995,2040,1955,1955,-40
2437,2023-08-24,SIDO,650,650,655,635,635,-15
2438,2023-08-24,UNTR,27875,27775,27775,26700,26700,-1175
2439,2023-08-24,UNVR,3750,3750,3760,3720,3720,-30
2440,2023-08-25,ACES,760,765,765,745,750,-10
2441,2023-08-25,AMRT,2890,2900,2950,2880,2890,0
2442,2023-08-25,ASII,6475,6475,6500,6400,6450,-25
2443,2023-08-25,HRUM,1610,1600,1610,1570,1600,-10
2444,2023-08-25,INKP,9400,9400,9475,9250,9300,-100
2445,2023-08-25,INTP,11150,11200,11300,11100,11300,150
2446,2023-08-25,MAPI,1955,1965,1995,1920,1970,15
2447,2023-08-25,SIDO,635,635,645,635,640,5
2448,2023-08-25,UNTR,26700,26700,26725,25975,26050,-650
2449,2023-08-25,UNVR,3720,3720,3760,3700,3760,40
2450,2023-08-28,ACES,750,755,775,750,760,10
2451,2023-08-28,AMRT,2890,2900,2930,2870,2870,-20
2452,2023-08-28,ASII,6450,6500,6500,6400,6425,-25
2453,2023-08-28,HRUM,1600,1600,1630,1595,1615,15
2454,2023-08-28,INKP,9300,9300,9500,9300,9475,175
2455,2023-08-28,INTP,11300,11275,11350,11150,11150,-150
2456,2023-08-28,MAPI,1970,1975,2020,1945,2010,40
2457,2023-08-28,SIDO,640,640,645,635,640,0
2458,2023-08-28,UNTR,26050,26125,26600,26125,26400,350
2459,2023-08-28,UNVR,3760,3790,3800,3760,3780,20
2460,2023-08-29,ACES,760,765,770,750,755,-5
2461,2023-08-29,AMRT,2870,2910,2930,2860,2900,30
2462,2023-08-29,ASII,6425,6450,6450,6375,6400,-25
2463,2023-08-29,HRUM,1615,1625,1635,1600,1600,-15
2464,2023-08-29,INKP,9475,9475,9700,9425,9500,25
2465,2023-08-29,INTP,11150,11150,11275,11125,11125,-25
2466,2023-08-29,MAPI,2010,2010,2020,1955,1960,-50
2467,2023-08-29,SIDO,640,640,645,630,635,-5
2468,2023-08-29,UNTR,26400,26500,26600,26300,26350,-50
2469,2023-08-29,UNVR,3780,3780,3800,3760,3760,-20
2470,2023-08-30,ACES,755,760,765,750,755,0
2471,2023-08-30,AMRT,2900,2900,2920,2860,2900,0
2472,2023-08-30,ASII,6400,6450,6525,6400,6450,50
2473,2023-08-30,HRUM,1600,1605,1610,1575,1585,-15
2474,2023-08-30,INKP,9500,9525,9675,9350,9350,-150
2475,2023-08-30,INTP,11125,11150,11200,10900,10900,-225
2476,2023-08-30,MAPI,1960,1965,1985,1950,1960,0
2477,2023-08-30,SIDO,635,635,635,620,620,-15
2478,2023-08-30,UNTR,26350,26350,26400,26150,26150,-200
2479,2023-08-30,UNVR,3760,3790,3790,3740,3740,-20
2480,2023-08-31,ACES,755,755,755,730,730,-25
2481,2023-08-31,AMRT,2900,2900,2920,2870,2900,0
2482,2023-08-31,ASII,6450,6450,6475,6400,6450,0
2483,2023-08-31,HRUM,1585,1585,1590,1560,1560,-25
2484,2023-08-31,INKP,9350,9400,9425,9025,9100,-250
2485,2023-08-31,INTP,10900,10875,10875,10600,10700,-200
2486,2023-08-31,MAPI,1960,1965,1975,1935,1935,-25
2487,2023-08-31,SIDO,620,625,625,615,620,0
2488,2023-08-31,UNTR,26150,26150,26250,26000,26000,-150
2489,2023-08-31,UNVR,3740,3740,3760,3670,3670,-70
2490,2023-09-01,ACES,730,730,740,710,740,10
2491,2023-09-01,AMRT,2900,2900,2910,2820,2880,-20
2492,2023-09-01,ASII,6450,6475,6575,6475,6550,100
2493,2023-09-01,HRUM,1560,1560,1585,1560,1575,15
2494,2023-09-01,INKP,9100,9200,9300,9125,9175,75
2495,2023-09-01,INTP,10700,10700,10700,10450,10600,-100
2496,2023-09-01,MAPI,1935,1940,1985,1940,1975,40
2497,2023-09-01,SIDO,620,620,625,610,615,-5
2498,2023-09-01,UNTR,26000,26000,26425,26000,26350,350
2499,2023-09-01,UNVR,3670,3670,3720,3630,3660,-10
2500,2023-09-04,ACES,740,740,750,730,740,0
2501,2023-09-04,AMRT,2880,2890,2910,2840,2850,-30
2502,2023-09-04,ASII,6550,6575,6600,6525,6600,50
2503,2023-09-04,HRUM,1575,1585,1640,1580,1620,45
2504,2023-09-04,INKP,9175,9200,9300,9075,9250,75
2505,2023-09-04,INTP,10600,10600,10800,10500,10600,0
2506,2023-09-04,MAPI,1975,1975,1985,1950,1980,5
2507,2023-09-04,SIDO,615,620,630,615,615,0
2508,2023-09-04,UNTR,26350,26425,26875,26425,26825,475
2509,2023-09-04,UNVR,3660,3670,3690,3660,3660,0
2510,2023-09-05,ACES,740,740,740,730,730,-10
2511,2023-09-05,AMRT,2850,2850,2860,2820,2840,-10
2512,2023-09-05,ASII,6600,6600,6650,6550,6600,0
2513,2023-09-05,HRUM,1620,1620,1635,1605,1605,-15
2514,2023-09-05,INKP,9250,9250,9450,9200,9250,0
2515,2023-09-05,INTP,10600,0,10775,10575,10700,100
2516,2023-09-05,MAPI,1980,1990,1995,1950,1960,-20
2517,2023-09-05,SIDO,615,615,620,610,615,0
2518,2023-09-05,UNTR,26825,26850,27350,26850,27200,375
2519,2023-09-05,UNVR,3660,3660,3670,3600,3620,-40
2520,2023-09-06,ACES,730,730,750,715,725,-5
2521,2023-09-06,AMRT,2840,2840,2870,2770,2810,-30
2522,2023-09-06,ASII,6600,6575,6625,6525,6525,-75
2523,2023-09-06,HRUM,1605,1625,1700,1620,1695,90
2524,2023-09-06,INKP,9250,9300,9300,9150,9175,-75
2525,2023-09-06,INTP,10700,10725,10975,10700,10775,75
2526,2023-09-06,MAPI,1960,1955,1955,1865,1900,-60
2527,2023-09-06,SIDO,615,615,625,615,620,5
2528,2023-09-06,UNTR,27200,27400,27525,27350,27400,200
2529,2023-09-06,UNVR,3620,3620,3680,3600,3650,30
2530,2023-09-07,ACES,725,725,735,720,720,-5
2531,2023-09-07,AMRT,2810,2810,2900,2810,2900,90
2532,2023-09-07,ASII,6525,6475,6500,6350,6400,-125
2533,2023-09-07,HRUM,1695,1685,1730,1660,1670,-25
2534,2023-09-07,INKP,9175,9175,9600,9075,9475,300
2535,2023-09-07,INTP,10775,10775,10775,10550,10700,-75
2536,2023-09-07,MAPI,1900,1900,1905,1815,1840,-60
2537,2023-09-07,SIDO,620,620,625,615,620,0
2538,2023-09-07,UNTR,27400,27400,27425,26950,27150,-250
2539,2023-09-07,UNVR,3650,3660,3670,3600,3630,-20
2540,2023-09-08,ACES,720,725,730,715,720,0
2541,2023-09-08,AMRT,2900,2900,2920,2820,2870,-30
2542,2023-09-08,ASII,6400,6450,6450,6350,6400,0
2543,2023-09-08,HRUM,1670,1670,1705,1655,1665,-5
2544,2023-09-08,INKP,9475,9525,9550,9325,9450,-25
2545,2023-09-08,INTP,10700,10750,10825,10675,10825,125
2546,2023-09-08,MAPI,1840,1815,1870,1790,1840,0
2547,2023-09-08,SIDO,620,620,620,600,600,-20
2548,2023-09-08,UNTR,27150,27125,27475,26975,27300,150
2549,2023-09-08,UNVR,3630,3630,3630,3570,3610,-20
2550,2023-09-11,ACES,720,730,755,720,755,35
2551,2023-09-11,AMRT,2870,2880,2950,2880,2950,80
2552,2023-09-11,ASII,6400,6400,6425,6300,6375,-25
2553,2023-09-11,HRUM,1665,1665,1730,1610,1695,30
2554,2023-09-11,INKP,9450,9500,10200,9425,10200,750
2555,2023-09-11,INTP,10825,10825,11050,10775,11025,200
2556,2023-09-11,MAPI,1840,1850,1900,1830,1885,45
2557,2023-09-11,SIDO,600,600,615,600,605,5
2558,2023-09-11,UNTR,27300,27325,27350,26850,26900,-400
2559,2023-09-11,UNVR,3610,3610,3650,3580,3650,40
2560,2023-09-12,ACES,755,760,760,735,750,-5
2561,2023-09-12,AMRT,2950,2960,2990,2920,2980,30
2562,2023-09-12,ASII,6375,6375,6375,6300,6300,-75
2563,2023-09-12,HRUM,1695,1715,1765,1715,1735,40
2564,2023-09-12,INKP,10200,10225,10850,10025,10200,0
2565,2023-09-12,INTP,11025,11075,11075,10775,10825,-200
2566,2023-09-12,MAPI,1885,1895,1900,1820,1850,-35
2567,2023-09-12,SIDO,605,605,615,605,610,5
2568,2023-09-12,UNTR,26900,26950,27250,26925,27075,175
2569,2023-09-12,UNVR,3650,3650,3660,3610,3620,-30
2570,2023-09-13,ACES,750,750,760,745,745,-5
2571,2023-09-13,AMRT,2980,3000,3000,2930,2960,-20
2572,2023-09-13,ASII,6300,6325,6325,6225,6300,0
2573,2023-09-13,HRUM,1735,1735,1770,1730,1760,25
2574,2023-09-13,INKP,10200,10200,10625,10050,10575,375
2575,2023-09-13,INTP,10825,10850,11000,10850,11000,175
2576,2023-09-13,MAPI,1850,1850,1870,1830,1845,-5
2577,2023-09-13,SIDO,610,610,610,600,605,-5
2578,2023-09-13,UNTR,27075,27150,27275,27075,27175,100
2579,2023-09-13,UNVR,3620,3630,3630,3570,3590,-30
2580,2023-09-14,ACES,745,745,750,735,735,-10
2581,2023-09-14,AMRT,2960,2950,2960,2840,2840,-120
2582,2023-09-14,ASII,6300,6325,6375,6250,6325,25
2583,2023-09-14,HRUM,1760,1775,1845,1770,1800,40
2584,2023-09-14,INKP,10575,10575,10850,10500,10500,-75
2585,2023-09-14,INTP,11000,11025,11025,10875,10900,-100
2586,2023-09-14,MAPI,1845,1845,1860,1815,1825,-20
2587,2023-09-14,SIDO,605,605,610,600,605,0
2588,2023-09-14,UNTR,27175,27325,27600,27325,27400,225
2589,2023-09-14,UNVR,3590,3580,3610,3560,3560,-30
2590,2023-09-15,ACES,735,735,745,725,730,-5
2591,2023-09-15,AMRT,2840,2840,2920,2840,2900,60
2592,2023-09-15,ASII,6325,6250,6325,6200,6300,-25
2593,2023-09-15,HRUM,1800,1800,1830,1775,1810,10
2594,2023-09-15,INKP,10500,10500,10625,10400,10575,75
2595,2023-09-15,INTP,10900,10975,10975,10750,10750,-150
2596,2023-09-15,MAPI,1825,1835,1840,1800,1820,-5
2597,2023-09-15,SIDO,605,605,610,590,590,-15
2598,2023-09-15,UNTR,27400,27400,28425,27250,28425,1025
2599,2023-09-15,UNVR,3560,3550,3570,3500,3500,-60
2600,2023-09-18,ACES,730,735,795,730,795,65
2601,2023-09-18,AMRT,2900,2880,2910,2840,2900,0
2602,2023-09-18,ASII,6300,6275,6325,6250,6300,0
2603,2023-09-18,HRUM,1810,1810,1820,1755,1780,-30
2604,2023-09-18,INKP,10575,10600,10750,10225,10500,-75
2605,2023-09-18,INTP,10750,10700,10750,10250,10250,-500
2606,2023-09-18,MAPI,1820,1820,1820,1775,1795,-25
2607,2023-09-18,SIDO,590,590,600,590,595,5
2608,2023-09-18,UNTR,28425,28375,28600,28100,28100,-325
2609,2023-09-18,UNVR,3500,3500,3520,3460,3470,-30
2610,2023-09-19,ACES,795,800,815,775,775,-20
2611,2023-09-19,AMRT,2900,2910,2910,2860,2900,0
2612,2023-09-19,ASII,6300,6300,6375,6275,6350,50
2613,2023-09-19,HRUM,1780,1785,1860,1755,1845,65
2614,2023-09-19,INKP,10500,10500,11200,10475,11150,650
2615,2023-09-19,INTP,10250,10250,10625,10175,10350,100
2616,2023-09-19,MAPI,1795,1795,1835,1790,1800,5
2617,2023-09-19,SIDO,595,590,595,585,590,-5
2618,2023-09-19,UNTR,28100,28150,28450,28025,28325,225
2619,2023-09-19,UNVR,3470,3490,3630,3480,3580,110
2620,2023-09-20,ACES,775,775,810,770,790,15
2621,2023-09-20,AMRT,2900,2900,2920,2860,2900,0
2622,2023-09-20,ASII,6350,6350,6400,6300,6300,-50
2623,2023-09-20,HRUM,1845,1860,1865,1805,1810,-35
2624,2023-09-20,INKP,11150,11175,11375,10850,10925,-225
2625,2023-09-20,INTP,10350,10325,10325,10100,10125,-225
2626,2023-09-20,MAPI,1800,1800,1845,1790,1825,25
2627,2023-09-20,SIDO,590,590,590,580,585,-5
2628,2023-09-20,UNTR,28325,28400,28775,28400,28500,175
2629,2023-09-20,UNVR,3580,3580,3670,3570,3630,50
2630,2023-09-21,ACES,790,800,810,780,800,10
2631,2023-09-21,AMRT,2900,2900,2930,2860,2880,-20
2632,2023-09-21,ASII,6300,6300,6325,6200,6200,-100
2633,2023-09-21,HRUM,1810,1810,1825,1780,1790,-20
2634,2023-09-21,INKP,10925,10900,11100,10600,10925,0
2635,2023-09-21,INTP,10125,10075,10300,10050,10250,125
2636,2023-09-21,MAPI,1825,1825,1930,1805,1895,70
2637,2023-09-21,SIDO,585,585,595,580,590,5
2638,2023-09-21,UNTR,28500,28475,28475,28250,28325,-175
2639,2023-09-21,UNVR,3630,3630,3780,3580,3770,140
2640,2023-09-22,ACES,800,795,800,785,790,-10
2641,2023-09-22,AMRT,2880,2880,2920,2880,2900,20
2642,2023-09-22,ASII,6200,6200,6275,6175,6200,0
2643,2023-09-22,HRUM,1790,1780,1830,1775,1820,30
2644,2023-09-22,INKP,10925,10925,11625,10900,11500,575
2645,2023-09-22,INTP,10250,10250,10300,10075,10100,-150
2646,2023-09-22,MAPI,1895,1910,1915,1845,1875,-20
2647,2023-09-22,SIDO,590,590,610,585,600,10
2648,2023-09-22,UNTR,28325,28250,28525,28175,28350,25
2649,2023-09-22,UNVR,3770,3770,3890,3750,3850,80
2650,2023-09-25,ACES,790,795,800,780,790,0
2651,2023-09-25,AMRT,2900,2910,2970,2900,2910,10
2652,2023-09-25,ASII,6200,6225,6275,6200,6250,50
2653,2023-09-25,HRUM,1820,1820,1870,1820,1820,0
2654,2023-09-25,INKP,11500,11500,11725,11375,11550,50
2655,2023-09-25,INTP,10100,10100,10200,10000,10025,-75
2656,2023-09-25,MAPI,1875,1875,1880,1815,1815,-60
2657,2023-09-25,SIDO,600,600,610,595,595,-5
2658,2023-09-25,UNTR,28350,28350,28375,28150,28250,-100
2659,2023-09-25,UNVR,3850,3860,3890,3790,3820,-30
2660,2023-09-26,ACES,790,790,795,730,760,-30
2661,2023-09-26,AMRT,2910,2930,2980,2930,2960,50
2662,2023-09-26,ASII,6250,6225,6300,6200,6200,-50
2663,2023-09-26,HRUM,1820,1825,1835,1715,1735,-85
2664,2023-09-26,INKP,11550,11550,11850,11325,11450,-100
2665,2023-09-26,INTP,10025,10075,10125,9725,9800,-225
2666,2023-09-26,MAPI,1815,1820,1865,1820,1850,35
2667,2023-09-26,SIDO,595,600,600,590,590,-5
2668,2023-09-26,UNTR,28250,28275,28400,27625,27750,-500
2669,2023-09-26,UNVR,3820,3800,3820,3770,3820,0
2670,2023-09-27,ACES,760,760,765,745,755,-5
2671,2023-09-27,AMRT,2960,2960,2980,2910,2930,-30
2672,2023-09-27,ASII,6200,6200,6250,6125,6150,-50
2673,2023-09-27,HRUM,1735,1745,1890,1745,1870,135
2674,2023-09-27,INKP,11450,11475,11500,11075,11350,-100
2675,2023-09-27,INTP,9800,9800,10075,9775,10075,275
2676,2023-09-27,MAPI,1850,1870,1880,1745,1775,-75
2677,2023-09-27,SIDO,590,590,595,580,585,-5
2678,2023-09-27,UNTR,27750,27700,28300,27475,28300,550
2679,2023-09-27,UNVR,3820,3820,3820,3720,3770,-50
2680,2023-09-29,ACES,755,755,765,745,750,-5
2681,2023-09-29,AMRT,2930,2950,2980,2910,2960,30
2682,2023-09-29,ASII,6150,6250,6275,6200,6225,75
2683,2023-09-29,HRUM,1870,1885,1945,1875,1885,15
2684,2023-09-29,INKP,11350,11375,11450,10800,11100,-250
2685,2023-09-29,INTP,10075,10100,10125,9925,9950,-125
2686,2023-09-29,MAPI,1775,1780,1850,1780,1820,45
2687,2023-09-29,SIDO,585,585,595,580,590,5
2688,2023-09-29,UNTR,28300,28400,28475,28100,28250,-50
2689,2023-09-29,UNVR,3770,3770,3780,3690,3740,-30
2690,2023-10-02,ACES,750,755,790,755,785,35
2691,2023-10-02,AMRT,2960,2960,2970,2930,2950,-10
2692,2023-10-02,ASII,6225,6275,6350,6250,6275,50
2693,2023-10-02,HRUM,1885,1895,1920,1815,1820,-65
2694,2023-10-02,INKP,11100,11100,11250,10775,10875,-225
2695,2023-10-02,INTP,9950,10025,10150,9975,10100,150
2696,2023-10-02,MAPI,1820,1820,1885,1820,1870,50
2697,2023-10-02,SIDO,590,590,590,580,585,-5
2698,2023-10-02,UNTR,28250,28225,28350,27850,27925,-325
2699,2023-10-02,UNVR,3740,3740,3780,3700,3700,-40
2700,2023-10-03,ACES,785,785,790,770,775,-10
2701,2023-10-03,AMRT,2950,2950,2980,2900,2950,0
2702,2023-10-03,ASII,6275,6275,6300,6200,6200,-75
2703,2023-10-03,HRUM,1820,1820,1825,1735,1735,-85
2704,2023-10-03,INKP,10875,10875,11125,10600,10625,-250
2705,2023-10-03,INTP,10100,10150,10175,10025,10100,0
2706,2023-10-03,MAPI,1870,1875,1950,1875,1950,80
2707,2023-10-03,SIDO,585,585,590,585,585,0
2708,2023-10-03,UNTR,27925,27925,27925,27000,27000,-925
2709,2023-10-03,UNVR,3700,3700,3700,3590,3590,-110
2710,2023-10-04,ACES,775,775,775,750,750,-25
2711,2023-10-04,AMRT,2950,2950,2970,2870,2870,-80
2712,2023-10-04,ASII,6200,6175,6200,6050,6075,-125
2713,2023-10-04,HRUM,1735,1725,1725,1635,1695,-40
2714,2023-10-04,INKP,10625,10600,10600,9900,10100,-525
2715,2023-10-04,INTP,10100,10050,10050,9825,10025,-75
2716,2023-10-04,MAPI,1950,1950,1950,1900,1930,-20
2717,2023-10-04,SIDO,585,585,590,560,560,-25
2718,2023-10-04,UNTR,27000,26675,26675,26275,26575,-425
2719,2023-10-04,UNVR,3590,3590,3610,3540,3580,-10
2720,2023-10-05,ACES,750,750,780,745,760,10
2721,2023-10-05,AMRT,2870,2900,2930,2890,2900,30
2722,2023-10-05,ASII,6075,6125,6175,6025,6025,-50
2723,2023-10-05,HRUM,1695,1685,1735,1625,1635,-60
2724,2023-10-05,INKP,10100,10100,10600,10025,10200,100
2725,2023-10-05,INTP,10025,10050,10175,9950,10125,100
2726,2023-10-05,MAPI,1930,1930,1950,1910,1915,-15
2727,2023-10-05,SIDO,560,565,615,565,605,45
2728,2023-10-05,UNTR,26575,26575,26575,26150,26150,-425
2729,2023-10-05,UNVR,3580,3610,3680,3580,3660,80
2730,2023-10-06,ACES,760,760,770,755,765,5
2731,2023-10-06,AMRT,2900,2920,2950,2720,2730,-170
2732,2023-10-06,ASII,6025,6050,6150,6050,6075,50
2733,2023-10-06,HRUM,1635,1630,1670,1610,1660,25
2734,2023-10-06,INKP,10200,10275,10450,10175,10350,150
2735,2023-10-06,INTP,10125,10125,10125,9975,10025,-100
2736,2023-10-06,MAPI,1915,1920,1995,1920,1990,75
2737,2023-10-06,SIDO,605,605,610,580,595,-10
2738,2023-10-06,UNTR,26150,26175,26525,26175,26400,250
2739,2023-10-06,UNVR,3660,3680,3840,3670,3800,140
2740,2023-10-09,ACES,765,765,770,760,765,0
2741,2023-10-09,AMRT,2730,2750,2830,2750,2820,90
2742,2023-10-09,ASII,6075,6150,6225,6100,6125,50
2743,2023-10-09,HRUM,1660,1685,1705,1660,1680,20
2744,2023-10-09,INKP,10350,10250,10575,10150,10250,-100
2745,2023-10-09,INTP,10025,9975,10050,9850,10000,-25
2746,2023-10-09,MAPI,1990,1995,1995,1935,1960,-30
2747,2023-10-09,SIDO,595,595,605,590,590,-5
2748,2023-10-09,UNTR,26400,26600,26875,26600,26700,300
2749,2023-10-09,UNVR,3800,3800,3800,3700,3720,-80
2750,2023-10-10,ACES,765,770,790,770,780,15
2751,2023-10-10,AMRT,2820,2820,2920,2820,2900,80
2752,2023-10-10,ASII,6125,6175,6175,6050,6050,-75
2753,2023-10-10,HRUM,1680,1710,1725,1670,1670,-10
2754,2023-10-10,INKP,10250,10300,10725,10300,10600,350
2755,2023-10-10,INTP,10000,10050,10175,10050,10100,100
2756,2023-10-10,MAPI,1960,1970,2000,1945,1990,30
2757,2023-10-10,SIDO,590,595,600,585,590,0
2758,2023-10-10,UNTR,26700,26875,26950,26725,26875,175
2759,2023-10-10,UNVR,3720,3720,3750,3670,3670,-50
2760,2023-10-11,ACES,780,785,790,775,780,0
2761,2023-10-11,AMRT,2900,2910,2940,2860,2880,-20
2762,2023-10-11,ASII,6050,6075,6125,6050,6050,0
2763,2023-10-11,HRUM,1670,1680,1695,1655,1675,5
2764,2023-10-11,INKP,10600,10650,10850,10525,10675,75
2765,2023-10-11,INTP,10100,10125,10150,9950,9950,-150
2766,2023-10-11,MAPI,1990,1995,2020,1970,1980,-10
2767,2023-10-11,SIDO,590,590,595,580,585,-5
2768,2023-10-11,UNTR,26875,26300,26375,26250,26275,-600
2769,2023-10-11,UNVR,3670,3670,3710,3610,3610,-60
2770,2023-10-12,ACES,780,780,810,780,805,25
2771,2023-10-12,AMRT,2880,2860,2900,2810,2850,-30
2772,2023-10-12,ASII,6050,6000,6025,5950,5950,-100
2773,2023-10-12,HRUM,1675,1675,1675,1615,1620,-55
2774,2023-10-12,INKP,10675,10725,10925,10425,10725,50
2775,2023-10-12,INTP,9950,9975,10125,9975,10050,100
2776,2023-10-12,MAPI,1980,1990,1990,1930,1975,-5
2777,2023-10-12,SIDO,585,585,600,585,590,5
2778,2023-10-12,UNTR,26275,26275,26275,25850,25875,-400
2779,2023-10-12,UNVR,3610,3620,3670,3610,3630,20
2780,2023-10-13,ACES,805,805,830,785,785,-20
2781,2023-10-13,AMRT,2850,2850,2850,2750,2810,-40
2782,2023-10-13,ASII,5950,6000,6025,5950,5975,25
2783,2023-10-13,HRUM,1620,1630,1695,1630,1670,50
2784,2023-10-13,INKP,10725,10750,10775,10375,10525,-200
2785,2023-10-13,INTP,10050,10050,10200,9975,10000,-50
2786,2023-10-13,MAPI,1975,1975,1990,1950,1965,-10
2787,2023-10-13,SIDO,590,590,595,575,580,-10
2788,2023-10-13,UNTR,25875,26000,26325,26000,26075,200
2789,2023-10-13,UNVR,3630,3610,3660,3610,3650,20
2790,2023-10-16,ACES,785,785,810,775,805,20
2791,2023-10-16,AMRT,2810,2820,2870,2800,2800,-10
2792,2023-10-16,ASII,5975,5925,5975,5825,5850,-125
2793,2023-10-16,HRUM,1670,1680,1720,1680,1705,35
2794,2023-10-16,INKP,10525,10525,10525,10175,10350,-175
2795,2023-10-16,INTP,10000,10000,10150,9975,10075,75
2796,2023-10-16,MAPI,1965,1950,1960,1880,1890,-75
2797,2023-10-16,SIDO,580,580,590,570,575,-5
2798,2023-10-16,UNTR,26075,26375,26450,26200,26450,375
2799,2023-10-16,UNVR,3650,3660,3670,3620,3650,0
2800,2023-10-17,ACES,805,805,815,785,800,-5
2801,2023-10-17,AMRT,2800,2810,2870,2790,2790,-10
2802,2023-10-17,ASII,5850,5875,5925,5850,5850,0
2803,2023-10-17,HRUM,1705,1705,1715,1680,1700,-5
2804,2023-10-17,INKP,10350,10375,10675,10275,10325,-25
2805,2023-10-17,INTP,10075,10100,10350,10100,10300,225
2806,2023-10-17,MAPI,1890,1890,1915,1855,1855,-35
2807,2023-10-17,SIDO,575,575,585,575,580,5
2808,2023-10-17,UNTR,26450,26450,26475,26250,26375,-75
2809,2023-10-17,UNVR,3650,3650,3840,3630,3830,180
2810,2023-10-18,ACES,800,800,805,785,800,0
2811,2023-10-18,AMRT,2790,2830,2840,2780,2810,20
2812,2023-10-18,ASII,5850,5850,6000,5825,5825,-25
2813,2023-10-18,HRUM,1700,1695,1725,1660,1725,25
2814,2023-10-18,INKP,10325,10350,10725,10225,10625,300
2815,2023-10-18,INTP,10300,10300,10300,9900,9900,-400
2816,2023-10-18,MAPI,1855,1865,1895,1810,1895,40
2817,2023-10-18,SIDO,580,580,585,575,580,0
2818,2023-10-18,UNTR,26375,26275,26425,26100,26300,-75
2819,2023-10-18,UNVR,3830,3830,3840,3760,3820,-10
2820,2023-10-19,ACES,800,800,810,765,790,-10
2821,2023-10-19,AMRT,2810,2820,2840,2800,2810,0
2822,2023-10-19,ASII,5825,5825,5850,5700,5725,-100
2823,2023-10-19,HRUM,1725,1725,1780,1720,1760,35
2824,2023-10-19,INKP,10625,10600,10600,10300,10450,-175
2825,2023-10-19,INTP,9900,9900,10000,9800,9875,-25
2826,2023-10-19,MAPI,1895,1880,1880,1795,1855,-40
2827,2023-10-19,SIDO,580,580,580,570,570,-10
2828,2023-10-19,UNTR,26300,26400,26400,26000,26025,-275
2829,2023-10-19,UNVR,3820,3800,3850,3770,3810,-10
2830,2023-10-20,ACES,790,790,805,780,795,5
2831,2023-10-20,AMRT,2810,2810,2900,2750,2800,-10
2832,2023-10-20,ASII,5725,5675,5750,5650,5700,-25
2833,2023-10-20,HRUM,1760,1760,1775,1705,1760,0
2834,2023-10-20,INKP,10450,10425,10450,10100,10275,-175
2835,2023-10-20,INTP,9875,9825,9875,9700,9825,-50
2836,2023-10-20,MAPI,1855,1855,1915,1835,1905,50
2837,2023-10-20,SIDO,570,570,575,560,575,5
2838,2023-10-20,UNTR,26025,26000,26050,25800,25825,-200
2839,2023-10-20,UNVR,3810,3810,3880,3730,3860,50
2840,2023-10-23,ACES,795,810,845,805,825,30
2841,2023-10-23,AMRT,2800,2800,2820,2750,2760,-40
2842,2023-10-23,ASII,5700,5725,5750,5600,5600,-100
2843,2023-10-23,HRUM,1760,1760,1785,1700,1720,-40
2844,2023-10-23,INKP,10275,10275,10275,9650,9775,-500
2845,2023-10-23,INTP,9825,9825,9825,9525,9650,-175
2846,2023-10-23,MAPI,1905,1915,1930,1875,1920,15
2847,2023-10-23,SIDO,575,575,575,565,570,-5
2848,2023-10-23,UNTR,25825,25825,25850,25000,25000,-825
2849,2023-10-23,UNVR,3860,3860,3860,3760,3840,-20
2850,2023-10-24,ACES,825,825,865,815,855,30
2851,2023-10-24,AMRT,2760,2760,2830,2760,2820,60
2852,2023-10-24,ASII,5600,5600,5850,5600,5800,200
2853,2023-10-24,HRUM,1720,1720,1755,1710,1735,15
2854,2023-10-24,INKP,9775,9700,10000,9675,9800,25
2855,2023-10-24,INTP,9650,9650,9825,9650,9675,25
2856,2023-10-24,MAPI,1920,1920,1965,1880,1950,30
2857,2023-10-24,SIDO,570,575,590,570,590,20
2858,2023-10-24,UNTR,25000,25000,25425,24850,25250,250
2859,2023-10-24,UNVR,3840,3830,4000,3790,3990,150
2860,2023-10-25,ACES,855,855,890,855,875,20
2861,2023-10-25,AMRT,2820,2830,2920,2820,2920,100
2862,2023-10-25,ASII,5800,5825,5925,5775,5775,-25
2863,2023-10-25,HRUM,1735,1745,1780,1730,1760,25
2864,2023-10-25,INKP,9800,9875,9875,9300,9400,-400
2865,2023-10-25,INTP,9675,9700,9800,9650,9650,-25
2866,2023-10-25,MAPI,1950,1950,1970,1935,1955,5
2867,2023-10-25,SIDO,590,590,600,590,590,0
2868,2023-10-25,UNTR,25250,25700,26800,25700,26325,1075
2869,2023-10-25,UNVR,3990,4000,4100,4000,4080,90
2870,2023-10-26,ACES,875,875,880,825,870,-5
2871,2023-10-26,AMRT,2920,2910,2910,2760,2850,-70
2872,2023-10-26,ASII,5775,5775,5800,5675,5725,-50
2873,2023-10-26,HRUM,1760,1760,1765,1715,1725,-35
2874,2023-10-26,INKP,9400,9400,9750,9275,9500,100
2875,2023-10-26,INTP,9650,9700,9700,9175,9350,-300
2876,2023-10-26,MAPI,1955,1950,1950,1830,1850,-105
2877,2023-10-26,SIDO,590,590,590,575,575,-15
2878,2023-10-26,UNTR,26325,26200,26500,26000,26175,-150
2879,2023-10-26,UNVR,4080,4050,4050,3960,3980,-100
2880,2023-10-27,ACES,870,870,875,840,845,-25
2881,2023-10-27,AMRT,2850,2850,2900,2820,2820,-30
2882,2023-10-27,ASII,5725,5750,5775,5725,5725,0
2883,2023-10-27,HRUM,1725,1730,1750,1730,1735,10
2884,2023-10-27,INKP,9500,9600,10125,9550,10000,500
2885,2023-10-27,INTP,9350,9375,9450,9125,9250,-100
2886,2023-10-27,MAPI,1850,1855,1865,1780,1825,-25
2887,2023-10-27,SIDO,575,575,585,565,575,0
2888,2023-10-27,UNTR,26175,26175,26250,25525,25525,-650
2889,2023-10-27,UNVR,3980,3980,4070,3950,3980,0
2890,2023-10-30,ACES,845,845,860,795,830,-15
2891,2023-10-30,AMRT,2820,2820,2900,2820,2890,70
2892,2023-10-30,ASII,5725,5750,5825,5675,5800,75
2893,2023-10-30,HRUM,1735,1735,1760,1595,1600,-135
2894,2023-10-30,INKP,10000,10000,10100,9100,9300,-700
2895,2023-10-30,INTP,9250,9250,9275,9150,9225,-25
2896,2023-10-30,MAPI,1825,1820,1820,1750,1755,-70
2897,2023-10-30,SIDO,575,575,580,510,515,-60
2898,2023-10-30,UNTR,25525,25525,25525,24300,24400,-1125
2899,2023-10-30,UNVR,3980,3970,3970,3720,3790,-190
2900,2023-10-31,ACES,830,830,835,785,800,-30
2901,2023-10-31,AMRT,2890,2890,2910,2830,2890,0
2902,2023-10-31,ASII,5800,5850,5900,5775,5775,-25
2903,2023-10-31,HRUM,1600,1600,1625,1565,1615,15
2904,2023-10-31,INKP,9300,9300,9600,9200,9600,300
2905,2023-10-31,INTP,9225,9225,9325,9025,9275,50
2906,2023-10-31,MAPI,1755,1755,1755,1660,1735,-20
2907,2023-10-31,SIDO,515,515,520,505,510,-5
2908,2023-10-31,UNTR,24400,24425,25300,24425,25125,725
2909,2023-10-31,UNVR,3790,3790,3820,3620,3620,-170
2910,2023-11-01,ACES,800,810,820,780,795,-5
2911,2023-11-01,AMRT,2890,2900,2940,2850,2850,-40
2912,2023-11-01,ASII,5775,5900,6000,5800,5800,25
2913,2023-11-01,HRUM,1615,1600,1600,1505,1510,-105
2914,2023-11-01,INKP,9600,9100,9200,8200,8225,-1375
2915,2023-11-01,INTP,9275,9500,9500,9100,9100,-175
2916,2023-11-01,MAPI,1735,1725,1725,1580,1605,-130
2917,2023-11-01,SIDO,510,505,505,484,486,-24
2918,2023-11-01,UNTR,25125,25100,25100,24100,24100,-1025
2919,2023-11-01,UNVR,3620,3600,3650,3550,3580,-40
2920,2023-11-02,ACES,795,805,820,795,795,0
2921,2023-11-02,AMRT,2850,2860,2880,2840,2850,0
2922,2023-11-02,ASII,5800,5850,5900,5800,5800,0
2923,2023-11-02,HRUM,1510,1510,1560,1510,1525,15
2924,2023-11-02,INKP,8225,8400,8700,8300,8575,350
2925,2023-11-02,INTP,9100,9150,9475,9150,9325,225
2926,2023-11-02,MAPI,1605,1650,1745,1605,1710,105
2927,2023-11-02,SIDO,486,486,505,486,492,6
2928,2023-11-02,UNTR,24100,24125,24350,23725,23725,-375
2929,2023-11-02,UNVR,3580,3600,3670,3570,3590,10
2930,2023-11-03,ACES,795,800,825,795,820,25
2931,2023-11-03,AMRT,2850,2850,2900,2850,2900,50
2932,2023-11-03,ASII,5800,5850,5925,5825,5900,100
2933,2023-11-03,HRUM,1525,1540,1560,1510,1515,-10
2934,2023-11-03,INKP,8575,8725,8725,8325,8475,-100
2935,2023-11-03,INTP,9325,9375,9500,9375,9375,50
2936,2023-11-03,MAPI,1710,1710,1720,1640,1670,-40
2937,2023-11-03,SIDO,492,494,500,478,496,4
2938,2023-11-03,UNTR,23725,23800,24050,23775,23775,50
2939,2023-11-03,UNVR,3590,3590,3610,3520,3550,-40
2940,2023-11-06,ACES,820,830,870,820,860,40
2941,2023-11-06,AMRT,2900,2900,2900,2790,2810,-90
2942,2023-11-06,ASII,5900,5925,5950,5900,5925,25
2943,2023-11-06,HRUM,1515,1505,1545,1495,1515,0
2944,2023-11-06,INKP,8475,8475,8700,8475,8700,225
2945,2023-11-06,INTP,9375,9575,9950,9450,9800,425
2946,2023-11-06,MAPI,1670,1700,1705,1615,1685,15
2947,2023-11-06,SIDO,496,496,505,496,500,4
2948,2023-11-06,UNTR,23775,23825,23850,23550,23750,-25
2949,2023-11-06,UNVR,3550,3550,3630,3550,3620,70
2950,2023-11-07,ACES,860,860,860,825,830,-30
2951,2023-11-07,AMRT,2810,2820,2890,2820,2890,80
2952,2023-11-07,ASII,5925,5925,5950,5775,5825,-100
2953,2023-11-07,HRUM,1515,1515,1515,1460,1470,-45
2954,2023-11-07,INKP,8700,8700,8700,8350,8500,-200
2955,2023-11-07,INTP,9800,9850,10200,9700,9825,25
2956,2023-11-07,MAPI,1685,1685,1685,1560,1600,-85
2957,2023-11-07,SIDO,500,505,505,496,496,-4
2958,2023-11-07,UNTR,23750,23775,24075,23225,23375,-375
2959,2023-11-07,UNVR,3620,3620,3620,3550,3570,-50
2960,2023-11-08,ACES,830,840,845,820,830,0
2961,2023-11-08,AMRT,2890,2890,2900,2850,2900,10
2962,2023-11-08,ASII,5825,5800,5825,5675,5725,-100
2963,2023-11-08,HRUM,1470,1470,1490,1455,1465,-5
2964,2023-11-08,INKP,8500,8475,8500,8300,8400,-100
2965,2023-11-08,INTP,9825,9825,9825,9550,9700,-125
2966,2023-11-08,MAPI,1600,1600,1670,1580,1655,55
2967,2023-11-08,SIDO,496,496,498,484,486,-10
2968,2023-11-08,UNTR,23375,23375,23400,22700,22800,-575
2969,2023-11-08,UNVR,3570,3560,3600,3560,3600,30
2970,2023-11-09,ACES,830,830,840,820,825,-5
2971,2023-11-09,AMRT,2900,2900,2970,2850,2900,0
2972,2023-11-09,ASII,5725,5775,5825,5725,5750,25
2973,2023-11-09,HRUM,1465,1480,1510,1465,1475,10
2974,2023-11-09,INKP,8400,8425,8650,8300,8575,175
2975,2023-11-09,INTP,9700,9700,9750,9600,9600,-100
2976,2023-11-09,MAPI,1655,1655,1670,1610,1665,10
2977,2023-11-09,SIDO,486,488,494,486,494,8
2978,2023-11-09,UNTR,22800,23000,23125,22875,22875,75
2979,2023-11-09,UNVR,3600,3600,3600,3580,3600,0
2980,2023-11-10,ACES,825,820,830,800,805,-20
2981,2023-11-10,AMRT,2900,2910,2910,2880,2900,0
2982,2023-11-10,ASII,5750,5725,5775,5725,5775,25
2983,2023-11-10,HRUM,1475,1475,1475,1455,1460,-15
2984,2023-11-10,INKP,8575,8600,8650,8350,8475,-100
2985,2023-11-10,INTP,9600,9600,9600,9350,9400,-200
2986,2023-11-10,MAPI,1665,1650,1710,1645,1685,20
2987,2023-11-10,SIDO,494,494,498,494,496,2
2988,2023-11-10,UNTR,22875,22900,23175,22900,23100,225
2989,2023-11-10,UNVR,3600,3600,3600,3550,3590,-10
2990,2023-11-13,ACES,805,815,830,810,825,20
2991,2023-11-13,AMRT,2900,2910,2920,2890,2910,10
2992,2023-11-13,ASII,5775,5825,5825,5650,5650,-125
2993,2023-11-13,HRUM,1460,1455,1460,1430,1445,-15
2994,2023-11-13,INKP,8475,8575,8800,8450,8750,275
2995,2023-11-13,INTP,9400,9475,9475,9375,9425,25
2996,2023-11-13,MAPI,1685,1685,1685,1600,1610,-75
2997,2023-11-13,SIDO,496,498,500,496,500,4
2998,2023-11-13,UNTR,23100,23100,23500,23100,23250,150
2999,2023-11-13,UNVR,3590,3590,3590,3510,3530,-60
3000,2023-11-14,ACES,825,830,840,810,810,-15
3001,2023-11-14,AMRT,2910,2920,2920,2830,2880,-30
3002,2023-11-14,ASII,5650,5675,5725,5650,5675,25
3003,2023-11-14,HRUM,1445,1445,1470,1435,1470,25
3004,2023-11-14,INKP,8750,8800,8900,8625,8625,-125
3005,2023-11-14,INTP,9425,9425,9475,9325,9425,0
3006,2023-11-14,MAPI,1610,1600,1645,1550,1590,-20
3007,2023-11-14,SIDO,500,500,500,492,498,-2
3008,2023-11-14,UNTR,23250,23300,23475,23225,23250,0
3009,2023-11-14,UNVR,3530,3510,3520,3470,3480,-50
3010,2023-11-15,ACES,810,825,835,820,835,25
3011,2023-11-15,AMRT,2880,2940,2940,2860,2900,20
3012,2023-11-15,ASII,5675,5750,5850,5700,5750,75
3013,2023-11-15,HRUM,1470,1470,1485,1450,1450,-20
3014,2023-11-15,INKP,8625,8575,8625,8450,8475,-150
3015,2023-11-15,INTP,9425,9475,9475,9350,9425,0
3016,2023-11-15,MAPI,1590,1615,1710,1605,1685,95
3017,2023-11-15,SIDO,498,500,505,496,498,0
3018,2023-11-15,UNTR,23250,23300,23900,23300,23400,150
3019,2023-11-15,UNVR,3480,3500,3530,3410,3430,-50
3020,2023-11-16,ACES,835,840,840,820,830,-5
3021,2023-11-16,AMRT,2900,2900,2920,2860,2900,0
3022,2023-11-16,ASII,5750,5750,5825,5725,5825,75
3023,2023-11-16,HRUM,1450,1455,1465,1435,1440,-10
3024,2023-11-16,INKP,8475,8500,8675,8400,8675,200
3025,2023-11-16,INTP,9425,9425,9425,9325,9400,-25
3026,2023-11-16,MAPI,1685,1695,1695,1635,1640,-45
3027,2023-11-16,SIDO,498,498,500,498,498,0
3028,2023-11-16,UNTR,23400,23425,23600,23050,23450,50
3029,2023-11-16,UNVR,3430,3440,3460,3420,3460,30
3030,2023-11-17,ACES,830,830,830,815,815,-15
3031,2023-11-17,AMRT,2900,2900,2910,2870,2890,-10
3032,2023-11-17,ASII,5825,5800,5825,5700,5700,-125
3033,2023-11-17,HRUM,1440,1430,1445,1405,1410,-30
3034,2023-11-17,INKP,8675,8650,8675,8500,8500,-175
3035,2023-11-17,INTP,9400,9400,9500,9375,9450,50
3036,2023-11-17,MAPI,1640,1640,1665,1615,1660,20
3037,2023-11-17,SIDO,498,500,500,494,498,0
3038,2023-11-17,UNTR,23450,23450,23450,22800,22875,-575
3039,2023-11-17,UNVR,3460,3470,3470,3420,3470,10
3040,2023-11-20,ACES,815,820,835,815,830,15
3041,2023-11-20,AMRT,2890,2910,2940,2890,2900,10
3042,2023-11-20,ASII,5700,5725,5850,5700,5800,100
3043,2023-11-20,HRUM,1410,1415,1440,1410,1415,5
3044,2023-11-20,INKP,8500,8475,8600,8475,8500,0
3045,2023-11-20,INTP,9450,9450,9625,9400,9550,100
3046,2023-11-20,MAPI,1660,1660,1675,1630,1650,-10
3047,2023-11-20,SIDO,498,500,505,498,505,7
3048,2023-11-20,UNTR,22875,22900,23000,22750,22950,75
3049,2023-11-20,UNVR,3470,3470,3470,3420,3460,-10
3050,2023-11-21,ACES,830,830,855,820,820,-10
3051,2023-11-21,AMRT,2900,2910,2930,2830,2900,0
3052,2023-11-21,ASII,5800,5800,5850,5750,5775,-25
3053,2023-11-21,HRUM,1415,1415,1425,1405,1420,5
3054,2023-11-21,INKP,8500,8550,8700,8525,8650,150
3055,2023-11-21,INTP,9550,9600,9600,9300,9350,-200
3056,2023-11-21,MAPI,1650,1650,1665,1635,1645,-5
3057,2023-11-21,SIDO,505,500,505,498,500,-5
3058,2023-11-21,UNTR,22950,22950,22950,22700,22775,-175
3059,2023-11-21,UNVR,3460,3460,3490,3430,3480,20
3060,2023-11-22,ACES,820,825,830,815,815,-5
3061,2023-11-22,AMRT,2900,2900,2940,2860,2880,-20
3062,2023-11-22,ASII,5775,5775,5775,5650,5675,-100
3063,2023-11-22,HRUM,1420,1420,1440,1410,1435,15
3064,2023-11-22,INKP,8650,8625,8650,8475,8550,-100
3065,2023-11-22,INTP,9350,9375,9400,9225,9250,-100
3066,2023-11-22,MAPI,1645,1655,1680,1620,1675,30
3067,2023-11-22,SIDO,500,500,500,496,498,-2
3068,2023-11-22,UNTR,22775,22775,22775,22275,22325,-450
3069,2023-11-22,UNVR,3480,3480,3520,3450,3500,20
3070,2023-11-23,ACES,815,820,825,805,810,-5
3071,2023-11-23,AMRT,2880,2900,2920,2880,2890,10
3072,2023-11-23,ASII,5675,5675,5725,5675,5700,25
3073,2023-11-23,HRUM,1435,1430,1435,1405,1415,-20
3074,2023-11-23,INKP,8550,8550,8550,8300,8450,-100
3075,2023-11-23,INTP,9250,9225,9400,9225,9250,0
3076,2023-11-23,MAPI,1675,1675,1760,1665,1745,70
3077,2023-11-23,SIDO,498,498,500,498,498,0
3078,2023-11-23,UNTR,22325,22500,22575,22325,22525,200
3079,2023-11-23,UNVR,3500,3510,3580,3500,3540,40
3080,2023-11-24,ACES,810,815,820,760,815,5
3081,2023-11-24,AMRT,2890,2890,2910,2860,2870,-20
3082,2023-11-24,ASII,5700,5700,5750,5700,5725,25
3083,2023-11-24,HRUM,1415,1415,1460,1405,1440,25
3084,2023-11-24,INKP,8450,8450,8450,8350,8450,0
3085,2023-11-24,INTP,9250,9250,9325,9200,9275,25
3086,2023-11-24,MAPI,1745,1740,1800,1740,1785,40
3087,2023-11-24,SIDO,498,498,500,498,498,0
3088,2023-11-24,UNTR,22525,22575,22650,22475,22625,100
3089,2023-11-24,UNVR,3540,3550,3580,3520,3530,-10
3090,2023-11-27,ACES,815,815,815,795,800,-15
3091,2023-11-27,AMRT,2870,2900,2900,2840,2860,-10
3092,2023-11-27,ASII,5725,5725,5750,5600,5625,-100
3093,2023-11-27,HRUM,1440,1445,1475,1435,1445,5
3094,2023-11-27,INKP,8450,8425,8425,8325,8350,-100
3095,2023-11-27,INTP,9275,9300,9425,9250,9250,-25
3096,2023-11-27,MAPI,1785,1800,1815,1765,1780,-5
3097,2023-11-27,SIDO,498,500,505,498,500,2
3098,2023-11-27,UNTR,22625,22625,22875,22450,22450,-175
3099,2023-11-27,UNVR,3530,3530,3550,3500,3520,-10
3100,2023-11-28,ACES,800,805,810,770,775,-25
3101,2023-11-28,AMRT,2860,2860,2900,2850,2870,10
3102,2023-11-28,ASII,5625,5675,5675,5550,5550,-75
3103,2023-11-28,HRUM,1445,1450,1470,1435,1455,10
3104,2023-11-28,INKP,8350,8350,8525,8350,8450,100
3105,2023-11-28,INTP,9250,9300,9375,9250,9275,25
3106,2023-11-28,MAPI,1780,1780,1795,1720,1735,-45
3107,2023-11-28,SIDO,500,500,505,496,498,-2
3108,2023-11-28,UNTR,22450,22500,22725,22325,22500,50
3109,2023-11-28,UNVR,3520,3520,3640,3520,3600,80
3110,2023-11-29,ACES,775,780,785,750,770,-5
3111,2023-11-29,AMRT,2870,2870,2900,2800,2810,-60
3112,2023-11-29,ASII,5550,5600,5650,5525,5525,-25
3113,2023-11-29,HRUM,1455,1425,1470,1420,1435,-20
3114,2023-11-29,INKP,8450,8525,8875,8525,8800,350
3115,2023-11-29,INTP,9275,9375,9425,9300,9400,125
3116,2023-11-29,MAPI,1735,1735,1740,1710,1730,-5
3117,2023-11-29,SIDO,498,500,500,496,498,0
3118,2023-11-29,UNTR,22500,22600,22600,22300,22450,-50
3119,2023-11-29,UNVR,3600,3600,3640,3560,3630,30
3120,2023-11-30,ACES,770,770,775,740,755,-15
3121,2023-11-30,AMRT,2810,2830,2930,2790,2870,60
3122,2023-11-30,ASII,5525,5575,5575,5400,5400,-125
3123,2023-11-30,HRUM,1435,1435,1445,1380,1385,-50
3124,2023-11-30,INKP,8800,8850,8900,8625,8775,-25
3125,2023-11-30,INTP,9400,9325,10200,9275,10200,800
3126,2023-11-30,MAPI,1730,1740,1765,1695,1745,15
3127,2023-11-30,SIDO,498,500,505,498,500,2
3128,2023-11-30,UNTR,22450,22450,22500,21900,21900,-550
3129,2023-11-30,UNVR,3630,3630,3650,3570,3650,20
3130,2023-12-01,ACES,755,760,760,730,735,-20
3131,2023-12-01,AMRT,2870,2900,2900,2850,2900,30
3132,2023-12-01,ASII,5400,5450,5750,5450,5750,350
3133,2023-12-01,HRUM,1385,1385,1405,1385,1400,15
3134,2023-12-01,INKP,8775,8575,8750,8450,8475,-300
3135,2023-12-01,INTP,10200,9600,9750,9375,9550,-650
3136,2023-12-01,MAPI,1745,1720,1745,1700,1740,-5
3137,2023-12-01,SIDO,500,500,500,496,498,-2
3138,2023-12-01,UNTR,21900,22025,22350,22000,22150,250
3139,2023-12-01,UNVR,3650,3600,3700,3590,3630,-20
3140,2023-12-04,ACES,735,730,750,720,720,-15
3141,2023-12-04,AMRT,2900,2900,2910,2870,2870,-30
3142,2023-12-04,ASII,5750,5750,5825,5725,5750,0
3143,2023-12-04,HRUM,1400,1405,1415,1360,1365,-35
3144,2023-12-04,INKP,8475,8575,8575,8350,8425,-50
3145,2023-12-04,INTP,9550,9475,9500,9350,9350,-200
3146,2023-12-04,MAPI,1740,1730,1735,1640,1670,-70
3147,2023-12-04,SIDO,498,500,545,496,530,32
3148,2023-12-04,UNTR,22150,22200,22675,22200,22425,275
3149,2023-12-04,UNVR,3630,3640,3670,3550,3630,0
3150,2023-12-05,ACES,720,720,730,690,710,-10
3151,2023-12-05,AMRT,2870,2880,2900,2860,2870,0
3152,2023-12-05,ASII,5750,5775,5800,5675,5725,-25
3153,2023-12-05,HRUM,1365,1365,1370,1315,1320,-45
3154,2023-12-05,INKP,8425,8475,8625,8425,8575,150
3155,2023-12-05,INTP,9350,9375,9475,9275,9475,125
3156,2023-12-05,MAPI,1670,1655,1680,1625,1670,0
3157,2023-12-05,SIDO,530,535,575,530,560,30
3158,2023-12-05,UNTR,22425,22425,22450,22025,22050,-375
3159,2023-12-05,UNVR,3630,3590,3620,3570,3620,-10
3160,2023-12-06,ACES,710,715,730,705,730,20
3161,2023-12-06,AMRT,2870,2880,2910,2860,2890,20
3162,2023-12-06,ASII,5725,5700,5825,5700,5725,0
3163,2023-12-06,HRUM,1320,1335,1335,1265,1270,-50
3164,2023-12-06,INKP,8575,8575,8650,8400,8400,-175
3165,2023-12-06,INTP,9475,9425,9550,9425,9500,25
3166,2023-12-06,MAPI,1670,1670,1690,1635,1640,-30
3167,2023-12-06,SIDO,560,560,575,560,570,10
3168,2023-12-06,UNTR,22050,22050,22150,21600,21625,-425
3169,2023-12-06,UNVR,3620,3620,3630,3500,3510,-110
3170,2023-12-07,ACES,730,730,730,670,695,-35
3171,2023-12-07,AMRT,2890,2870,2900,2870,2900,10
3172,2023-12-07,ASII,5725,5750,5750,5600,5675,-50
3173,2023-12-07,HRUM,1270,1285,1300,1240,1265,-5
3174,2023-12-07,INKP,8400,8500,8500,8250,8300,-100
3175,2023-12-07,INTP,9500,9500,9600,9400,9525,25
3176,2023-12-07,MAPI,1640,1640,1650,1605,1640,0
3177,2023-12-07,SIDO,570,570,570,540,550,-20
3178,2023-12-07,UNTR,21625,21675,21850,21425,21700,75
3179,2023-12-07,UNVR,3510,3510,3570,3500,3570,60
3180,2023-12-08,ACES,695,695,710,690,695,0
3181,2023-12-08,AMRT,2900,2890,2890,2770,2850,-50
3182,2023-12-08,ASII,5675,5675,5700,5625,5675,0
3183,2023-12-08,HRUM,1265,1285,1345,1280,1330,65
3184,2023-12-08,INKP,8300,8350,8475,8075,8150,-150
3185,2023-12-08,INTP,9525,9550,9550,9350,9375,-150
3186,2023-12-08,MAPI,1640,1645,1680,1635,1660,20
3187,2023-12-08,SIDO,550,555,555,535,540,-10
3188,2023-12-08,UNTR,21700,21800,22350,21725,22300,600
3189,2023-12-08,UNVR,3570,3570,3570,3490,3510,-60
3190,2023-12-11,ACES,695,700,700,685,690,-5
3191,2023-12-11,AMRT,2850,2850,2850,2720,2800,-50
3192,2023-12-11,ASII,5675,5650,5675,5525,5600,-75
3193,2023-12-11,HRUM,1330,1350,1385,1330,1330,0
3194,2023-12-11,INKP,8150,8200,8200,7800,7800,-350
3195,2023-12-11,INTP,9375,9400,9450,9325,9425,50
3196,2023-12-11,MAPI,1660,1650,1650,1595,1630,-30
3197,2023-12-11,SIDO,540,540,555,530,530,-10
3198,2023-12-11,UNTR,22300,22425,22450,21825,21825,-475
3199,2023-12-11,UNVR,3510,3500,3510,3470,3500,-10
3200,2023-12-12,ACES,690,690,710,685,685,-5
3201,2023-12-12,AMRT,2800,2800,2870,2770,2850,50
3202,2023-12-12,ASII,5600,5675,5675,5550,5575,-25
3203,2023-12-12,HRUM,1330,1335,1345,1290,1310,-20
3204,2023-12-12,INKP,7800,7825,8150,7775,8075,275
3205,2023-12-12,INTP,9425,9425,9550,9325,9400,-25
3206,2023-12-12,MAPI,1630,1630,1630,1560,1615,-15
3207,2023-12-12,SIDO,530,530,540,520,530,0
3208,2023-12-12,UNTR,21825,22000,22025,21850,21850,25
3209,2023-12-12,UNVR,3500,3500,3510,3420,3430,-70
3210,2023-12-13,ACES,685,690,690,665,680,-5
3211,2023-12-13,AMRT,2850,2850,2880,2810,2880,30
3212,2023-12-13,ASII,5575,5550,5600,5525,5525,-50
3213,2023-12-13,HRUM,1310,1300,1300,1265,1280,-30
3214,2023-12-13,INKP,8075,8075,8100,7925,8000,-75
3215,2023-12-13,INTP,9400,9375,9375,9175,9300,-100
3216,2023-12-13,MAPI,1615,1625,1655,1600,1620,5
3217,2023-12-13,SIDO,530,530,565,525,550,20
3218,2023-12-13,UNTR,21850,21700,21725,20925,20925,-925
3219,2023-12-13,UNVR,3430,3430,3460,3400,3450,20
3220,2023-12-14,ACES,680,685,700,680,680,0
3221,2023-12-14,AMRT,2880,2890,2910,2840,2900,20
3222,2023-12-14,ASII,5525,5600,5650,5575,5625,100
3223,2023-12-14,HRUM,1280,1295,1335,1285,1320,40
3224,2023-12-14,INKP,8000,8025,8050,7850,7850,-150
3225,2023-12-14,INTP,9300,9300,9375,9275,9300,0
3226,2023-12-14,MAPI,1620,1645,1725,1640,1720,100
3227,2023-12-14,SIDO,550,550,565,550,555,5
3228,2023-12-14,UNTR,20925,21075,21675,21000,21450,525
3229,2023-12-14,UNVR,3450,3450,3450,3400,3400,-50
3230,2023-12-15,ACES,680,685,690,675,685,5
3231,2023-12-15,AMRT,2900,2860,2880,2770,2800,-100
3232,2023-12-15,ASII,5625,5625,5700,5600,5650,25
3233,2023-12-15,HRUM,1320,1335,1355,1320,1330,10
3234,2023-12-15,INKP,7850,7850,8075,7850,7975,125
3235,2023-12-15,INTP,9300,9300,9425,9275,9300,0
3236,2023-12-15,MAPI,1720,1710,1720,1655,1675,-45
3237,2023-12-15,SIDO,555,560,560,540,545,-10
3238,2023-12-15,UNTR,21450,21500,21950,21275,21275,-175
3239,2023-12-15,UNVR,3400,3400,3500,3330,3500,100
3240,2023-12-18,ACES,685,695,740,690,715,30
3241,2023-12-18,AMRT,2800,2750,2750,2530,2730,-70
3242,2023-12-18,ASII,5650,5650,5650,5550,5600,-50
3243,2023-12-18,HRUM,1330,1340,1360,1300,1305,-25
3244,2023-12-18,INKP,7975,7975,8150,7975,8025,50
3245,2023-12-18,INTP,9300,9250,9350,9250,9300,0
3246,2023-12-18,MAPI,1675,1680,1685,1645,1675,0
3247,2023-12-18,SIDO,545,550,550,540,545,0
3248,2023-12-18,UNTR,21275,21425,21850,21375,21800,525
3249,2023-12-18,UNVR,3500,3480,3480,3380,3410,-90
3250,2023-12-19,ACES,715,720,750,705,740,25
3251,2023-12-19,AMRT,2730,2730,2820,2700,2820,90
3252,2023-12-19,ASII,5600,5625,5650,5600,5625,25
3253,2023-12-19,HRUM,1305,1305,1315,1290,1305,0
3254,2023-12-19,INKP,8025,8100,8100,7900,7925,-100
3255,2023-12-19,INTP,9300,9300,9375,9200,9200,-100
3256,2023-12-19,MAPI,1675,1675,1710,1665,1700,25
3257,2023-12-19,SIDO,545,545,560,545,555,10
3258,2023-12-19,UNTR,21800,21750,21825,21450,21825,25
3259,2023-12-19,UNVR,3410,3410,3440,3380,3430,20
3260,2023-12-20,ACES,740,740,750,720,720,-20
3261,2023-12-20,AMRT,2820,2820,2830,2800,2820,0
3262,2023-12-20,ASII,5625,5650,5700,5625,5625,0
3263,2023-12-20,HRUM,1305,1315,1340,1305,1315,10
3264,2023-12-20,INKP,7925,7925,8575,7925,8400,475
3265,2023-12-20,INTP,9200,9250,9325,9150,9150,-50
3266,2023-12-20,MAPI,1700,1720,1740,1695,1715,15
3267,2023-12-20,SIDO,555,555,560,540,545,-10
3268,2023-12-20,UNTR,21825,21875,22250,21800,21800,-25
3269,2023-12-20,UNVR,3430,3430,3520,3420,3460,30
3270,2023-12-21,ACES,720,725,730,715,725,5
3271,2023-12-21,AMRT,2820,2820,2880,2820,2880,60
3272,2023-12-21,ASII,5625,5600,5600,5475,5550,-75
3273,2023-12-21,HRUM,1315,1305,1325,1290,1310,-5
3274,2023-12-21,INKP,8400,8400,8450,8275,8325,-75
3275,2023-12-21,INTP,9150,9175,9250,9125,9150,0
3276,2023-12-21,MAPI,1715,1715,1720,1690,1715,0
3277,2023-12-21,SIDO,545,545,550,530,535,-10
3278,2023-12-21,UNTR,21800,21800,22075,21775,22000,200
3279,2023-12-21,UNVR,3460,3470,3480,3440,3470,10
3280,2023-12-22,ACES,725,730,735,715,720,-5
3281,2023-12-22,AMRT,2880,2870,2880,2820,2870,-10
3282,2023-12-22,ASII,5550,5550,5600,5500,5550,0
3283,2023-12-22,HRUM,1310,1310,1320,1295,1305,-5
3284,2023-12-22,INKP,8325,8325,8475,8300,8350,25
3285,2023-12-22,INTP,9150,9200,9325,9175,9275,125
3286,2023-12-22,MAPI,1715,1720,1785,1720,1765,50
3287,2023-12-22,SIDO,535,535,545,535,540,5
3288,2023-12-22,UNTR,22000,22050,22150,21850,22025,25
3289,2023-12-22,UNVR,3470,3470,3490,3440,3470,0
3290,2023-12-27,ACES,720,720,740,715,725,5
3291,2023-12-27,AMRT,2870,2870,2900,2850,2870,0
3292,2023-12-27,ASII,5550,5550,5575,5500,5550,0
3293,2023-12-27,HRUM,1305,1305,1360,1295,1350,45
3294,2023-12-27,INKP,8350,8350,8400,8225,8250,-100
3295,2023-12-27,INTP,9275,9300,9375,9225,9275,0
3296,2023-12-27,MAPI,1765,1765,1780,1740,1750,-15
3297,2023-12-27,SIDO,540,540,545,525,525,-15
3298,2023-12-27,UNTR,22025,22025,22625,21975,22425,400
3299,2023-12-27,UNVR,3470,3470,3520,3450,3470,0
3300,2023-12-28,ACES,725,730,735,705,715,-10
3301,2023-12-28,AMRT,2870,2890,2930,2870,2910,40
3302,2023-12-28,ASII,5550,5575,5600,5550,5600,50
3303,2023-12-28,HRUM,1350,1370,1380,1335,1345,-5
3304,2023-12-28,INKP,8250,8300,8450,8275,8375,125
3305,2023-12-28,INTP,9275,9325,9475,9300,9400,125
3306,2023-12-28,MAPI,1750,1750,1775,1745,1765,15
3307,2023-12-28,SIDO,525,530,535,525,530,5
3308,2023-12-28,UNTR,22425,22525,22775,22450,22700,275
3309,2023-12-28,UNVR,3470,3500,3570,3500,3540,70
3310,2023-12-29,ACES,715,715,720,705,720,5
3311,2023-12-29,AMRT,2910,2910,2950,2870,2930,20
3312,2023-12-29,ASII,5600,5600,5675,5575,5650,50
3313,2023-12-29,HRUM,1345,1345,1350,1325,1335,-10
3314,2023-12-29,INKP,8375,8375,8425,8300,8325,-50
3315,2023-12-29,INTP,9400,9425,9450,9325,9400,0
3316,2023-12-29,MAPI,1765,1765,1830,1765,1790,25
3317,2023-12-29,SIDO,530,530,530,520,525,-5
3318,2023-12-29,UNTR,22700,22700,22750,22500,22625,-75
3319,2023-12-29,UNVR,3540,3540,3550,3500,3530,-10
3320,2022-01-03,ACES,1280,1285,1385,1285,1380,100
3321,2022-01-03,AMRT,1215,0,1245,1200,1230,15
3322,2022-01-03,ASII,5700,5675,5750,5625,5725,25
3323,2022-01-03,HRUM,10325,0,10650,9900,10500,175
3324,2022-01-03,INKP,7825,7825,8250,7825,8100,275
3325,2022-01-03,INTP,12100,12000,12050,11650,11700,-400
3326,2022-01-03,MAPI,710,0,730,700,700,-10
3327,2022-01-03,SIDO,865,0,875,865,870,5
3328,2022-01-03,UNTR,22150,21900,22125,21750,21825,-325
3329,2022-01-03,UNVR,4110,4120,4340,4120,4230,120
3330,2022-01-04,ACES,1380,1380,1380,1345,1365,-15
3331,2022-01-04,AMRT,1230,0,1245,1185,1195,-35
3332,2022-01-04,ASII,5725,5750,5875,5725,5775,50
3333,2022-01-04,HRUM,10500,0,10700,10275,10500,0
3334,2022-01-04,INKP,8100,8125,8250,8050,8075,-25
3335,2022-01-04,INTP,11700,11700,11850,11450,11475,-225
3336,2022-01-04,MAPI,700,0,785,700,775,75
3337,2022-01-04,SIDO,870,0,910,865,900,30
3338,2022-01-04,UNTR,21825,21850,22125,21800,21925,100
3339,2022-01-04,UNVR,4230,4250,4310,4230,4250,20
3340,2022-01-05,ACES,1365,1365,1395,1350,1385,20
3341,2022-01-05,AMRT,1195,0,1210,1180,1200,5
3342,2022-01-05,ASII,5775,5725,5775,5550,5575,-200
3343,2022-01-05,HRUM,10500,0,10975,10275,10300,-200
3344,2022-01-05,INKP,8075,8100,8400,8100,8125,50
3345,2022-01-05,INTP,11475,11475,11575,11275,11300,-175
3346,2022-01-05,MAPI,775,0,785,750,780,5
3347,2022-01-05,SIDO,900,0,915,900,910,10
3348,2022-01-05,UNTR,21925,21925,22450,21725,21950,25
3349,2022-01-05,UNVR,4250,4260,4270,4180,4210,-40
3350,2022-01-06,ACES,1385,1380,1385,1335,1360,-25
3351,2022-01-06,AMRT,1200,0,1200,1135,1155,-45
3352,2022-01-06,ASII,5575,5600,5675,5575,5675,100
3353,2022-01-06,HRUM,10300,0,10425,9600,10000,-300
3354,2022-01-06,INKP,8125,8100,8350,7925,8300,175
3355,2022-01-06,INTP,11300,11275,11300,10975,11150,-150
3356,2022-01-06,MAPI,780,0,785,740,765,-15
3357,2022-01-06,SIDO,910,0,930,910,925,15
3358,2022-01-06,UNTR,21950,21850,21950,21450,21725,-225
3359,2022-01-06,UNVR,4210,4210,4240,4180,4230,20
3360,2022-01-07,ACES,1360,1370,1390,1350,1380,20
3361,2022-01-07,AMRT,1155,0,1170,1145,1155,0
3362,2022-01-07,ASII,5675,5725,5750,5650,5700,25
3363,2022-01-07,HRUM,10000,0,10700,10025,10625,625
3364,2022-01-07,INKP,8300,8350,8550,8200,8500,200
3365,2022-01-07,INTP,11150,11150,11200,10950,10950,-200
3366,2022-01-07,MAPI,765,0,775,750,765,0
3367,2022-01-07,SIDO,925,0,970,925,950,25
3368,2022-01-07,UNTR,21725,21900,22375,21750,22175,450
3369,2022-01-07,UNVR,4230,4230,4240,4200,4220,-10
3370,2022-01-10,ACES,1380,1380,1390,1365,1385,5
3371,2022-01-10,AMRT,1155,0,1165,1130,1130,-25
3372,2022-01-10,ASII,5700,5675,5725,5650,5650,-50
3373,2022-01-10,HRUM,10625,0,10875,10400,10750,125
3374,2022-01-10,INKP,8500,8575,8600,8400,8500,0
3375,2022-01-10,INTP,10950,10950,11100,10925,10925,-25
3376,2022-01-10,MAPI,765,0,770,750,760,-5
3377,2022-01-10,SIDO,950,0,975,945,970,20
3378,2022-01-10,UNTR,22175,22300,22300,21800,21800,-375
3379,2022-01-10,UNVR,4220,4220,4290,4200,4250,30
3380,2022-01-11,ACES,1385,1385,1390,1315,1315,-70
3381,2022-01-11,AMRT,1130,0,1140,1075,1095,-35
3382,2022-01-11,ASII,5650,5700,5700,5650,5700,50
3383,2022-01-11,HRUM,10750,0,11500,10675,10900,150
3384,2022-01-11,INKP,8500,8500,8500,8250,8275,-225
3385,2022-01-11,INTP,10925,10950,11050,10825,10925,0
3386,2022-01-11,MAPI,760,0,775,745,755,-5
3387,2022-01-11,SIDO,970,0,985,940,955,-15
3388,2022-01-11,UNTR,21800,22050,22175,21750,21750,-50
3389,2022-01-11,UNVR,4250,4260,4270,4150,4180,-70
3390,2022-01-12,ACES,1315,1330,1360,1300,1325,10
3391,2022-01-12,AMRT,1095,0,1105,1090,1095,0
3392,2022-01-12,ASII,5700,5725,5725,5650,5725,25
3393,2022-01-12,HRUM,10900,0,11675,11000,11600,700
3394,2022-01-12,INKP,8275,8375,8475,8275,8425,150
3395,2022-01-12,INTP,10925,10950,11050,10850,11000,75
3396,2022-01-12,MAPI,755,0,765,740,745,-10
3397,2022-01-12,SIDO,955,0,960,940,950,-5
3398,2022-01-12,UNTR,21750,22000,22275,21750,22100,350
3399,2022-01-12,UNVR,4180,4200,4340,4180,4330,150
3400,2022-01-13,ACES,1325,1325,1370,1325,1355,30
3401,2022-01-13,AMRT,1095,0,1105,1090,1095,0
3402,2022-01-13,ASII,5725,5725,5775,5675,5775,50
3403,2022-01-13,HRUM,11600,0,11850,10850,10900,-700
3404,2022-01-13,INKP,8425,8475,8525,8325,8475,50
3405,2022-01-13,INTP,11000,11000,11100,10975,11075,75
3406,2022-01-13,MAPI,745,0,750,740,745,0
3407,2022-01-13,SIDO,950,0,960,935,935,-15
3408,2022-01-13,UNTR,22100,22075,22675,21925,22675,575
3409,2022-01-13,UNVR,4330,4330,4340,4240,4270,-60
3410,2022-01-14,ACES,1355,1355,1370,1345,1370,15
3411,2022-01-14,AMRT,1095,0,1100,1085,1090,-5
3412,2022-01-14,ASII,5775,5775,5800,5700,5725,-50
3413,2022-01-14,HRUM,10900,0,11075,10725,11000,100
3414,2022-01-14,INKP,8475,8475,8500,8325,8425,-50
3415,2022-01-14,INTP,11075,11075,11075,10975,11075,0
3416,2022-01-14,MAPI,745,0,790,735,790,45
3417,2022-01-14,SIDO,935,0,960,935,935,0
3418,2022-01-14,UNTR,22675,22575,23550,22475,23525,850
3419,2022-01-14,UNVR,4270,4280,4280,4210,4220,-50
3420,2022-01-17,ACES,1370,1370,1375,1345,1350,-20
3421,2022-01-17,AMRT,1090,0,1110,1085,1095,5
3422,2022-01-17,ASII,5725,5775,5775,5650,5675,-50
3423,2022-01-17,HRUM,11000,0,11325,10650,10900,-100
3424,2022-01-17,INKP,8425,8450,8475,8250,8325,-100
3425,2022-01-17,INTP,11075,11075,11075,10825,10875,-200
3426,2022-01-17,MAPI,790,0,800,760,765,-25
3427,2022-01-17,SIDO,935,0,950,935,945,10
3428,2022-01-17,UNTR,23525,23550,23900,23425,23500,-25
3429,2022-01-17,UNVR,4220,4240,4240,4140,4150,-70
3430,2022-01-18,ACES,1350,1350,1370,1335,1345,-5
3431,2022-01-18,AMRT,1095,0,1105,1085,1095,0
3432,2022-01-18,ASII,5675,5675,5725,5575,5650,-25
3433,2022-01-18,HRUM,10900,0,11100,10250,10500,-400
3434,2022-01-18,INKP,8325,8325,8350,7850,7975,-350
3435,2022-01-18,INTP,10875,10875,11000,10700,10875,0
3436,2022-01-18,MAPI,765,0,780,750,765,0
3437,2022-01-18,SIDO,945,0,955,935,950,5
3438,2022-01-18,UNTR,23500,23500,23700,23050,23650,150
3439,2022-01-18,UNVR,4150,4160,4230,4070,4110,-40
3440,2022-01-19,ACES,1345,1345,1350,1310,1340,-5
3441,2022-01-19,AMRT,1095,0,1120,1095,1120,25
3442,2022-01-19,ASII,5650,5650,5675,5575,5600,-50
3443,2022-01-19,HRUM,10500,0,11050,10400,10875,375
3444,2022-01-19,INKP,7975,7950,7950,7475,7500,-475
3445,2022-01-19,INTP,10875,10875,11000,10650,10675,-200
3446,2022-01-19,MAPI,765,0,775,725,750,-15
3447,2022-01-19,SIDO,950,0,965,945,950,0
3448,2022-01-19,UNTR,23650,23650,23700,23250,23250,-400
3449,2022-01-19,UNVR,4110,4110,4110,4080,4100,-10
3450,2022-01-20,ACES,1340,1340,1340,1300,1300,-40
3451,2022-01-20,AMRT,1120,0,1130,1090,1100,-20
3452,2022-01-20,ASII,5600,5600,5625,5500,5525,-75
3453,2022-01-20,HRUM,10875,0,11200,10900,11125,250
3454,2022-01-20,INKP,7500,7550,7650,7500,7575,75
3455,2022-01-20,INTP,10675,10675,10900,10600,10750,75
3456,2022-01-20,MAPI,750,0,760,745,750,0
3457,2022-01-20,SIDO,950,0,955,940,940,-10
3458,2022-01-20,UNTR,23250,23100,23475,22675,22850,-400
3459,2022-01-20,UNVR,4100,4100,4120,4070,4100,0
3460,2022-01-21,ACES,1300,1290,1300,1270,1275,-25
3461,2022-01-21,AMRT,1100,0,1110,1085,1095,-5
3462,2022-01-21,ASII,5525,5525,5625,5500,5600,75
3463,2022-01-21,HRUM,11125,0,11200,10875,10975,-150
3464,2022-01-21,INKP,7575,7575,7900,7400,7900,325
3465,2022-01-21,INTP,10750,10625,10850,10625,10775,25
3466,2022-01-21,MAPI,750,0,765,735,750,0
3467,2022-01-21,SIDO,940,0,945,935,935,-5
3468,2022-01-21,UNTR,22850,22850,23500,22725,23500,650
3469,2022-01-21,UNVR,4100,4090,4150,4080,4150,50
3470,2022-01-24,ACES,1275,1280,1295,1270,1270,-5
3471,2022-01-24,AMRT,1095,0,1105,1035,1055,-40
3472,2022-01-24,ASII,5600,5600,5625,5525,5525,-75
3473,2022-01-24,HRUM,10975,0,11100,10475,10700,-275
3474,2022-01-24,INKP,7900,7875,7875,7675,7700,-200
3475,2022-01-24,INTP,10775,10750,11125,10750,11125,350
3476,2022-01-24,MAPI,750,0,755,725,750,0
3477,2022-01-24,SIDO,935,0,945,930,935,0
3478,2022-01-24,UNTR,23500,23650,23650,23225,23400,-100
3479,2022-01-24,UNVR,4150,4130,4140,4080,4080,-70
3480,2022-01-25,ACES,1270,1270,1285,1250,1250,-20
3481,2022-01-25,AMRT,1055,0,1075,1020,1020,-35
3482,2022-01-25,ASII,5525,5500,5500,5375,5450,-75
3483,2022-01-25,HRUM,10700,0,10725,10075,10250,-450
3484,2022-01-25,INKP,7700,7650,7725,7500,7650,-50
3485,2022-01-25,INTP,11125,11000,11025,10800,10950,-175
3486,2022-01-25,MAPI,750,0,760,725,735,-15
3487,2022-01-25,SIDO,935,0,940,925,940,5
3488,2022-01-25,UNTR,23400,23400,23450,23000,23150,-250
3489,2022-01-25,UNVR,4080,4100,4110,4010,4060,-20
3490,2022-01-26,ACES,1250,1250,1255,1190,1200,-50
3491,2022-01-26,AMRT,1020,0,1185,1050,1155,135
3492,2022-01-26,ASII,5450,5500,5500,5425,5450,0
3493,2022-01-26,HRUM,10250,0,10800,10125,10675,425
3494,2022-01-26,INKP,7650,7700,7725,7550,7625,-25
3495,2022-01-26,INTP,10950,10950,11050,10850,11050,100
3496,2022-01-26,MAPI,735,0,755,735,755,20
3497,2022-01-26,SIDO,940,0,950,930,940,0
3498,2022-01-26,UNTR,23150,23175,23425,22750,22775,-375
3499,2022-01-26,UNVR,4060,4060,4130,4050,4130,70
3500,2022-01-27,ACES,1200,1210,1255,1200,1255,55
3501,2022-01-27,AMRT,1155,0,1230,1115,1215,60
3502,2022-01-27,ASII,5450,5425,5525,5400,5475,25
3503,2022-01-27,HRUM,10675,0,11075,10600,10925,250
3504,2022-01-27,INKP,7625,7650,7650,7475,7525,-100
3505,2022-01-27,INTP,11050,11050,11050,10850,10900,-150
3506,2022-01-27,MAPI,755,0,755,730,735,-20
3507,2022-01-27,SIDO,940,0,945,920,925,-15
3508,2022-01-27,UNTR,22775,22725,23275,22525,23250,475
3509,2022-01-27,UNVR,4130,4120,4120,4050,4060,-70
3510,2022-01-28,ACES,1255,1260,1270,1245,1260,5
3511,2022-01-28,AMRT,1215,0,1240,1150,1205,-10
3512,2022-01-28,ASII,5475,5475,5525,5450,5475,0
3513,2022-01-28,HRUM,10925,0,11200,10625,10925,0
3514,2022-01-28,INKP,7525,7575,7600,7500,7500,-25
3515,2022-01-28,INTP,10900,10825,11025,10750,10950,50
3516,2022-01-28,MAPI,735,0,750,730,750,15
3517,2022-01-28,SIDO,925,0,940,915,925,0
3518,2022-01-28,UNTR,23250,23250,23350,23100,23250,0
3519,2022-01-28,UNVR,4060,4060,4090,4030,4050,-10
3520,2022-01-31,ACES,1260,1260,1265,1220,1235,-25
3521,2022-01-31,AMRT,1205,0,1210,1160,1165,-40
3522,2022-01-31,ASII,5475,5475,5550,5450,5475,0
3523,2022-01-31,HRUM,10925,0,11175,10475,10625,-300
3524,2022-01-31,INKP,7500,7575,7725,7525,7600,100
3525,2022-01-31,INTP,10950,10975,11025,10800,10950,0
3526,2022-01-31,MAPI,750,0,805,725,780,30
3527,2022-01-31,SIDO,925,0,940,925,930,5
3528,2022-01-31,UNTR,23250,23475,23500,23125,23125,-125
3529,2022-01-31,UNVR,4050,4060,4080,4000,4030,-20
3530,2022-02-02,ACES,1235,0,1290,1235,1270,35
3531,2022-02-02,AMRT,1165,1160,1270,1155,1265,100
3532,2022-02-02,ASII,5475,5500,5525,5425,5500,25
3533,2022-02-02,HRUM,10625,10650,10850,10500,10650,25
3534,2022-02-02,INKP,7600,7600,7825,7600,7700,100
3535,2022-02-02,INTP,10950,10950,11100,10925,11000,50
3536,2022-02-02,MAPI,780,0,810,765,805,25
3537,2022-02-02,SIDO,930,0,940,930,940,10
3538,2022-02-02,UNTR,23125,23075,23075,22650,22925,-200
3539,2022-02-02,UNVR,4030,4030,4060,4010,4050,20
3540,2022-02-03,ACES,1270,0,1275,1255,1255,-15
3541,2022-02-03,AMRT,1265,1265,1270,1215,1250,-15
3542,2022-02-03,ASII,5500,5500,5550,5450,5500,0
3543,2022-02-03,HRUM,10650,10650,10675,10275,10400,-250
3544,2022-02-03,INKP,7700,7700,7725,7525,7525,-175
3545,2022-02-03,INTP,11000,11000,11025,10725,10900,-100
3546,2022-02-03,MAPI,805,0,820,770,790,-15
3547,2022-02-03,SIDO,940,0,940,930,935,-5
3548,2022-02-03,UNTR,22925,22725,22925,22250,22825,-100
3549,2022-02-03,UNVR,4050,4050,4050,4000,4010,-40
3550,2022-02-04,ACES,1255,0,1300,1260,1285,30
3551,2022-02-04,AMRT,1250,1250,1280,1215,1230,-20
3552,2022-02-04,ASII,5500,5525,5525,5475,5500,0
3553,2022-02-04,HRUM,10400,10400,10550,10375,10450,50
3554,2022-02-04,INKP,7525,7525,7675,7475,7525,0
3555,2022-02-04,INTP,10900,10900,11200,10825,10875,-25
3556,2022-02-04,MAPI,790,0,785,755,760,-30
3557,2022-02-04,SIDO,935,0,940,920,920,-15
3558,2022-02-04,UNTR,22825,22825,22825,22375,22500,-325
3559,2022-02-04,UNVR,4010,4020,4040,3990,4020,10
3560,2022-02-07,ACES,1285,0,1305,1270,1275,-10
3561,2022-02-07,AMRT,1230,1240,1265,1230,1245,15
3562,2022-02-07,ASII,5500,5500,5525,5450,5475,-25
3563,2022-02-07,HRUM,10450,10500,10625,10125,10150,-300
3564,2022-02-07,INKP,7525,7525,7850,7500,7800,275
3565,2022-02-07,INTP,10875,10900,11175,10850,11175,300
3566,2022-02-07,MAPI,760,0,760,735,740,-20
3567,2022-02-07,SIDO,920,0,940,920,925,5
3568,2022-02-07,UNTR,22500,22550,22950,22425,22600,100
3569,2022-02-07,UNVR,4020,4020,4050,4000,4000,-20
3570,2022-02-08,ACES,1275,0,1285,1245,1245,-30
3571,2022-02-08,AMRT,1245,1250,1275,1215,1225,-20
3572,2022-02-08,ASII,5475,5525,5700,5500,5550,75
3573,2022-02-08,HRUM,10150,10250,10525,10000,10475,325
3574,2022-02-08,INKP,7800,7800,7875,7600,7600,-200
3575,2022-02-08,INTP,11175,11175,11225,10825,10850,-325
3576,2022-02-08,MAPI,740,0,755,730,740,0
3577,2022-02-08,SIDO,925,0,1000,915,925,0
3578,2022-02-08,UNTR,22600,22700,23225,22100,22175,-425
3579,2022-02-08,UNVR,4000,4000,4080,4000,4000,0
3580,2022-02-09,ACES,1245,0,1250,1215,1220,-25
3581,2022-02-09,AMRT,1225,1240,1295,1230,1270,45
3582,2022-02-09,ASII,5550,5550,5650,5475,5550,0
3583,2022-02-09,HRUM,10475,10475,10550,10175,10225,-250
3584,2022-02-09,INKP,7600,7200,7575,7175,7550,-50
3585,2022-02-09,INTP,10850,11000,11000,10800,10875,25
3586,2022-02-09,MAPI,740,0,790,740,785,45
3587,2022-02-09,SIDO,925,0,940,925,935,10
3588,2022-02-09,UNTR,22175,22425,22950,22400,22675,500
3589,2022-02-09,UNVR,4000,4000,4020,3960,3960,-40
3590,2022-02-10,ACES,1220,0,1240,1210,1230,10
3591,2022-02-10,AMRT,1270,1275,1320,1270,1275,5
3592,2022-02-10,ASII,5550,5575,5625,5450,5450,-100
3593,2022-02-10,HRUM,10225,10325,10400,9750,10025,-200
3594,2022-02-10,INKP,7550,7550,7700,7550,7600,50
3595,2022-02-10,INTP,10875,10875,11100,10850,10850,-25
3596,2022-02-10,MAPI,785,0,820,775,795,10
3597,2022-02-10,SIDO,935,0,950,925,935,0
3598,2022-02-10,UNTR,22675,22700,23200,22650,22800,125
3599,2022-02-10,UNVR,3960,3960,4040,3960,3980,20
3600,2022-02-11,ACES,1230,0,1240,1220,1220,-10
3601,2022-02-11,AMRT,1275,1275,1290,1230,1235,-40
3602,2022-02-11,ASII,5450,5450,5475,5400,5450,0
3603,2022-02-11,HRUM,10025,10025,10050,9850,9950,-75
3604,2022-02-11,INKP,7600,7600,7700,7500,7700,100
3605,2022-02-11,INTP,10850,10850,10950,10750,10925,75
3606,2022-02-11,MAPI,795,0,805,780,785,-10
3607,2022-02-11,SIDO,935,0,945,930,945,10
3608,2022-02-11,UNTR,22800,22775,23050,22600,23050,250
3609,2022-02-11,UNVR,3980,3950,3960,3880,3900,-80
3610,2022-02-14,ACES,1220,0,1230,1210,1210,-10
3611,2022-02-14,AMRT,1235,1235,1240,1195,1225,-10
3612,2022-02-14,ASII,5450,5400,5425,5250,5300,-150
3613,2022-02-14,HRUM,9950,9900,10250,9750,10175,225
3614,2022-02-14,INKP,7700,7675,7675,7500,7575,-125
3615,2022-02-14,INTP,10925,10875,10900,10650,10775,-150
3616,2022-02-14,MAPI,785,0,795,740,750,-35
3617,2022-02-14,SIDO,945,0,960,930,955,10
3618,2022-02-14,UNTR,23050,23050,23625,23000,23450,400
3619,2022-02-14,UNVR,3900,3900,3910,3850,3850,-50
3620,2022-02-15,ACES,1210,0,1255,1215,1245,35
3621,2022-02-15,AMRT,1225,1220,1260,1210,1215,-10
3622,2022-02-15,ASII,5300,5300,5525,5300,5500,200
3623,2022-02-15,HRUM,10175,10250,10575,10225,10500,325
3624,2022-02-15,INKP,7575,7575,7625,7525,7600,25
3625,2022-02-15,INTP,10775,10775,10900,10750,10875,100
3626,2022-02-15,MAPI,750,0,785,725,780,30
3627,2022-02-15,SIDO,955,0,960,940,945,-10
3628,2022-02-15,UNTR,23450,23500,24200,23500,24175,725
3629,2022-02-15,UNVR,3850,3860,3880,3850,3870,20
3630,2022-02-16,ACES,1245,0,1255,1235,1245,0
3631,2022-02-16,AMRT,1215,1225,1230,1185,1190,-25
3632,2022-02-16,ASII,5500,5550,5600,5475,5475,-25
3633,2022-02-16,HRUM,10500,10700,10850,10625,10700,200
3634,2022-02-16,INKP,7600,7650,7800,7625,7750,150
3635,2022-02-16,INTP,10875,10825,11050,10825,10975,100
3636,2022-02-16,MAPI,780,0,825,780,805,25
3637,2022-02-16,SIDO,945,0,955,945,945,0
3638,2022-02-16,UNTR,24175,24175,24225,23800,23800,-375
3639,2022-02-16,UNVR,3870,3880,3920,3870,3870,0
3640,2022-02-17,ACES,1245,0,1255,1215,1225,-20
3641,2022-02-17,AMRT,1190,1190,1210,1155,1165,-25
3642,2022-02-17,ASII,5475,5500,5525,5425,5475,0
3643,2022-02-17,HRUM,10700,10850,10850,10225,10600,-100
3644,2022-02-17,INKP,7750,7800,7825,7625,7650,-100
3645,2022-02-17,INTP,10975,10975,11200,10925,11125,150
3646,2022-02-17,MAPI,805,0,820,790,800,-5
3647,2022-02-17,SIDO,945,0,960,945,955,10
3648,2022-02-17,UNTR,23800,23850,24025,23500,23725,-75
3649,2022-02-17,UNVR,3870,3880,3910,3820,3830,-40
3650,2022-02-18,ACES,1225,0,1260,1215,1245,20
3651,2022-02-18,AMRT,1165,1160,1215,1155,1200,35
3652,2022-02-18,ASII,5475,5450,5625,5425,5600,125
3653,2022-02-18,HRUM,10600,10600,10750,10475,10650,50
3654,2022-02-18,INKP,7650,7600,8025,7600,7925,275
3655,2022-02-18,INTP,11125,11100,11150,10925,10925,-200
3656,2022-02-18,MAPI,800,0,845,790,840,40
3657,2022-02-18,SIDO,955,0,980,955,955,0
3658,2022-02-18,UNTR,23725,23675,24075,23650,23925,200
3659,2022-02-18,UNVR,3830,3840,3900,3840,3850,20
3660,2022-02-21,ACES,1245,0,1245,1205,1205,-40
3661,2022-02-21,AMRT,1200,1200,1200,1155,1160,-40
3662,2022-02-21,ASII,5600,5625,5650,5550,5575,-25
3663,2022-02-21,HRUM,10650,10775,11275,10750,11200,550
3664,2022-02-21,INKP,7925,7925,7975,7725,7875,-50
3665,2022-02-21,INTP,10925,10925,11200,10900,11200,275
3666,2022-02-21,MAPI,840,0,850,800,815,-25
3667,2022-02-21,SIDO,955,0,970,950,955,0
3668,2022-02-21,UNTR,23925,23975,24050,23400,23500,-425
3669,2022-02-21,UNVR,3850,3850,3900,3850,3850,0
3670,2022-02-22,ACES,1205,0,1215,1160,1165,-40
3671,2022-02-22,AMRT,1160,1155,1180,1130,1150,-10
3672,2022-02-22,ASII,5575,5525,5575,5450,5575,0
3673,2022-02-22,HRUM,11200,11325,11800,11200,11325,125
3674,2022-02-22,INKP,7875,7825,7875,7700,7850,-25
3675,2022-02-22,INTP,11200,11200,11200,10925,11150,-50
3676,2022-02-22,MAPI,815,0,815,780,800,-15
3677,2022-02-22,SIDO,955,0,965,950,955,0
3678,2022-02-22,UNTR,23500,23500,23650,22900,23475,-25
3679,2022-02-22,UNVR,3850,3850,3870,3800,3810,-40
3680,2022-02-23,ACES,1165,0,1170,1115,1120,-45
3681,2022-02-23,AMRT,1150,1150,1170,1130,1130,-20
3682,2022-02-23,ASII,5575,5575,5650,5525,5650,75
3683,2022-02-23,HRUM,11325,11600,11750,11350,11675,350
3684,2022-02-23,INKP,7850,7825,8275,7800,8250,400
3685,2022-02-23,INTP,11150,11125,11125,10950,11000,-150
3686,2022-02-23,MAPI,800,0,805,790,800,0
3687,2022-02-23,SIDO,955,0,975,945,950,-5
3688,2022-02-23,UNTR,23475,23500,24000,23200,24000,525
3689,2022-02-23,UNVR,3810,3810,3860,3800,3820,10
3690,2022-02-24,ACES,1120,0,1120,1060,1060,-60
3691,2022-02-24,AMRT,1130,1125,1140,1100,1115,-15
3692,2022-02-24,ASII,5650,5625,5775,5525,5700,50
3693,2022-02-24,HRUM,11675,11800,12475,11500,12400,725
3694,2022-02-24,INKP,8250,8200,8425,7800,7975,-275
3695,2022-02-24,INTP,11000,10950,11075,10425,10475,-525
3696,2022-02-24,MAPI,800,0,800,760,790,-10
3697,2022-02-24,SIDO,950,0,970,945,955,5
3698,2022-02-24,UNTR,24000,24000,25550,23950,25200,1200
3699,2022-02-24,UNVR,3820,3810,3840,3670,3690,-130
3700,2022-02-25,ACES,1060,0,1090,1055,1070,10
3701,2022-02-25,AMRT,1115,1100,1130,1085,1090,-25
3702,2022-02-25,ASII,5700,5700,5800,5650,5800,100
3703,2022-02-25,HRUM,12400,12600,12750,12050,12275,-125
3704,2022-02-25,INKP,7975,7975,8175,7950,8075,100
3705,2022-02-25,INTP,10475,10500,11175,10500,10950,475
3706,2022-02-25,MAPI,790,0,810,780,785,-5
3707,2022-02-25,SIDO,955,0,975,945,975,20
3708,2022-02-25,UNTR,25200,25400,25750,24600,24900,-300
3709,2022-02-25,UNVR,3690,3700,3750,3680,3680,-10
3710,2022-03-01,ACES,1070,0,1110,1070,1110,40
3711,2022-03-01,AMRT,1090,1100,1115,1085,1090,0
3712,2022-03-01,ASII,5800,5800,5950,5700,5700,-100
3713,2022-03-01,HRUM,12275,12400,12575,11750,11800,-475
3714,2022-03-01,INKP,8075,8075,8200,7825,7850,-225
3715,2022-03-01,INTP,10950,11175,11400,10500,10525,-425
3716,2022-03-01,MAPI,785,0,820,780,820,35
3717,2022-03-01,SIDO,975,0,980,965,970,-5
3718,2022-03-01,UNTR,24900,25050,25150,24650,24850,-50
3719,2022-03-01,UNVR,3680,3690,3730,3670,3680,0
3720,2022-03-02,ACES,1110,0,1110,1060,1060,-50
3721,2022-03-02,AMRT,1090,1085,1090,1075,1090,0
3722,2022-03-02,ASII,5700,5650,5700,5500,5525,-175
3723,2022-03-02,HRUM,11800,12150,12200,11300,11600,-200
3724,2022-03-02,INKP,7850,7875,7975,7675,7750,-100
3725,2022-03-02,INTP,10525,10525,10575,10200,10200,-325
3726,2022-03-02,MAPI,820,0,820,795,805,-15
3727,2022-03-02,SIDO,970,0,980,965,965,-5
3728,2022-03-02,UNTR,24850,25200,26250,25175,25525,675
3729,2022-03-02,UNVR,3680,3680,3810,3650,3660,-20
3730,2022-03-04,ACES,1060,0,1070,1015,1025,-35
3731,2022-03-04,AMRT,1090,1100,1110,1080,1085,-5
3732,2022-03-04,ASII,5525,5575,5675,5525,5625,100
3733,2022-03-04,HRUM,11600,12000,12675,12000,12600,1000
3734,2022-03-04,INKP,7750,7750,7800,7525,7675,-75
3735,2022-03-04,INTP,10200,10100,10275,10000,10200,0
3736,2022-03-04,MAPI,805,0,820,795,815,10
3737,2022-03-04,SIDO,965,0,980,950,970,5
3738,2022-03-04,UNTR,25525,26225,27125,25750,27075,1550
3739,2022-03-04,UNVR,3660,3660,3670,3520,3520,-140
3740,2022-03-07,ACES,1025,0,1035,955,960,-65
3741,2022-03-07,AMRT,1085,1080,1150,1055,1145,60
3742,2022-03-07,ASII,5625,5600,5825,5550,5800,175
3743,2022-03-07,HRUM,12600,13050,13900,13050,13750,1150
3744,2022-03-07,INKP,7675,7775,8500,7750,8450,775
3745,2022-03-07,INTP,10200,10150,10375,10000,10200,0
3746,2022-03-07,MAPI,815,0,830,790,800,-15
3747,2022-03-07,SIDO,970,0,985,955,965,-5
3748,2022-03-07,UNTR,27075,27100,27650,27100,27350,275
3749,2022-03-07,UNVR,3520,3500,3510,3400,3430,-90
3750,2022-03-08,ACES,960,0,1015,935,995,35
3751,2022-03-08,AMRT,1145,1145,1155,1065,1070,-75
3752,2022-03-08,ASII,5800,6000,6550,5975,6250,450
3753,2022-03-08,HRUM,13750,14300,14750,12800,12800,-950
3754,2022-03-08,INKP,8450,8550,8750,8025,8025,-425
3755,2022-03-08,INTP,10200,10200,10225,10000,10000,-200
3756,2022-03-08,MAPI,800,0,820,790,800,0
3757,2022-03-08,SIDO,965,0,980,950,950,-15
3758,2022-03-08,UNTR,27350,27400,27750,25700,25700,-1650
3759,2022-03-08,UNVR,3430,3420,3520,3360,3360,-70
3760,2022-03-09,ACES,995,0,1050,995,1045,50
3761,2022-03-09,AMRT,1070,1070,1080,1020,1055,-15
3762,2022-03-09,ASII,6250,6500,6500,6225,6300,50
3763,2022-03-09,HRUM,12800,11925,12000,11925,11925,-875
3764,2022-03-09,INKP,8025,8025,8325,8025,8125,100
3765,2022-03-09,INTP,10000,10000,10150,9925,10050,50
3766,2022-03-09,MAPI,800,0,835,790,805,5
3767,2022-03-09,SIDO,950,0,960,935,935,-15
3768,2022-03-09,UNTR,25700,25950,26800,25950,26400,700
3769,2022-03-09,UNVR,3360,3370,3450,3370,3400,40
3770,2022-03-10,ACES,1045,0,1115,1045,1110,65
3771,2022-03-10,AMRT,1055,1070,1170,1065,1170,115
3772,2022-03-10,ASII,6300,6300,6300,6150,6250,-50
3773,2022-03-10,HRUM,11925,11300,11675,11100,11400,-525
3774,2022-03-10,INKP,8125,8200,8350,8050,8200,75
3775,2022-03-10,INTP,10050,10200,10725,10150,10700,650
3776,2022-03-10,MAPI,805,0,870,810,855,50
3777,2022-03-10,SIDO,935,0,970,940,970,35
3778,2022-03-10,UNTR,26400,26400,26400,24950,25950,-450
3779,2022-03-10,UNVR,3400,3450,3460,3370,3430,30
3780,2022-03-11,ACES,1110,0,1110,1060,1095,-15
3781,2022-03-11,AMRT,1170,1155,1200,1135,1195,25
3782,2022-03-11,ASII,6250,6175,6300,6125,6275,25
3783,2022-03-11,HRUM,11400,11400,11775,11100,11125,-275
3784,2022-03-11,INKP,8200,8250,8300,8100,8225,25
3785,2022-03-11,INTP,10700,10700,10700,10500,10675,-25
3786,2022-03-11,MAPI,855,0,870,840,855,0
3787,2022-03-11,SIDO,970,0,1000,965,1000,30
3788,2022-03-11,UNTR,25950,25625,26900,25600,26700,750
3789,2022-03-11,UNVR,3430,3420,3420,3370,3370,-60
3790,2022-03-14,ACES,1095,0,1105,1075,1100,5
3791,2022-03-14,AMRT,1195,1200,1280,1195,1280,85
3792,2022-03-14,ASII,6275,6350,6425,6300,6375,100
3793,2022-03-14,HRUM,11125,11150,11525,10350,10400,-725
3794,2022-03-14,INKP,8225,8250,8425,8100,8225,0
3795,2022-03-14,INTP,10675,10650,10775,10525,10675,0
3796,2022-03-14,MAPI,855,0,880,840,855,0
3797,2022-03-14,SIDO,1000,0,1035,1000,1020,20
3798,2022-03-14,UNTR,26700,26700,26700,24850,24850,-1850
3799,2022-03-14,UNVR,3370,3380,3410,3370,3380,10
3800,2022-03-15,ACES,1100,0,1125,1035,1060,-40
3801,2022-03-15,AMRT,1280,1280,1335,1265,1295,15
3802,2022-03-15,ASII,6375,6425,6450,6275,6300,-75
3803,2022-03-15,HRUM,10400,10500,10850,10150,10600,200
3804,2022-03-15,INKP,8225,8225,8250,7800,7825,-400
3805,2022-03-15,INTP,10675,10675,10800,10575,10650,-25
3806,2022-03-15,MAPI,855,0,880,815,820,-35
3807,2022-03-15,SIDO,1020,0,1035,1020,1030,10
3808,2022-03-15,UNTR,24850,24850,25175,24400,24475,-375
3809,2022-03-15,UNVR,3380,3400,3440,3280,3280,-100
3810,2022-03-16,ACES,1060,0,1070,1015,1045,-15
3811,2022-03-16,AMRT,1295,1295,1340,1290,1305,10
3812,2022-03-16,ASII,6300,6325,6400,6300,6400,100
3813,2022-03-16,HRUM,10600,10800,11000,10400,10975,375
3814,2022-03-16,INKP,7825,7825,7950,7750,7800,-25
3815,2022-03-16,INTP,10650,10650,10750,10550,10675,25
3816,2022-03-16,MAPI,820,0,830,795,805,-15
3817,2022-03-16,SIDO,1030,0,1070,1030,1040,10
3818,2022-03-16,UNTR,24475,24475,25275,24475,25000,525
3819,2022-03-16,UNVR,3280,3290,3540,3280,3450,170
3820,2022-03-17,ACES,1045,0,1070,1030,1060,15
3821,2022-03-17,AMRT,1305,1315,1380,1315,1345,40
3822,2022-03-17,ASII,6400,6400,6475,6350,6425,25
3823,2022-03-17,HRUM,10975,11050,11075,10500,10500,-475
3824,2022-03-17,INKP,7800,7850,7975,7825,7875,75
3825,2022-03-17,INTP,10675,10675,10900,10675,10800,125
3826,2022-03-17,MAPI,805,0,850,805,835,30
3827,2022-03-17,SIDO,1040,0,1070,1040,1050,10
3828,2022-03-17,UNTR,25000,25225,25725,25125,25250,250
3829,2022-03-17,UNVR,3450,3490,3520,3380,3420,-30
3830,2022-03-18,ACES,1060,0,1070,1000,1000,-60
3831,2022-03-18,AMRT,1345,1350,1400,1325,1360,15
3832,2022-03-18,ASII,6425,6450,6450,6325,6400,-25
3833,2022-03-18,HRUM,10500,10725,10900,10500,10500,0
3834,2022-03-18,INKP,7875,7900,8000,7775,8000,125
3835,2022-03-18,INTP,10800,10850,10975,10525,10975,175
3836,2022-03-18,MAPI,835,0,835,805,815,-20
3837,2022-03-18,SIDO,1050,0,1060,1030,1040,-10
3838,2022-03-18,UNTR,25250,25475,25600,25100,25425,175
3839,2022-03-18,UNVR,3420,3430,3440,3340,3360,-60
3840,2022-03-21,ACES,1000,0,1025,1000,1005,5
3841,2022-03-21,AMRT,1360,1360,1420,1360,1390,30
3842,2022-03-21,ASII,6400,6450,6600,6450,6600,200
3843,2022-03-21,HRUM,10500,10700,10950,10350,10900,400
3844,2022-03-21,INKP,8000,7975,8000,7800,7925,-75
3845,2022-03-21,INTP,10975,10875,10875,10500,10625,-350
3846,2022-03-21,MAPI,815,0,825,800,815,0
3847,2022-03-21,SIDO,1040,0,1050,1020,1020,-20
3848,2022-03-21,UNTR,25425,25475,25700,24925,25350,-75
3849,2022-03-21,UNVR,3360,3360,3470,3330,3460,100
3850,2022-03-22,ACES,1005,0,1020,995,995,-10
3851,2022-03-22,AMRT,1390,1390,1410,1365,1400,10
3852,2022-03-22,ASII,6600,6600,6600,6500,6575,-25
3853,2022-03-22,HRUM,10900,10950,11325,10850,11300,400
3854,2022-03-22,INKP,7925,7925,8000,7875,8000,75
3855,2022-03-22,INTP,10625,10625,10850,10625,10850,225
3856,2022-03-22,MAPI,815,0,825,805,815,0
3857,2022-03-22,SIDO,1020,0,1040,1020,1040,20
3858,2022-03-22,UNTR,25350,25350,25700,25225,25550,200
3859,2022-03-22,UNVR,3460,3460,3500,3440,3490,30
3860,2022-03-23,ACES,995,0,1010,970,990,-5
3861,2022-03-23,AMRT,1400,1400,1430,1365,1395,-5
3862,2022-03-23,ASII,6575,6575,6575,6450,6475,-100
3863,2022-03-23,HRUM,11300,11500,11500,10925,11100,-200
3864,2022-03-23,INKP,8000,8000,8200,8000,8075,75
3865,2022-03-23,INTP,10850,10825,10900,10750,10900,50
3866,2022-03-23,MAPI,815,0,820,795,805,-10
3867,2022-03-23,SIDO,1040,0,1050,1025,1045,5
3868,2022-03-23,UNTR,25550,25600,25850,25550,25725,175
3869,2022-03-23,UNVR,3490,3500,3510,3410,3410,-80
3870,2022-03-24,ACES,990,0,1010,985,995,5
3871,2022-03-24,AMRT,1395,1400,1430,1375,1420,25
3872,2022-03-24,ASII,6475,6425,6575,6425,6575,100
3873,2022-03-24,HRUM,11100,11350,11525,11150,11400,300
3874,2022-03-24,INKP,8075,8075,8200,8000,8075,0
3875,2022-03-24,INTP,10900,10750,10975,10725,10975,75
3876,2022-03-24,MAPI,805,0,860,805,860,55
3877,2022-03-24,SIDO,1045,0,1050,1030,1030,-15
3878,2022-03-24,UNTR,25725,26225,27250,26200,26600,875
3879,2022-03-24,UNVR,3410,3400,3420,3360,3380,-30
3880,2022-03-25,ACES,995,0,1025,995,1005,10
3881,2022-03-25,AMRT,1420,1420,1425,1355,1390,-30
3882,2022-03-25,ASII,6575,6550,6575,6375,6400,-175
3883,2022-03-25,HRUM,11400,11625,11850,11225,11800,400
3884,2022-03-25,INKP,8075,8175,8175,7900,7975,-100
3885,2022-03-25,INTP,10975,10925,10975,10625,10975,0
3886,2022-03-25,MAPI,860,0,870,840,845,-15
3887,2022-03-25,SIDO,1030,0,1040,1025,1035,5
3888,2022-03-25,UNTR,26600,26600,26950,26200,26325,-275
3889,2022-03-25,UNVR,3380,3390,3420,3380,3400,20
3890,2022-03-28,ACES,1005,0,1015,1000,1015,10
3891,2022-03-28,AMRT,1390,1415,1425,1350,1400,10
3892,2022-03-28,ASII,6400,6400,6775,6400,6700,300
3893,2022-03-28,HRUM,11800,11900,11925,11400,11400,-400
3894,2022-03-28,INKP,7975,8025,8050,7950,8025,50
3895,2022-03-28,INTP,10975,10925,11050,10750,10875,-100
3896,2022-03-28,MAPI,845,0,870,825,835,-10
3897,2022-03-28,SIDO,1035,0,1035,1010,1020,-15
3898,2022-03-28,UNTR,26325,26325,26950,26325,26600,275
3899,2022-03-28,UNVR,3400,3400,3490,3370,3460,60
3900,2022-03-29,ACES,1015,0,1035,1015,1025,10
3901,2022-03-29,AMRT,1400,1395,1470,1395,1420,20
3902,2022-03-29,ASII,6700,6600,6700,6550,6550,-150
3903,2022-03-29,HRUM,11400,11400,11600,10825,10975,-425
3904,2022-03-29,INKP,8025,8050,8075,7925,7925,-100
3905,2022-03-29,INTP,10875,10950,10950,10750,10750,-125
3906,2022-03-29,MAPI,835,0,860,835,840,5
3907,2022-03-29,SIDO,1020,0,1020,995,1000,-20
3908,2022-03-29,UNTR,26600,26300,26425,26025,26025,-575
3909,2022-03-29,UNVR,3460,3480,3560,3480,3480,20
3910,2022-03-30,ACES,1025,0,1060,1020,1025,0
3911,2022-03-30,AMRT,1420,1420,1480,1395,1460,40
3912,2022-03-30,ASII,6550,6550,6650,6500,6650,100
3913,2022-03-30,HRUM,10975,11025,11025,10525,10600,-375
3914,2022-03-30,INKP,7925,7925,8000,7825,7850,-75
3915,2022-03-30,INTP,10750,10850,10975,10775,10925,175
3916,2022-03-30,MAPI,840,0,865,845,860,20
3917,2022-03-30,SIDO,1000,0,1015,985,995,-5
3918,2022-03-30,UNTR,26025,26000,26250,25600,25875,-150
3919,2022-03-30,UNVR,3480,3500,3740,3500,3720,240
3920,2022-03-31,ACES,1025,0,1035,1005,1025,0
3921,2022-03-31,AMRT,1460,1480,1530,1470,1520,60
3922,2022-03-31,ASII,6650,6675,6675,6575,6575,-75
3923,2022-03-31,HRUM,10600,10800,10800,10425,10700,100
3924,2022-03-31,INKP,7850,7950,7950,7800,7900,50
3925,2022-03-31,INTP,10925,10950,10950,10700,10775,-150
3926,2022-03-31,MAPI,860,0,880,850,880,20
3927,2022-03-31,SIDO,995,0,1025,990,1020,25
3928,2022-03-31,UNTR,25875,25875,26000,25550,25550,-325
3929,2022-03-31,UNVR,3720,3730,3760,3650,3660,-60
3930,2022-04-01,ACES,1025,0,1095,1025,1075,50
3931,2022-04-01,AMRT,1520,1515,1520,1455,1485,-35
3932,2022-04-01,ASII,6575,6775,6775,6625,6700,125
3933,2022-04-01,HRUM,10700,10800,10900,10475,10550,-150
3934,2022-04-01,INKP,7900,7900,7975,7825,7975,75
3935,2022-04-01,INTP,10775,10825,10825,10625,10725,-50
3936,2022-04-01,MAPI,880,0,880,825,840,-40
3937,2022-04-01,SIDO,1020,0,1025,950,955,-65
3938,2022-04-01,UNTR,25550,25775,26425,25475,25925,375
3939,2022-04-01,UNVR,3660,3660,3690,3600,3620,-40
3940,2022-04-04,ACES,1075,0,1120,1075,1110,35
3941,2022-04-04,AMRT,1485,1495,1550,1490,1530,45
3942,2022-04-04,ASII,6700,6775,6825,6675,6825,125
3943,2022-04-04,HRUM,10550,10700,11750,10575,11700,1150
3944,2022-04-04,INKP,7975,7975,7975,7875,7950,-25
3945,2022-04-04,INTP,10725,10750,10875,10575,10875,150
3946,2022-04-04,MAPI,840,0,850,830,840,0
3947,2022-04-04,SIDO,955,0,970,940,965,10
3948,2022-04-04,UNTR,25925,26200,26775,26050,26775,850
3949,2022-04-04,UNVR,3620,3630,3660,3540,3570,-50
3950,2022-04-05,ACES,1110,0,1110,1070,1075,-35
3951,2022-04-05,AMRT,1530,1530,1580,1510,1575,45
3952,2022-04-05,ASII,6825,6825,6900,6725,6900,75
3953,2022-04-05,HRUM,11700,11900,12150,11500,12025,325
3954,2022-04-05,INKP,7950,8025,8175,8025,8100,150
3955,2022-04-05,INTP,10875,10825,10875,10650,10850,-25
3956,2022-04-05,MAPI,840,0,865,840,855,15
3957,2022-04-05,SIDO,965,0,975,955,960,-5
3958,2022-04-05,UNTR,26775,26800,27200,26550,27200,425
3959,2022-04-05,UNVR,3570,3570,3690,3570,3680,110
3960,2022-04-06,ACES,1075,0,1090,1065,1075,0
3961,2022-04-06,AMRT,1575,1595,1755,1580,1705,130
3962,2022-04-06,ASII,6900,6825,7000,6800,7000,100
3963,2022-04-06,HRUM,12025,12100,12625,12050,12475,450
3964,2022-04-06,INKP,8100,8150,8250,8000,8000,-100
3965,2022-04-06,INTP,10850,10700,10800,10500,10500,-350
3966,2022-04-06,MAPI,855,0,855,825,855,0
3967,2022-04-06,SIDO,960,0,975,940,940,-20
3968,2022-04-06,UNTR,27200,27250,27475,27200,27450,250
3969,2022-04-06,UNVR,3680,3680,3680,3560,3600,-80
3970,2022-04-07,ACES,1075,0,1110,1070,1095,20
3971,2022-04-07,AMRT,1705,1750,1750,1590,1615,-90
3972,2022-04-07,ASII,7000,6950,7000,6850,6900,-100
3973,2022-04-07,HRUM,12475,12550,12850,12150,12400,-75
3974,2022-04-07,INKP,8000,8000,8050,7875,7875,-125
3975,2022-04-07,INTP,10500,10525,10675,10400,10450,-50
3976,2022-04-07,MAPI,855,0,850,815,845,-10
3977,2022-04-07,SIDO,940,0,950,930,940,0
3978,2022-04-07,UNTR,27450,27475,27775,27150,27150,-300
3979,2022-04-07,UNVR,3600,3600,3640,3550,3570,-30
3980,2022-04-08,ACES,1095,0,1115,1080,1085,-10
3981,2022-04-08,AMRT,1615,1615,1730,1615,1695,80
3982,2022-04-08,ASII,6900,7000,7075,6900,7000,100
3983,2022-04-08,HRUM,12400,12550,13425,12475,12900,500
3984,2022-04-08,INKP,7875,7875,7975,7850,7925,50
3985,2022-04-08,INTP,10450,10450,10575,10400,10450,0
3986,2022-04-08,MAPI,845,0,850,830,845,0
3987,2022-04-08,SIDO,940,0,940,920,935,-5
3988,2022-04-08,UNTR,27150,27350,29000,27350,28600,1450
3989,2022-04-08,UNVR,3570,3590,3600,3520,3540,-30
3990,2022-04-11,ACES,1085,0,1100,1050,1065,-20
3991,2022-04-11,AMRT,1695,1695,1700,1630,1675,-20
3992,2022-04-11,ASII,7000,6975,7000,6750,6850,-150
3993,2022-04-11,HRUM,12900,12900,13350,12675,12700,-200
3994,2022-04-11,INKP,7925,7925,7975,7750,7775,-150
3995,2022-04-11,INTP,10450,10400,10450,10125,10125,-325
3996,2022-04-11,MAPI,845,0,880,840,875,30
3997,2022-04-11,SIDO,935,0,940,900,905,-30
3998,2022-04-11,UNTR,28600,28700,29125,28225,28450,-150
3999,2022-04-11,UNVR,3540,3570,3570,3450,3460,-80
4000,2022-04-12,ACES,1065,0,1175,1060,1160,95
4001,2022-04-12,AMRT,1675,1680,1775,1680,1755,80
4002,2022-04-12,ASII,6850,6875,6950,6825,6950,100
4003,2022-04-12,HRUM,12700,12625,13350,12250,13200,500
4004,2022-04-12,INKP,7775,7775,7850,7625,7800,25
4005,2022-04-12,INTP,10125,10125,10250,9975,10225,100
4006,2022-04-12,MAPI,875,0,915,875,910,35
4007,2022-04-12,SIDO,905,0,935,900,905,0
4008,2022-04-12,UNTR,28450,28450,28675,27800,27950,-500
4009,2022-04-12,UNVR,3460,3460,3520,3410,3520,60
4010,2022-04-13,ACES,1160,0,1175,1130,1170,10
4011,2022-04-13,AMRT,1755,1760,1760,1690,1700,-55
4012,2022-04-13,ASII,6950,6950,7000,6875,6975,25
4013,2022-04-13,HRUM,13200,13500,13950,13375,13550,350
4014,2022-04-13,INKP,7800,7800,7800,7650,7700,-100
4015,2022-04-13,INTP,10225,10200,10200,9975,10175,-50
4016,2022-04-13,MAPI,910,0,935,875,890,-20
4017,2022-04-13,SIDO,905,0,925,905,905,0
4018,2022-04-13,UNTR,27950,28500,29300,28300,29275,1325
4019,2022-04-13,UNVR,3520,3520,3520,3410,3440,-80
4020,2022-04-14,ACES,1170,0,1185,1125,1145,-25
4021,2022-04-14,AMRT,1700,1700,1730,1685,1720,20
4022,2022-04-14,ASII,6975,6975,7050,6875,6875,-100
4023,2022-04-14,HRUM,13550,13625,13700,13450,13600,50
4024,2022-04-14,INKP,7700,7700,7725,7600,7625,-75
4025,2022-04-14,INTP,10175,10075,10175,10000,10050,-125
4026,2022-04-14,MAPI,890,0,910,880,890,0
4027,2022-04-14,SIDO,905,0,925,905,910,5
4028,2022-04-14,UNTR,29275,29500,30000,29300,29800,525
4029,2022-04-14,UNVR,3440,3430,3460,3400,3400,-40
4030,2022-04-18,ACES,1145,0,1155,1125,1145,0
4031,2022-04-18,AMRT,1720,1720,1730,1700,1705,-15
4032,2022-04-18,ASII,6875,6900,7050,6900,7000,125
4033,2022-04-18,HRUM,13600,13725,14125,13675,14075,475
4034,2022-04-18,INKP,7625,7650,7700,7525,7600,-25
4035,2022-04-18,INTP,10050,10075,10250,10000,10025,-25
4036,2022-04-18,MAPI,890,0,930,885,890,0
4037,2022-04-18,SIDO,910,0,920,910,915,5
4038,2022-04-18,UNTR,29800,29800,30000,29400,30000,200
4039,2022-04-18,UNVR,3400,3400,3440,3370,3390,-10
4040,2022-04-19,ACES,1145,0,1150,1070,1075,-70
4041,2022-04-19,AMRT,1705,1705,1715,1690,1690,-15
4042,2022-04-19,ASII,7000,7050,7050,6800,6900,-100
4043,2022-04-19,HRUM,14075,14075,14200,13675,13750,-325
4044,2022-04-19,INKP,7600,7600,7700,7550,7600,0
4045,2022-04-19,INTP,10025,10025,10350,10025,10275,250
4046,2022-04-19,MAPI,890,0,910,880,905,15
4047,2022-04-19,SIDO,915,0,930,910,930,15
4048,2022-04-19,UNTR,30000,30025,30300,29425,29600,-400
4049,2022-04-19,UNVR,3390,3390,3410,3350,3350,-40
4050,2022-04-20,ACES,1075,0,1120,1070,1095,20
4051,2022-04-20,AMRT,1690,1695,1760,1695,1740,50
4052,2022-04-20,ASII,6900,6900,6975,6825,6900,0
4053,2022-04-20,HRUM,13750,14000,14300,13650,13850,100
4054,2022-04-20,INKP,7600,7625,7675,7550,7600,0
4055,2022-04-20,INTP,10275,10300,10375,10125,10225,-50
4056,2022-04-20,MAPI,905,0,925,885,885,-20
4057,2022-04-20,SIDO,930,0,940,925,940,10
4058,2022-04-20,UNTR,29600,29100,29100,28300,28350,-1250
4059,2022-04-20,UNVR,3350,3390,3510,3370,3470,120
4060,2022-04-21,ACES,1095,0,1100,1070,1075,-20
4061,2022-04-21,AMRT,1740,1735,1740,1645,1705,-35
4062,2022-04-21,ASII,6900,6925,7100,6900,7000,100
4063,2022-04-21,HRUM,13850,13900,13900,12900,12900,-950
4064,2022-04-21,INKP,7600,7650,7800,7575,7600,0
4065,2022-04-21,INTP,10225,10225,10350,10100,10150,-75
4066,2022-04-21,MAPI,885,0,920,885,920,35
4067,2022-04-21,SIDO,940,0,950,930,930,-10
4068,2022-04-21,UNTR,28350,28350,29150,28050,28125,-225
4069,2022-04-21,UNVR,3470,3470,3500,3400,3400,-70
4070,2022-04-22,ACES,1075,0,1075,1035,1065,-10
4071,2022-04-22,AMRT,1705,1705,1730,1700,1710,5
4072,2022-04-22,ASII,7000,6975,7100,6875,7050,50
4073,2022-04-22,HRUM,12900,12800,12925,12375,12575,-325
4074,2022-04-22,INKP,7600,7600,7675,7525,7550,-50
4075,2022-04-22,INTP,10150,10150,10175,10025,10150,0
4076,2022-04-22,MAPI,920,0,930,905,920,0
4077,2022-04-22,SIDO,930,0,940,925,935,5
4078,2022-04-22,UNTR,28125,28125,28700,27825,28300,175
4079,2022-04-22,UNVR,3400,3400,3440,3370,3430,30
4080,2022-04-25,ACES,1065,0,1070,1045,1050,-15
4081,2022-04-25,AMRT,1710,1690,1740,1650,1695,-15
4082,2022-04-25,ASII,7050,7050,7150,6875,7075,25
4083,2022-04-25,HRUM,12575,12425,12450,11925,11925,-650
4084,2022-04-25,INKP,7550,7525,7575,7450,7500,-50
4085,2022-04-25,INTP,10150,10100,10275,10025,10125,-25
4086,2022-04-25,MAPI,920,0,940,895,920,0
4087,2022-04-25,SIDO,935,0,940,915,920,-15
4088,2022-04-25,UNTR,28300,28200,28200,27325,27625,-675
4089,2022-04-25,UNVR,3430,3420,3720,3400,3690,260
4090,2022-04-26,ACES,1050,0,1055,1020,1040,-10
4091,2022-04-26,AMRT,1695,1695,1745,1675,1685,-10
4092,2022-04-26,ASII,7075,7100,7200,7000,7200,125
4093,2022-04-26,HRUM,11925,11925,12150,11100,11100,-825
4094,2022-04-26,INKP,7500,7500,7550,7350,7400,-100
4095,2022-04-26,INTP,10125,10125,10575,10125,10475,350
4096,2022-04-26,MAPI,920,0,935,910,920,0
4097,2022-04-26,SIDO,920,0,940,910,940,20
4098,2022-04-26,UNTR,27625,27650,28750,27650,28750,1125
4099,2022-04-26,UNVR,3690,3720,3930,3690,3890,200
4100,2022-04-27,ACES,1040,0,1045,1020,1030,-10
4101,2022-04-27,AMRT,1685,1685,1715,1675,1705,20
4102,2022-04-27,ASII,7200,7175,7200,7050,7125,-75
4103,2022-04-27,HRUM,11100,11100,11625,10600,11500,400
4104,2022-04-27,INKP,7400,7400,7525,7350,7425,25
4105,2022-04-27,INTP,10475,10475,10550,10325,10425,-50
4106,2022-04-27,MAPI,920,0,930,900,920,0
4107,2022-04-27,SIDO,940,0,950,930,940,0
4108,2022-04-27,UNTR,28750,28850,29100,28750,28900,150
4109,2022-04-27,UNVR,3890,3890,3900,3770,3810,-80
4110,2022-04-28,ACES,1030,0,1055,1025,1045,15
4111,2022-04-28,AMRT,1705,1715,1725,1700,1710,5
4112,2022-04-28,ASII,7125,7250,7700,7225,7575,450
4113,2022-04-28,HRUM,11500,11725,11850,11275,11525,25
4114,2022-04-28,INKP,7425,7425,7625,7425,7575,150
4115,2022-04-28,INTP,10425,10500,10675,10400,10475,50
4116,2022-04-28,MAPI,920,0,915,895,900,-20
4117,2022-04-28,SIDO,940,0,945,935,940,0
4118,2022-04-28,UNTR,28900,30000,30800,29825,30275,1375
4119,2022-04-28,UNVR,3810,3830,3920,3770,3890,80
4120,2022-05-09,ACES,1045,0,1045,985,990,-55
4121,2022-05-09,AMRT,1710,1680,1740,1625,1670,-40
4122,2022-05-09,ASII,7575,7425,7425,7050,7050,-525
4123,2022-05-09,HRUM,11525,11750,11775,10725,11000,-525
4124,2022-05-09,INKP,7575,7450,7475,7225,7325,-250
4125,2022-05-09,INTP,10475,10450,10450,9850,10000,-475
4126,2022-05-09,MAPI,900,0,910,865,905,5
4127,2022-05-09,SIDO,940,0,950,920,940,0
4128,2022-05-09,UNTR,30275,31775,31875,28825,29225,-1050
4129,2022-05-09,UNVR,3890,4000,4140,3890,4010,120
4130,2022-05-10,ACES,990,0,1025,955,995,5
4131,2022-05-10,AMRT,1670,1670,1670,1555,1555,-115
4132,2022-05-10,ASII,7050,6650,7000,6625,7000,-50
4133,2022-05-10,HRUM,11000,10500,10550,10250,10250,-750
4134,2022-05-10,INKP,7325,7300,7550,7125,7500,175
4135,2022-05-10,INTP,10000,10000,10150,9800,10025,25
4136,2022-05-10,MAPI,905,0,915,845,905,0
4137,2022-05-10,SIDO,940,0,945,910,935,-5
4138,2022-05-10,UNTR,29225,28750,29925,28025,29625,400
4139,2022-05-10,UNVR,4010,4010,4400,3990,4380,370
4140,2022-05-11,ACES,995,0,1035,1000,1025,30
4141,2022-05-11,AMRT,1555,1545,1615,1450,1615,60
4142,2022-05-11,ASII,7000,7025,7225,6900,6900,-100
4143,2022-05-11,HRUM,10250,10375,10775,10150,10350,100
4144,2022-05-11,INKP,7500,7500,7650,7425,7600,100
4145,2022-05-11,INTP,10025,10075,10600,10075,10500,475
4146,2022-05-11,MAPI,905,0,930,875,925,20
4147,2022-05-11,SIDO,935,0,940,920,920,-15
4148,2022-05-11,UNTR,29625,29625,30400,29625,30225,600
4149,2022-05-11,UNVR,4380,4400,4940,4380,4880,500
4150,2022-05-12,ACES,1025,0,1035,970,970,-55
4151,2022-05-12,AMRT,1615,1610,1615,1505,1505,-110
4152,2022-05-12,ASII,6900,6900,7025,6725,6850,-50
4153,2022-05-12,HRUM,10350,10350,10500,9850,10000,-350
4154,2022-05-12,INKP,7600,7600,7600,7225,7275,-325
4155,2022-05-12,INTP,10500,10450,10450,10100,10150,-350
4156,2022-05-12,MAPI,925,0,925,865,865,-60
4157,2022-05-12,SIDO,920,0,930,900,900,-20
4158,2022-05-12,UNTR,30225,29625,30200,28925,29300,-925
4159,2022-05-12,UNVR,4880,4920,4940,4580,4690,-190
4160,2022-05-13,ACES,970,0,1010,960,990,20
4161,2022-05-13,AMRT,1505,1595,1675,1430,1575,70
4162,2022-05-13,ASII,6850,6900,7225,6850,7125,275
4163,2022-05-13,HRUM,10000,10300,10725,9950,10525,525
4164,2022-05-13,INKP,7275,7275,7475,7200,7325,50
4165,2022-05-13,INTP,10150,9450,9800,9450,9650,-500
4166,2022-05-13,MAPI,865,0,905,835,890,25
4167,2022-05-13,SIDO,900,0,925,900,925,25
4168,2022-05-13,UNTR,29300,29300,30325,29300,30225,925
4169,2022-05-13,UNVR,4690,4690,4900,4660,4800,110
4170,2022-05-17,ACES,990,0,1025,1000,1015,25
4171,2022-05-17,AMRT,1575,1600,1710,1600,1650,75
4172,2022-05-17,ASII,7125,7250,7300,7000,7000,-125
4173,2022-05-17,HRUM,10525,10700,10975,10600,10975,450
4174,2022-05-17,INKP,7325,7400,7725,7350,7675,350
4175,2022-05-17,INTP,9650,9650,9750,9375,9600,-50
4176,2022-05-17,MAPI,890,0,910,865,865,-25
4177,2022-05-17,SIDO,925,0,930,920,925,0
4178,2022-05-17,UNTR,30225,30250,30775,29825,30075,-150
4179,2022-05-17,UNVR,4800,4810,4900,4660,4800,0
4180,2022-05-18,ACES,1015,0,1030,1000,1015,0
4181,2022-05-18,AMRT,1650,1675,1750,1665,1705,55
4182,2022-05-18,ASII,7000,6975,7200,6925,7100,100
4183,2022-05-18,HRUM,10975,11150,11175,10700,10975,0
4184,2022-05-18,INKP,7675,7675,7750,7575,7700,25
4185,2022-05-18,INTP,9600,9650,9900,9500,9900,300
4186,2022-05-18,MAPI,865,0,900,865,900,35
4187,2022-05-18,SIDO,925,0,940,920,930,5
4188,2022-05-18,UNTR,30075,30300,30400,30000,30300,225
4189,2022-05-18,UNVR,4800,4820,5075,4810,5025,225
4190,2022-05-19,ACES,1015,0,1020,980,1020,5
4191,2022-05-19,AMRT,1705,1675,1745,1610,1700,-5
4192,2022-05-19,ASII,7100,6925,7125,6850,7000,-100
4193,2022-05-19,HRUM,10975,10500,10825,10375,10700,-275
4194,2022-05-19,INKP,7700,7600,7650,7425,7525,-175
4195,2022-05-19,INTP,9900,9800,9825,9550,9825,-75
4196,2022-05-19,MAPI,900,0,890,840,845,-55
4197,2022-05-19,SIDO,930,0,965,920,965,35
4198,2022-05-19,UNTR,30300,30175,30175,29350,29975,-325
4199,2022-05-19,UNVR,5025,4960,5000,4850,4880,-145
4200,2022-05-20,ACES,1020,0,1025,990,1010,-10
4201,2022-05-20,AMRT,1700,1730,1845,1730,1775,75
4202,2022-05-20,ASII,7000,7050,7200,7050,7125,125
4203,2022-05-20,HRUM,10700,10900,11250,10850,11050,350
4204,2022-05-20,INKP,7525,7550,7850,7550,7625,100
4205,2022-05-20,INTP,9825,9825,10000,9775,9900,75
4206,2022-05-20,MAPI,845,0,865,820,845,0
4207,2022-05-20,SIDO,965,0,970,950,960,-5
4208,2022-05-20,UNTR,29975,29725,30500,29700,29900,-75
4209,2022-05-20,UNVR,4880,4870,5125,4860,5050,170
4210,2022-05-23,ACES,1010,0,1025,985,995,-15
4211,2022-05-23,AMRT,1775,1785,1795,1660,1740,-35
4212,2022-05-23,ASII,7125,7125,7175,6825,6950,-175
4213,2022-05-23,HRUM,11050,11250,11300,10800,10900,-150
4214,2022-05-23,INKP,7625,7725,7875,7650,7825,200
4215,2022-05-23,INTP,9900,10000,10150,9950,10075,175
4216,2022-05-23,MAPI,845,0,910,850,890,45
4217,2022-05-23,SIDO,960,0,970,945,960,0
4218,2022-05-23,UNTR,29900,30025,30150,29200,29650,-250
4219,2022-05-23,UNVR,5050,5050,5075,4850,4880,-170
4220,2022-05-24,ACES,995,0,995,960,975,-20
4221,2022-05-24,AMRT,1740,1750,1785,1675,1695,-45
4222,2022-05-24,ASII,6950,7025,7200,7025,7150,200
4223,2022-05-24,HRUM,10900,10900,11150,10825,11075,175
4224,2022-05-24,INKP,7825,7900,7925,7725,7775,-50
4225,2022-05-24,INTP,10075,10150,10275,10100,10200,125
4226,2022-05-24,MAPI,890,0,900,875,900,10
4227,2022-05-24,SIDO,960,0,965,940,945,-15
4228,2022-05-24,UNTR,29650,29650,30325,29625,30300,650
4229,2022-05-24,UNVR,4880,4920,4950,4700,4810,-70
4230,2022-05-25,ACES,975,0,1025,975,980,5
4231,2022-05-25,AMRT,1695,1690,1800,1690,1755,60
4232,2022-05-25,ASII,7150,7100,7175,7050,7100,-50
4233,2022-05-25,HRUM,11075,11000,11000,10400,10425,-650
4234,2022-05-25,INKP,7775,7825,7825,7575,7675,-100
4235,2022-05-25,INTP,10200,10200,10225,10050,10200,0
4236,2022-05-25,MAPI,900,0,900,875,895,-5
4237,2022-05-25,SIDO,945,0,960,945,960,15
4238,2022-05-25,UNTR,30300,30225,30800,29750,30175,-125
4239,2022-05-25,UNVR,4810,4860,4900,4730,4770,-40
4240,2022-05-27,ACES,980,0,1000,975,985,5
4241,2022-05-27,AMRT,1755,1785,1815,1690,1690,-65
4242,2022-05-27,ASII,7100,7200,7300,7150,7225,125
4243,2022-05-27,HRUM,10425,10625,11425,10525,11425,1000
4244,2022-05-27,INKP,7675,7750,7775,7625,7725,50
4245,2022-05-27,INTP,10200,10275,10575,10275,10350,150
4246,2022-05-27,MAPI,895,0,925,890,915,20
4247,2022-05-27,SIDO,960,0,970,950,965,5
4248,2022-05-27,UNTR,30175,30325,30400,30125,30400,225
4249,2022-05-27,UNVR,4770,4800,4840,4710,4760,-10
4250,2022-05-30,ACES,985,0,1010,980,1000,15
4251,2022-05-30,AMRT,1690,1710,1760,1680,1690,0
4252,2022-05-30,ASII,7225,7275,7275,7125,7250,25
4253,2022-05-30,HRUM,11425,11500,11600,11150,11450,25
4254,2022-05-30,INKP,7725,7775,8150,7750,8050,325
4255,2022-05-30,INTP,10350,10350,10575,10200,10225,-125
4256,2022-05-30,MAPI,915,0,920,890,900,-15
4257,2022-05-30,SIDO,965,0,970,965,965,0
4258,2022-05-30,UNTR,30400,30700,30875,29925,30250,-150
4259,2022-05-30,UNVR,4760,4760,4760,4620,4650,-110
4260,2022-05-31,ACES,1000,0,1010,960,960,-40
4261,2022-05-31,AMRT,1690,1730,1820,1640,1820,130
4262,2022-05-31,ASII,7250,7250,7475,7250,7350,100
4263,2022-05-31,HRUM,11450,11625,11925,11500,11875,425
4264,2022-05-31,INKP,8050,8125,8300,7950,8250,200
4265,2022-05-31,INTP,10225,10225,10300,9725,9725,-500
4266,2022-05-31,MAPI,900,0,905,890,900,0
4267,2022-05-31,SIDO,965,0,1020,965,1020,55
4268,2022-05-31,UNTR,30250,30500,31975,30300,31300,1050
4269,2022-05-31,UNVR,4650,4680,4820,4630,4730,80
4270,2022-06-02,ACES,960,0,1000,970,985,25
4271,2022-06-02,AMRT,1820,1850,1900,1780,1800,-20
4272,2022-06-02,ASII,7350,7300,7500,7250,7325,-25
4273,2022-06-02,HRUM,2380,2380,2400,2300,2310,-70
4274,2022-06-02,INKP,8250,8250,8475,8225,8425,175
4275,2022-06-02,INTP,9725,9800,9925,9675,9850,125
4276,2022-06-02,MAPI,900,0,910,890,895,-5
4277,2022-06-02,SIDO,1020,0,1020,975,1000,-20
4278,2022-06-02,UNTR,31300,31975,32500,30975,31625,325
4279,2022-06-02,UNVR,4730,4760,4890,4710,4790,60
4280,2022-06-03,ACES,985,0,1010,985,1000,15
4281,2022-06-03,AMRT,1800,1810,1860,1795,1815,15
4282,2022-06-03,ASII,7325,7350,7475,7300,7300,-25
4283,2022-06-03,HRUM,2310,2310,2440,2230,2410,100
4284,2022-06-03,INKP,8425,8450,8500,8250,8275,-150
4285,2022-06-03,INTP,9850,9975,9975,9750,9800,-50
4286,2022-06-03,MAPI,895,0,960,895,935,40
4287,2022-06-03,SIDO,1000,0,1010,985,985,-15
4288,2022-06-03,UNTR,31625,32450,32725,31600,32600,975
4289,2022-06-03,UNVR,4790,4810,4810,4720,4720,-70
4290,2022-06-06,ACES,1000,0,1005,970,980,-20
4291,2022-06-06,AMRT,1815,1815,1845,1790,1820,5
4292,2022-06-06,ASII,7300,7200,7250,7075,7225,-75
4293,2022-06-06,HRUM,2410,2410,2470,2310,2330,-80
4294,2022-06-06,INKP,8275,8275,8425,8100,8175,-100
4295,2022-06-06,INTP,9800,9825,9950,9775,9900,100
4296,2022-06-06,MAPI,935,0,985,930,960,25
4297,2022-06-06,SIDO,985,0,995,980,990,5
4298,2022-06-06,UNTR,32600,32600,32700,31825,32175,-425
4299,2022-06-06,UNVR,4720,4720,4780,4700,4770,50
4300,2022-06-07,ACES,980,0,990,980,990,10
4301,2022-06-07,AMRT,1820,1815,1850,1805,1810,-10
4302,2022-06-07,ASII,7225,7300,7400,7200,7200,-25
4303,2022-06-07,HRUM,2330,2370,2380,2310,2330,0
4304,2022-06-07,INKP,8175,8175,8450,8175,8200,25
4305,2022-06-07,INTP,9900,9500,9650,9425,9550,-350
4306,2022-06-07,MAPI,960,0,980,940,950,-10
4307,2022-06-07,SIDO,990,0,995,980,985,-5
4308,2022-06-07,UNTR,32175,32700,33375,32500,32825,650
4309,2022-06-07,UNVR,4770,4770,4780,4720,4730,-40
4310,2022-06-08,ACES,990,0,990,975,985,-5
4311,2022-06-08,AMRT,1810,1815,1850,1815,1850,40
4312,2022-06-08,ASII,7200,7150,7350,7150,7175,-25
4313,2022-06-08,HRUM,2330,2330,2340,2170,2180,-150
4314,2022-06-08,INKP,8200,8275,8400,8200,8350,150
4315,2022-06-08,INTP,9550,9550,9725,9475,9650,100
4316,2022-06-08,MAPI,950,0,985,950,965,15
4317,2022-06-08,SIDO,985,0,995,975,985,0
4318,2022-06-08,UNTR,32825,33275,33300,32775,33050,225
4319,2022-06-08,UNVR,4730,4740,4970,4730,4890,160
4320,2022-06-09,ACES,985,0,990,930,945,-40
4321,2022-06-09,AMRT,1850,1865,1865,1805,1855,5
4322,2022-06-09,ASII,7175,7150,7350,7150,7200,25
4323,2022-06-09,HRUM,2180,2180,2230,2150,2180,0
4324,2022-06-09,INKP,8350,8350,8450,8250,8275,-75
4325,2022-06-09,INTP,9650,9675,9700,9500,9500,-150
4326,2022-06-09,MAPI,965,0,970,940,950,-15
4327,2022-06-09,SIDO,985,0,985,975,975,-10
4328,2022-06-09,UNTR,33050,33050,33075,32275,32400,-650
4329,2022-06-09,UNVR,4890,4900,4930,4760,4820,-70
4330,2022-06-10,ACES,945,0,945,910,915,-30
4331,2022-06-10,AMRT,1855,1840,1840,1765,1795,-60
4332,2022-06-10,ASII,7200,7100,7175,6925,6925,-275
4333,2022-06-10,HRUM,2180,2140,2160,2080,2100,-80
4334,2022-06-10,INKP,8275,8225,8425,8100,8375,100
4335,2022-06-10,INTP,9500,9500,9525,9350,9400,-100
4336,2022-06-10,MAPI,950,0,960,915,925,-25
4337,2022-06-10,SIDO,975,0,980,965,975,0
4338,2022-06-10,UNTR,32400,32400,32700,32000,32200,-200
4339,2022-06-10,UNVR,4820,4780,4790,4720,4750,-70
4340,2022-06-13,ACES,915,0,915,875,880,-35
4341,2022-06-13,AMRT,1795,1795,1815,1740,1770,-25
4342,2022-06-13,ASII,6925,6900,7100,6725,7025,100
4343,2022-06-13,HRUM,2100,2000,2050,1965,2020,-80
4344,2022-06-13,INKP,8375,8200,8250,8000,8200,-175
4345,2022-06-13,INTP,9400,9350,9350,9025,9150,-250
4346,2022-06-13,MAPI,925,0,920,880,900,-25
4347,2022-06-13,SIDO,975,0,990,945,960,-15
4348,2022-06-13,UNTR,32200,32025,32025,30175,30675,-1525
4349,2022-06-13,UNVR,4750,4690,4700,4600,4690,-60
4350,2022-06-14,ACES,880,0,905,875,885,5
4351,2022-06-14,AMRT,1770,1775,1840,1770,1835,65
4352,2022-06-14,ASII,7025,6875,7000,6875,6975,-50
4353,2022-06-14,HRUM,2020,2000,2070,1960,2020,0
4354,2022-06-14,INKP,8200,8125,8250,7950,8000,-200
4355,2022-06-14,INTP,9150,9125,9275,9075,9225,75
4356,2022-06-14,MAPI,900,0,910,880,890,-10
4357,2022-06-14,SIDO,960,0,960,945,945,-15
4358,2022-06-14,UNTR,30675,30400,31550,30100,31550,875
4359,2022-06-14,UNVR,4690,4640,4740,4610,4740,50
4360,2022-06-15,ACES,885,0,890,860,860,-25
4361,2022-06-15,AMRT,1835,1830,1835,1775,1795,-40
4362,2022-06-15,ASII,6975,6975,6975,6700,6700,-275
4363,2022-06-15,HRUM,2020,2020,2030,1880,1885,-135
4364,2022-06-15,INKP,8000,8000,8075,7800,7800,-200
4365,2022-06-15,INTP,9225,9225,9300,9100,9100,-125
4366,2022-06-15,MAPI,890,0,905,885,900,10
4367,2022-06-15,SIDO,945,0,955,935,950,5
4368,2022-06-15,UNTR,31550,31550,31625,29700,29750,-1800
4369,2022-06-15,UNVR,4740,4750,4810,4690,4800,60
4370,2022-06-16,ACES,860,0,885,850,850,-10
4371,2022-06-16,AMRT,1795,1820,1840,1795,1830,35
4372,2022-06-16,ASII,6700,6850,6950,6750,6850,150
4373,2022-06-16,HRUM,1885,1930,1960,1840,1860,-25
4374,2022-06-16,INKP,7800,7950,8200,7925,8100,300
4375,2022-06-16,INTP,9100,9150,9300,9150,9200,100
4376,2022-06-16,MAPI,900,0,940,900,910,10
4377,2022-06-16,SIDO,950,0,970,945,950,0
4378,2022-06-16,UNTR,29750,30100,30900,29950,30000,250
4379,2022-06-16,UNVR,4800,4850,4850,4730,4800,0
4380,2022-06-17,ACES,850,0,840,800,805,-45
4381,2022-06-17,AMRT,1830,1820,1830,1790,1805,-25
4382,2022-06-17,ASII,6850,6675,6950,6675,6950,100
4383,2022-06-17,HRUM,1860,1815,1815,1730,1730,-130
4384,2022-06-17,INKP,8100,8000,8050,7875,7925,-175
4385,2022-06-17,INTP,9200,9100,9250,9050,9250,50
4386,2022-06-17,MAPI,910,0,915,860,875,-35
4387,2022-06-17,SIDO,950,0,960,945,960,10
4388,2022-06-17,UNTR,30000,29525,29550,28800,28800,-1200
4389,2022-06-17,UNVR,4800,4760,4800,4650,4650,-150
4390,2022-06-20,ACES,805,0,815,750,775,-30
4391,2022-06-20,AMRT,1805,1805,1820,1790,1800,-5
4392,2022-06-20,ASII,6950,6950,6975,6750,6925,-25
4393,2022-06-20,HRUM,1730,1750,1755,1640,1680,-50
4394,2022-06-20,INKP,7925,7925,7950,7700,7800,-125
4395,2022-06-20,INTP,9250,9250,9275,9075,9200,-50
4396,2022-06-20,MAPI,875,0,920,870,900,25
4397,2022-06-20,SIDO,960,0,970,945,965,5
4398,2022-06-20,UNTR,28800,28800,29125,28525,29000,200
4399,2022-06-20,UNVR,4650,4680,5025,4660,5025,375
4400,2022-06-21,ACES,775,0,800,760,765,-10
4401,2022-06-21,AMRT,1800,1830,1835,1810,1830,30
4402,2022-06-21,ASII,6925,6900,6975,6850,6850,-75
4403,2022-06-21,HRUM,1680,1745,1765,1695,1725,45
4404,2022-06-21,INKP,7800,7800,7900,7750,7775,-25
4405,2022-06-21,INTP,9200,9225,9400,9200,9400,200
4406,2022-06-21,MAPI,900,0,930,890,900,0
4407,2022-06-21,SIDO,965,0,970,945,955,-10
4408,2022-06-21,UNTR,29000,29500,29725,28825,29150,150
4409,2022-06-21,UNVR,5025,5050,5100,4950,5050,25
4410,2022-06-22,ACES,765,0,785,720,770,5
4411,2022-06-22,AMRT,1830,1835,1960,1815,1960,130
4412,2022-06-22,ASII,6850,6850,6925,6775,6800,-50
4413,2022-06-22,HRUM,1725,1725,1780,1645,1655,-70
4414,2022-06-22,INKP,7775,7800,7950,7625,7775,0
4415,2022-06-22,INTP,9400,9350,9425,9275,9275,-125
4416,2022-06-22,MAPI,900,0,910,890,895,-5
4417,2022-06-22,SIDO,955,0,975,955,975,20
4418,2022-06-22,UNTR,29150,29200,29525,29000,29200,50
4419,2022-06-22,UNVR,5050,5050,5050,4860,4890,-160
4420,2022-06-23,ACES,770,0,780,760,770,0
4421,2022-06-23,AMRT,1960,1960,2040,1915,1990,30
4422,2022-06-23,ASII,6800,6850,6875,6750,6875,75
4423,2022-06-23,HRUM,1655,1650,1685,1585,1675,20
4424,2022-06-23,INKP,7775,7750,7775,7600,7750,-25
4425,2022-06-23,INTP,9275,9275,9500,9200,9500,225
4426,2022-06-23,MAPI,895,0,910,880,900,5
4427,2022-06-23,SIDO,975,0,985,970,985,10
4428,2022-06-23,UNTR,29200,29450,29450,28650,29275,75
4429,2022-06-23,UNVR,4890,4900,5000,4860,4960,70
4430,2022-06-24,ACES,770,0,810,770,780,10
4431,2022-06-24,AMRT,1990,1990,2020,1945,1990,0
4432,2022-06-24,ASII,6875,6900,6900,6650,6675,-200
4433,2022-06-24,HRUM,1675,1680,1695,1640,1675,0
4434,2022-06-24,INKP,7750,7750,7775,7650,7725,-25
4435,2022-06-24,INTP,9500,9500,9825,9450,9775,275
4436,2022-06-24,MAPI,900,0,915,885,915,15
4437,2022-06-24,SIDO,985,0,1000,980,990,5
4438,2022-06-24,UNTR,29275,29400,29700,29075,29275,0
4439,2022-06-24,UNVR,4960,4930,4990,4870,4990,30
4440,2022-06-27,ACES,780,0,805,780,800,20
4441,2022-06-27,AMRT,1990,2000,2000,1910,1985,-5
4442,2022-06-27,ASII,6675,6700,6750,6550,6650,-25
4443,2022-06-27,HRUM,1675,1625,1645,1565,1585,-90
4444,2022-06-27,INKP,7725,7750,7900,7725,7900,175
4445,2022-06-27,INTP,9775,9775,9800,9525,9750,-25
4446,2022-06-27,MAPI,915,0,920,900,910,-5
4447,2022-06-27,SIDO,990,0,1005,980,985,-5
4448,2022-06-27,UNTR,29275,29500,29600,28975,29200,-75
4449,2022-06-27,UNVR,4990,4990,5000,4900,4980,-10
4450,2022-06-28,ACES,800,0,805,780,790,-10
4451,2022-06-28,AMRT,1985,1985,1985,1920,1985,0
4452,2022-06-28,ASII,6650,6650,6700,6600,6700,50
4453,2022-06-28,HRUM,1585,1595,1625,1580,1610,25
4454,2022-06-28,INKP,7900,7900,7950,7750,7775,-125
4455,2022-06-28,INTP,9750,9725,9725,9450,9625,-125
4456,2022-06-28,MAPI,910,0,955,910,925,15
4457,2022-06-28,SIDO,985,0,995,985,995,10
4458,2022-06-28,UNTR,29200,29400,29875,29300,29800,600
4459,2022-06-28,UNVR,4980,4980,5075,4960,5050,70
4460,2022-06-29,ACES,790,0,795,775,785,-5
4461,2022-06-29,AMRT,1985,1985,1995,1975,1990,5
4462,2022-06-29,ASII,6700,6625,6700,6500,6500,-200
4463,2022-06-29,HRUM,1610,1610,1615,1535,1550,-60
4464,2022-06-29,INKP,7775,7750,7825,7700,7700,-75
4465,2022-06-29,INTP,9625,9550,9675,9425,9500,-125
4466,2022-06-29,MAPI,925,0,990,925,965,40
4467,2022-06-29,SIDO,995,0,1010,980,995,0
4468,2022-06-29,UNTR,29800,29700,29700,28500,28525,-1275
4469,2022-06-29,UNVR,5050,5000,5050,4910,4940,-110
4470,2022-06-30,ACES,785,0,795,770,770,-15
4471,2022-06-30,AMRT,1990,2000,2090,1990,2040,50
4472,2022-06-30,ASII,6500,6525,6650,6500,6625,125
4473,2022-06-30,HRUM,1550,1560,1590,1520,1545,-5
4474,2022-06-30,INKP,7700,7700,7800,7600,7600,-100
4475,2022-06-30,INTP,9500,9600,9700,9300,9475,-25
4476,2022-06-30,MAPI,965,0,990,960,980,15
4477,2022-06-30,SIDO,995,0,1000,985,1000,5
4478,2022-06-30,UNTR,28525,28400,28750,28200,28400,-125
4479,2022-06-30,UNVR,4940,4950,4980,4750,4770,-170
4480,2022-07-01,ACES,770,0,785,770,775,5
4481,2022-07-01,AMRT,2040,2040,2050,1990,2010,-30
4482,2022-07-01,ASII,6625,6675,6675,6500,6525,-100
4483,2022-07-01,HRUM,1545,1535,1555,1440,1440,-105
4484,2022-07-01,INKP,7600,7600,7600,7400,7425,-175
4485,2022-07-01,INTP,9475,9475,9500,9250,9400,-75
4486,2022-07-01,MAPI,980,0,980,915,915,-65
4487,2022-07-01,SIDO,1000,0,1000,975,990,-10
4488,2022-07-01,UNTR,28400,28400,28600,26425,26500,-1900
4489,2022-07-01,UNVR,4770,4750,4860,4690,4830,60
4490,2022-07-04,ACES,775,0,780,725,725,-50
4491,2022-07-04,AMRT,2010,2010,2020,1920,1920,-90
4492,2022-07-04,ASII,6525,6500,6575,6300,6500,-25
4493,2022-07-04,HRUM,1440,1415,1455,1375,1380,-60
4494,2022-07-04,INKP,7425,7425,7525,7225,7450,25
4495,2022-07-04,INTP,9400,9400,9425,9125,9200,-200
4496,2022-07-04,MAPI,915,0,935,880,900,-15
4497,2022-07-04,SIDO,990,0,990,955,985,-5
4498,2022-07-04,UNTR,26500,26500,27350,26125,26525,25
4499,2022-07-04,UNVR,4830,4800,4820,4550,4700,-130
4500,2022-07-05,ACES,725,0,760,720,750,25
4501,2022-07-05,AMRT,1920,1920,1995,1920,1980,60
4502,2022-07-05,ASII,6500,6500,6525,6325,6325,-175
4503,2022-07-05,HRUM,1380,1410,1520,1410,1500,120
4504,2022-07-05,INKP,7450,7475,7600,7400,7400,-50
4505,2022-07-05,INTP,9200,9250,9325,9175,9225,25
4506,2022-07-05,MAPI,900,0,915,890,900,0
4507,2022-07-05,SIDO,985,0,990,975,975,-10
4508,2022-07-05,UNTR,26525,26875,28175,26875,27975,1450
4509,2022-07-05,UNVR,4700,4700,4780,4680,4760,60
4510,2022-07-06,ACES,750,0,760,740,755,5
4511,2022-07-06,AMRT,1980,1980,2030,1960,2030,50
4512,2022-07-06,ASII,6325,6300,6400,6050,6075,-250
4513,2022-07-06,HRUM,1500,1500,1525,1445,1470,-30
4514,2022-07-06,INKP,7400,7450,7475,7250,7325,-75
4515,2022-07-06,INTP,9225,9225,9325,9025,9325,100
4516,2022-07-06,MAPI,900,0,920,885,900,0
4517,2022-07-06,SIDO,975,0,990,975,980,5
4518,2022-07-06,UNTR,27975,27875,27875,26375,26800,-1175
4519,2022-07-06,UNVR,4760,4740,4830,4710,4780,20
4520,2022-07-07,ACES,755,0,775,755,765,10
4521,2022-07-07,AMRT,2030,2030,2040,1900,1900,-130
4522,2022-07-07,ASII,6075,6025,6125,5900,5950,-125
4523,2022-07-07,HRUM,1470,1470,1500,1420,1450,-20
4524,2022-07-07,INKP,7325,7325,7375,7225,7275,-50
4525,2022-07-07,INTP,9325,9325,9325,9100,9125,-200
4526,2022-07-07,MAPI,900,0,925,890,925,25
4527,2022-07-07,SIDO,980,0,990,975,985,5
4528,2022-07-07,UNTR,26800,26775,26925,26350,26775,-25
4529,2022-07-07,UNVR,4780,4820,5025,4800,5000,220
4530,2022-07-08,ACES,765,0,800,765,795,30
4531,2022-07-08,AMRT,1900,1900,2030,1895,1900,0
4532,2022-07-08,ASII,5950,6025,6075,5950,5975,25
4533,2022-07-08,HRUM,1450,1495,1530,1470,1500,50
4534,2022-07-08,INKP,7275,7325,7350,7250,7275,0
4535,2022-07-08,INTP,9125,9200,9250,9050,9175,50
4536,2022-07-08,MAPI,925,0,930,905,910,-15
4537,2022-07-08,SIDO,985,0,985,970,970,-15
4538,2022-07-08,UNTR,26775,27200,27600,26925,27450,675
4539,2022-07-08,UNVR,5000,5025,5025,4810,4890,-110
4540,2022-07-11,ACES,795,0,805,760,775,-20
4541,2022-07-11,AMRT,1900,1910,2000,1910,1920,20
4542,2022-07-11,ASII,5975,5975,6075,5925,6050,75
4543,2022-07-11,HRUM,1500,1505,1520,1460,1510,10
4544,2022-07-11,INKP,7275,7275,7550,7275,7525,250
4545,2022-07-11,INTP,9175,9075,9125,9025,9125,-50
4546,2022-07-11,MAPI,910,0,925,890,895,-15
4547,2022-07-11,SIDO,970,0,990,970,980,10
4548,2022-07-11,UNTR,27450,27450,27450,26900,27225,-225
4549,2022-07-11,UNVR,4890,4900,4910,4750,4800,-90
4550,2022-07-12,ACES,775,0,780,765,770,-5
4551,2022-07-12,AMRT,1920,1930,1970,1920,1930,10
4552,2022-07-12,ASII,6050,6050,6150,6050,6100,50
4553,2022-07-12,HRUM,1510,1525,1535,1495,1510,0
4554,2022-07-12,INKP,7525,7525,7550,7400,7475,-50
4555,2022-07-12,INTP,9125,9125,9125,9000,9075,-50
4556,2022-07-12,MAPI,895,0,915,890,895,0
4557,2022-07-12,SIDO,980,0,985,965,980,0
4558,2022-07-12,UNTR,27225,27250,27750,26775,26925,-300
4559,2022-07-12,UNVR,4800,4800,4880,4770,4880,80
4560,2022-07-13,ACES,770,0,780,750,750,-20
4561,2022-07-13,AMRT,1930,1945,1945,1900,1935,5
4562,2022-07-13,ASII,6100,6100,6100,5825,5825,-275
4563,2022-07-13,HRUM,1510,1515,1520,1465,1480,-30
4564,2022-07-13,INKP,7475,7500,7500,7400,7500,25
4565,2022-07-13,INTP,9075,9075,9100,9000,9025,-50
4566,2022-07-13,MAPI,895,0,900,850,850,-45
4567,2022-07-13,SIDO,980,0,980,950,955,-25
4568,2022-07-13,UNTR,26925,27750,28450,27600,28275,1350
4569,2022-07-13,UNVR,4880,4900,4920,4820,4900,20
4570,2022-07-14,ACES,750,0,760,735,745,-5
4571,2022-07-14,AMRT,1935,1935,1950,1910,1945,10
4572,2022-07-14,ASII,5825,5825,6100,5825,6100,275
4573,2022-07-14,HRUM,1480,1470,1510,1450,1485,5
4574,2022-07-14,INKP,7500,7475,7625,7350,7625,125
4575,2022-07-14,INTP,9025,9000,9075,8975,9050,25
4576,2022-07-14,MAPI,850,0,895,830,870,20
4577,2022-07-14,SIDO,955,0,975,950,970,15
4578,2022-07-14,UNTR,28275,28300,29975,28300,29800,1525
4579,2022-07-14,UNVR,4900,4900,4900,4800,4900,0
4580,2022-07-15,ACES,745,0,765,740,745,0
4581,2022-07-15,AMRT,1945,1940,1940,1860,1860,-85
4582,2022-07-15,ASII,6100,6000,6075,5925,5950,-150
4583,2022-07-15,HRUM,1485,1450,1450,1385,1385,-100
4584,2022-07-15,INKP,7625,7625,7625,7425,7450,-175
4585,2022-07-15,INTP,9050,9050,9350,9025,9125,75
4586,2022-07-15,MAPI,870,0,900,880,895,25
4587,2022-07-15,SIDO,970,0,975,960,965,-5
4588,2022-07-15,UNTR,29800,29700,29700,28925,29025,-775
4589,2022-07-15,UNVR,4900,4900,4930,4820,4830,-70
4590,2022-07-18,ACES,745,0,755,730,730,-15
4591,2022-07-18,AMRT,1860,1855,1870,1785,1850,-10
4592,2022-07-18,ASII,5950,5975,6025,5950,6025,75
4593,2022-07-18,HRUM,1385,1385,1395,1335,1360,-25
4594,2022-07-18,INKP,7450,7475,7650,7375,7650,200
4595,2022-07-18,INTP,9125,9250,9300,9200,9275,150
4596,2022-07-18,MAPI,895,0,905,870,880,-15
4597,2022-07-18,SIDO,965,0,970,950,960,-5
4598,2022-07-18,UNTR,29025,28950,29100,28625,28850,-175
4599,2022-07-18,UNVR,4830,4870,4980,4830,4980,150
4600,2022-07-19,ACES,730,0,760,705,755,25
4601,2022-07-19,AMRT,1850,1850,1890,1830,1860,10
4602,2022-07-19,ASII,6025,6025,6150,6025,6075,50
4603,2022-07-19,HRUM,1360,1370,1515,1370,1510,150
4604,2022-07-19,INKP,7650,7650,7650,7525,7650,0
4605,2022-07-19,INTP,9275,9275,9375,9175,9375,100
4606,2022-07-19,MAPI,880,0,920,875,920,40
4607,2022-07-19,SIDO,960,0,960,955,960,0
4608,2022-07-19,UNTR,28850,28825,29325,28600,29100,250
4609,2022-07-19,UNVR,4980,4970,4990,4890,4970,-10
4610,2022-07-20,ACES,755,0,770,740,740,-15
4611,2022-07-20,AMRT,1860,1890,1890,1815,1850,-10
4612,2022-07-20,ASII,6075,6175,6275,6100,6275,200
4613,2022-07-20,HRUM,1510,1550,1585,1530,1580,70
4614,2022-07-20,INKP,7650,7650,7725,7575,7600,-50
4615,2022-07-20,INTP,9375,9350,9375,9300,9325,-50
4616,2022-07-20,MAPI,920,0,980,915,940,20
4617,2022-07-20,SIDO,960,0,990,960,970,10
4618,2022-07-20,UNTR,29100,29600,30350,29575,30175,1075
4619,2022-07-20,UNVR,4970,4990,5100,4950,4970,0
4620,2022-07-21,ACES,740,0,750,725,730,-10
4621,2022-07-21,AMRT,1850,1850,1855,1800,1835,-15
4622,2022-07-21,ASII,6275,6200,6250,6050,6175,-100
4623,2022-07-21,HRUM,1580,1580,1590,1535,1545,-35
4624,2022-07-21,INKP,7600,7600,7800,7575,7800,200
4625,2022-07-21,INTP,9325,9375,9400,9325,9400,75
4626,2022-07-21,MAPI,940,0,960,915,915,-25
4627,2022-07-21,SIDO,970,0,990,965,985,15
4628,2022-07-21,UNTR,30175,30100,30200,29675,30000,-175
4629,2022-07-21,UNVR,4970,4970,5000,4890,5000,30
4630,2022-07-22,ACES,730,0,735,715,720,-10
4631,2022-07-22,AMRT,1835,1835,1910,1830,1875,40
4632,2022-07-22,ASII,6175,6175,6175,6050,6075,-100
4633,2022-07-22,HRUM,1545,1560,1630,1555,1625,80
4634,2022-07-22,INKP,7800,7800,7800,7675,7725,-75
4635,2022-07-22,INTP,9400,9375,9525,9325,9450,50
4636,2022-07-22,MAPI,915,0,935,900,920,5
4637,2022-07-22,SIDO,985,0,990,970,975,-10
4638,2022-07-22,UNTR,30000,30000,30225,29850,30075,75
4639,2022-07-22,UNVR,5000,5000,5000,4940,5000,0
4640,2022-07-25,ACES,720,0,730,710,715,-5
4641,2022-07-25,AMRT,1875,1885,1885,1860,1885,10
4642,2022-07-25,ASII,6075,6050,6150,6050,6075,0
4643,2022-07-25,HRUM,1625,1635,1660,1580,1600,-25
4644,2022-07-25,INKP,7725,7725,7750,7650,7650,-75
4645,2022-07-25,INTP,9450,9325,9425,9225,9275,-175
4646,2022-07-25,MAPI,920,0,940,920,940,20
4647,2022-07-25,SIDO,975,0,985,970,980,5
4648,2022-07-25,UNTR,30075,30075,30750,30075,30575,500
4649,2022-07-25,UNVR,5000,4980,4980,4920,4930,-70
4650,2022-07-26,ACES,715,0,725,700,700,-15
4651,2022-07-26,AMRT,1885,1885,1890,1870,1890,5
4652,2022-07-26,ASII,6075,6100,6125,6075,6100,25
4653,2022-07-26,HRUM,1600,1615,1655,1610,1635,35
4654,2022-07-26,INKP,7650,7650,7725,7600,7650,0
4655,2022-07-26,INTP,9275,9275,9300,9150,9200,-75
4656,2022-07-26,MAPI,940,0,940,910,920,-20
4657,2022-07-26,SIDO,980,0,985,970,970,-10
4658,2022-07-26,UNTR,30575,30625,30675,30375,30600,25
4659,2022-07-26,UNVR,4930,4930,4950,4900,4930,0
4660,2022-07-27,ACES,700,0,710,685,710,10
4661,2022-07-27,AMRT,1890,1900,1920,1875,1910,20
4662,2022-07-27,ASII,6100,6125,6125,6000,6100,0
4663,2022-07-27,HRUM,1635,1650,1760,1625,1730,95
4664,2022-07-27,INKP,7650,7650,7700,7575,7675,25
4665,2022-07-27,INTP,9200,9200,9225,9100,9200,0
4666,2022-07-27,MAPI,920,0,930,905,910,-10
4667,2022-07-27,SIDO,970,0,990,970,975,5
4668,2022-07-27,UNTR,30600,30625,31375,30500,31100,500
4669,2022-07-27,UNVR,4930,4950,5025,4710,4720,-210
4670,2022-07-28,ACES,710,0,725,705,705,-5
4671,2022-07-28,AMRT,1910,1925,1925,1840,1885,-25
4672,2022-07-28,ASII,6100,6125,6150,6025,6050,-50
4673,2022-07-28,HRUM,1730,1780,1855,1745,1845,115
4674,2022-07-28,INKP,7675,7675,7875,7675,7800,125
4675,2022-07-28,INTP,9200,9225,9275,9175,9200,0
4676,2022-07-28,MAPI,910,0,920,880,880,-30
4677,2022-07-28,SIDO,975,0,990,970,970,-5
4678,2022-07-28,UNTR,31100,31425,31475,30725,31300,200
4679,2022-07-28,UNVR,4720,4720,4770,4500,4510,-210
4680,2022-07-29,ACES,705,0,720,700,710,5
4681,2022-07-29,AMRT,1885,1880,1885,1855,1875,-10
4682,2022-07-29,ASII,6050,6150,6425,6125,6325,275
4683,2022-07-29,HRUM,1845,1845,1875,1805,1845,0
4684,2022-07-29,INKP,7800,7850,7875,7600,7600,-200
4685,2022-07-29,INTP,9200,9225,9325,9150,9300,100
4686,2022-07-29,MAPI,880,0,905,880,890,10
4687,2022-07-29,SIDO,970,0,975,905,905,-65
4688,2022-07-29,UNTR,31300,33000,33500,32225,32300,1000
4689,2022-07-29,UNVR,4510,4520,4560,4480,4510,0
4690,2022-08-01,ACES,710,0,720,695,700,-10
4691,2022-08-01,AMRT,1875,1890,1910,1860,1880,5
4692,2022-08-01,ASII,6325,6425,6550,6350,6475,150
4693,2022-08-01,HRUM,1845,1900,1950,1875,1945,100
4694,2022-08-01,INKP,7600,7600,7700,7425,7600,0
4695,2022-08-01,INTP,9300,9300,9325,9100,9125,-175
4696,2022-08-01,MAPI,890,0,930,890,930,40
4697,2022-08-01,SIDO,905,0,905,845,845,-60
4698,2022-08-01,UNTR,32300,32150,32950,32075,32175,-125
4699,2022-08-01,UNVR,4510,4530,4650,4510,4550,40
4700,2022-08-02,ACES,700,0,710,690,690,-10
4701,2022-08-02,AMRT,1880,1900,1920,1890,1920,40
4702,2022-08-02,ASII,6475,6475,6475,6275,6475,0
4703,2022-08-02,HRUM,1945,1945,1950,1810,1810,-135
4704,2022-08-02,INKP,7600,7575,7675,7500,7675,75
4705,2022-08-02,INTP,9125,9125,9225,9125,9150,25
4706,2022-08-02,MAPI,930,0,1000,895,1000,70
4707,2022-08-02,SIDO,845,0,835,790,790,-55
4708,2022-08-02,UNTR,32175,32400,33000,32325,32875,700
4709,2022-08-02,UNVR,4550,4550,4610,4530,4600,50
4710,2022-08-03,ACES,690,0,695,655,655,-35
4711,2022-08-03,AMRT,1920,1930,1950,1895,1950,30
4712,2022-08-03,ASII,6475,6450,6600,6375,6600,125
4713,2022-08-03,HRUM,1810,1775,1835,1725,1785,-25
4714,2022-08-03,INKP,7675,7600,7700,7575,7675,0
4715,2022-08-03,INTP,9150,9200,9275,9075,9100,-50
4716,2022-08-03,MAPI,1000,0,980,930,930,-70
4717,2022-08-03,SIDO,790,0,820,740,765,-25
4718,2022-08-03,UNTR,32875,32625,34000,32625,33950,1075
4719,2022-08-03,UNVR,4600,4600,4600,4550,4590,-10
4720,2022-08-04,ACES,655,0,665,650,650,-5
4721,2022-08-04,AMRT,1950,1950,1950,1865,1875,-75
4722,2022-08-04,ASII,6600,6700,6700,6450,6600,0
4723,2022-08-04,HRUM,1785,1795,1815,1725,1730,-55
4724,2022-08-04,INKP,7675,7650,7800,7625,7800,125
4725,2022-08-04,INTP,9100,0,9650,9175,9625,525
4726,2022-08-04,MAPI,930,0,945,915,930,0
4727,2022-08-04,SIDO,765,0,795,765,770,5
4728,2022-08-04,UNTR,33950,33950,34050,33100,33200,-750
4729,2022-08-04,UNVR,4590,4590,4610,4530,4600,10
4730,2022-08-05,ACES,650,0,705,650,690,40
4731,2022-08-05,AMRT,1875,1870,1890,1810,1850,-25
4732,2022-08-05,ASII,6600,6600,6650,6475,6625,25
4733,2022-08-05,HRUM,1730,1725,1785,1700,1760,30
4734,2022-08-05,INKP,7800,7775,7925,7700,7800,0
4735,2022-08-05,INTP,9625,9750,9800,9525,9700,75
4736,2022-08-05,MAPI,930,0,975,935,960,30
4737,2022-08-05,SIDO,770,0,780,755,760,-10
4738,2022-08-05,UNTR,33200,33150,33150,32275,32500,-700
4739,2022-08-05,UNVR,4600,4650,4740,4620,4720,120
4740,2022-08-08,ACES,690,0,730,690,705,15
4741,2022-08-08,AMRT,1850,1855,1875,1820,1850,0
4742,2022-08-08,ASII,6625,6625,6700,6525,6700,75
4743,2022-08-08,HRUM,1760,1760,1795,1730,1775,15
4744,2022-08-08,INKP,7800,7800,7800,7675,7800,0
4745,2022-08-08,INTP,9700,9700,9850,9700,9750,50
4746,2022-08-08,MAPI,960,0,1060,970,980,20
4747,2022-08-08,SIDO,760,0,775,730,750,-10
4748,2022-08-08,UNTR,32500,32500,32750,32275,32400,-100
4749,2022-08-08,UNVR,4720,4740,4800,4730,4790,70
4750,2022-08-09,ACES,705,0,730,710,715,10
4751,2022-08-09,AMRT,1850,1850,1855,1825,1825,-25
4752,2022-08-09,ASII,6700,6725,6825,6700,6750,50
4753,2022-08-09,HRUM,1775,1800,1825,1790,1800,25
4754,2022-08-09,INKP,7800,7800,7875,7775,7775,-25
4755,2022-08-09,INTP,9750,9775,9875,9650,9650,-100
4756,2022-08-09,MAPI,980,0,1040,975,985,5
4757,2022-08-09,SIDO,750,0,780,750,775,25
4758,2022-08-09,UNTR,32400,32700,33675,32375,32375,-25
4759,2022-08-09,UNVR,4790,4800,4800,4720,4720,-70
4760,2022-08-10,ACES,715,0,730,710,720,5
4761,2022-08-10,AMRT,1825,1835,1855,1810,1840,15
4762,2022-08-10,ASII,6750,6775,6850,6600,6850,100
4763,2022-08-10,HRUM,1800,1805,1815,1770,1775,-25
4764,2022-08-10,INKP,7775,7775,7800,7650,7775,0
4765,2022-08-10,INTP,9650,9650,9725,9450,9725,75
4766,2022-08-10,MAPI,985,0,1000,955,965,-20
4767,2022-08-10,SIDO,775,0,780,770,770,-5
4768,2022-08-10,UNTR,32375,32675,33075,32300,32350,-25
4769,2022-08-10,UNVR,4720,4720,4780,4660,4780,60
4770,2022-08-11,ACES,720,0,730,705,720,0
4771,2022-08-11,AMRT,1840,1845,1875,1825,1840,0
4772,2022-08-11,ASII,6850,6975,7000,6900,6950,100
4773,2022-08-11,HRUM,1775,1825,1840,1790,1790,15
4774,2022-08-11,INKP,7775,7800,7825,7675,7725,-50
4775,2022-08-11,INTP,9725,9725,9775,9675,9675,-50
4776,2022-08-11,MAPI,965,0,1010,970,980,15
4777,2022-08-11,SIDO,770,0,780,765,765,-5
4778,2022-08-11,UNTR,32350,32950,32950,31900,31900,-450
4779,2022-08-11,UNVR,4780,4790,4800,4740,4750,-30
4780,2022-08-12,ACES,720,0,745,720,740,20
4781,2022-08-12,AMRT,1840,1840,1850,1785,1850,10
4782,2022-08-12,ASII,6950,6950,7000,6850,6950,0
4783,2022-08-12,HRUM,1790,1795,1805,1755,1765,-25
4784,2022-08-12,INKP,7725,7750,7975,7725,7800,75
4785,2022-08-12,INTP,9675,9700,9825,9525,9750,75
4786,2022-08-12,MAPI,980,0,1035,980,1020,40
4787,2022-08-12,SIDO,765,0,775,765,770,5
4788,2022-08-12,UNTR,31900,31600,31850,31225,31600,-300
4789,2022-08-12,UNVR,4750,4750,4850,4750,4770,20
4790,2022-08-15,ACES,740,0,765,725,730,-10
4791,2022-08-15,AMRT,1850,1850,1855,1825,1830,-20
4792,2022-08-15,ASII,6950,6925,6950,6800,6875,-75
4793,2022-08-15,HRUM,1765,1765,1775,1685,1690,-75
4794,2022-08-15,INKP,7800,7825,7950,7825,7875,75
4795,2022-08-15,INTP,9750,9750,9750,9550,9550,-200
4796,2022-08-15,MAPI,1020,0,1040,1015,1020,0
4797,2022-08-15,SIDO,770,0,785,770,775,5
4798,2022-08-15,UNTR,31600,31700,32675,31675,32500,900
4799,2022-08-15,UNVR,4770,4770,4780,4710,4760,-10
4800,2022-08-16,ACES,730,0,740,715,735,5
4801,2022-08-16,AMRT,1830,1840,1950,1840,1950,120
4802,2022-08-16,ASII,6875,6875,7050,6875,6975,100
4803,2022-08-16,HRUM,1690,1685,1690,1625,1630,-60
4804,2022-08-16,INKP,7875,7950,7950,7850,7900,25
4805,2022-08-16,INTP,9550,9575,9600,9450,9500,-50
4806,2022-08-16,MAPI,1020,0,1075,1010,1025,5
4807,2022-08-16,SIDO,775,0,780,770,770,-5
4808,2022-08-16,UNTR,32500,32600,32775,32025,32400,-100
4809,2022-08-16,UNVR,4760,4780,4810,4710,4770,10
4810,2022-08-18,ACES,735,0,740,715,720,-15
4811,2022-08-18,AMRT,1950,1950,1990,1935,1990,40
4812,2022-08-18,ASII,6975,6975,7000,6850,6975,0
4813,2022-08-18,HRUM,1630,1630,1705,1630,1675,45
4814,2022-08-18,INKP,7900,7900,7975,7875,7950,50
4815,2022-08-18,INTP,9500,9500,9525,9300,9300,-200
4816,2022-08-18,MAPI,1025,0,1075,1020,1065,40
4817,2022-08-18,SIDO,770,0,780,765,775,5
4818,2022-08-18,UNTR,32400,31925,32175,31725,32000,-400
4819,2022-08-18,UNVR,4770,4800,4810,4730,4790,20
4820,2022-08-19,ACES,720,0,745,720,745,25
4821,2022-08-19,AMRT,1990,1990,2090,1990,2090,100
4822,2022-08-19,ASII,6975,6975,7000,6900,6975,0
4823,2022-08-19,HRUM,1675,1695,1695,1665,1665,-10
4824,2022-08-19,INKP,7950,7950,8050,7875,8000,50
4825,2022-08-19,INTP,9300,9225,9250,9150,9200,-100
4826,2022-08-19,MAPI,1065,0,1105,1060,1070,5
4827,2022-08-19,SIDO,775,0,780,770,770,-5
4828,2022-08-19,UNTR,32000,31925,32100,31650,31650,-350
4829,2022-08-19,UNVR,4790,4810,4830,4730,4730,-60
4830,2022-08-22,ACES,745,0,760,735,750,5
4831,2022-08-22,AMRT,2090,2090,2100,2040,2090,0
4832,2022-08-22,ASII,6975,6875,6925,6800,6925,-50
4833,2022-08-22,HRUM,1665,1655,1660,1575,1580,-85
4834,2022-08-22,INKP,8000,8000,8000,7800,7925,-75
4835,2022-08-22,INTP,9200,9200,9300,9150,9225,25
4836,2022-08-22,MAPI,1070,0,1080,1000,1020,-50
4837,2022-08-22,SIDO,770,0,775,750,750,-20
4838,2022-08-22,UNTR,31650,31925,32025,31450,31800,150
4839,2022-08-22,UNVR,4730,4750,4800,4730,4750,20
4840,2022-08-23,ACES,750,0,760,740,760,10
4841,2022-08-23,AMRT,2090,2090,2140,2070,2100,10
4842,2022-08-23,ASII,6925,6900,7025,6850,6975,50
4843,2022-08-23,HRUM,1580,1580,1680,1580,1665,85
4844,2022-08-23,INKP,7925,7900,8075,7850,8050,125
4845,2022-08-23,INTP,9225,9275,9450,9225,9275,50
4846,2022-08-23,MAPI,1020,0,1035,1000,1015,-5
4847,2022-08-23,SIDO,750,0,780,745,750,0
4848,2022-08-23,UNTR,31800,31350,32375,31350,32125,325
4849,2022-08-23,UNVR,4750,4800,4830,4760,4810,60
4850,2022-08-24,ACES,760,0,780,755,765,5
4851,2022-08-24,AMRT,2100,2050,2100,2000,2010,-90
4852,2022-08-24,ASII,6975,6925,7050,6900,7050,75
4853,2022-08-24,HRUM,1665,1665,1730,1640,1700,35
4854,2022-08-24,INKP,8050,8050,8075,7975,8075,25
4855,2022-08-24,INTP,9275,9275,9525,9275,9500,225
4856,2022-08-24,MAPI,1015,0,1030,1005,1015,0
4857,2022-08-24,SIDO,750,0,755,750,750,0
4858,2022-08-24,UNTR,32125,32375,32850,32125,32625,500
4859,2022-08-24,UNVR,4810,4820,4880,4800,4850,40
4860,2022-08-25,ACES,765,0,765,745,745,-20
4861,2022-08-25,AMRT,2010,2020,2050,2000,2000,-10
4862,2022-08-25,ASII,7050,7050,7050,6950,6975,-75
4863,2022-08-25,HRUM,1700,1710,1730,1680,1710,10
4864,2022-08-25,INKP,8075,8075,8100,7925,7950,-125
4865,2022-08-25,INTP,9500,9500,9525,9300,9350,-150
4866,2022-08-25,MAPI,1015,0,1035,980,990,-25
4867,2022-08-25,SIDO,750,0,755,735,735,-15
4868,2022-08-25,UNTR,32625,32850,33000,32450,32950,325
4869,2022-08-25,UNVR,4850,4850,4870,4800,4840,-10
4870,2022-08-26,ACES,745,0,750,735,740,-5
4871,2022-08-26,AMRT,2000,2030,2080,1995,2020,20
4872,2022-08-26,ASII,6975,6975,7025,6850,6875,-100
4873,2022-08-26,HRUM,1710,1720,1725,1685,1690,-20
4874,2022-08-26,INKP,7950,7950,8250,7950,8250,300
4875,2022-08-26,INTP,9350,9350,9375,9300,9300,-50
4876,2022-08-26,MAPI,990,0,1015,990,990,0
4877,2022-08-26,SIDO,735,0,740,715,715,-20
4878,2022-08-26,UNTR,32950,33150,33325,33025,33100,150
4879,2022-08-26,UNVR,4840,4850,4850,4610,4610,-230
4880,2022-08-29,ACES,740,0,740,720,720,-20
4881,2022-08-29,AMRT,2020,1990,2030,1975,2020,0
4882,2022-08-29,ASII,6875,6800,6900,6750,6825,-50
4883,2022-08-29,HRUM,1690,1665,1730,1625,1725,35
4884,2022-08-29,INKP,8250,8000,8350,8000,8350,100
4885,2022-08-29,INTP,9300,9200,9325,9200,9325,25
4886,2022-08-29,MAPI,990,0,985,960,970,-20
4887,2022-08-29,SIDO,715,0,720,705,705,-10
4888,2022-08-29,UNTR,33100,32750,33000,32275,33000,-100
4889,2022-08-29,UNVR,4610,4560,4600,4510,4580,-30
4890,2022-08-30,ACES,720,0,735,720,725,5
4891,2022-08-30,AMRT,2020,2020,2070,2020,2030,10
4892,2022-08-30,ASII,6825,6850,7025,6850,6900,75
4893,2022-08-30,HRUM,1725,1745,1765,1725,1755,30
4894,2022-08-30,INKP,8350,8375,8425,8300,8375,25
4895,2022-08-30,INTP,9325,9300,9425,9275,9300,-25
4896,2022-08-30,MAPI,970,0,1005,960,980,10
4897,2022-08-30,SIDO,705,0,735,705,720,15
4898,2022-08-30,UNTR,33000,33000,33825,32750,33325,325
4899,2022-08-30,UNVR,4580,4590,4630,4580,4580,0
4900,2022-08-31,ACES,725,0,730,700,720,-5
4901,2022-08-31,AMRT,2030,2050,2180,2020,2180,150
4902,2022-08-31,ASII,6900,6875,6975,6775,6975,75
4903,2022-08-31,HRUM,1755,1755,1755,1690,1700,-55
4904,2022-08-31,INKP,8375,8450,8500,8300,8325,-50
4905,2022-08-31,INTP,9300,9300,9450,9250,9450,150
4906,2022-08-31,MAPI,980,0,1035,980,1010,30
4907,2022-08-31,SIDO,720,0,725,710,710,-10
4908,2022-08-31,UNTR,33325,33075,33850,32700,33850,525
4909,2022-08-31,UNVR,4580,4580,4620,4530,4590,10
4910,2022-09-01,ACES,720,0,735,715,720,0
4911,2022-09-01,AMRT,2180,2150,2150,2050,2080,-100
4912,2022-09-01,ASII,6975,6975,7025,6900,6925,-50
4913,2022-09-01,HRUM,1700,1705,1740,1700,1710,10
4914,2022-09-01,INKP,8325,8350,8375,8200,8250,-75
4915,2022-09-01,INTP,9450,9450,9450,9275,9300,-150
4916,2022-09-01,MAPI,1010,0,1025,1000,1010,0
4917,2022-09-01,SIDO,710,0,715,705,705,-5
4918,2022-09-01,UNTR,33850,33750,33750,33275,33275,-575
4919,2022-09-01,UNVR,4590,4590,4610,4540,4540,-50
4920,2022-09-02,ACES,720,0,720,700,705,-15
4921,2022-09-02,AMRT,2080,2030,2090,2030,2060,-20
4922,2022-09-02,ASII,6925,6950,7000,6875,6925,0
4923,2022-09-02,HRUM,1710,1725,1730,1665,1685,-25
4924,2022-09-02,INKP,8250,8300,8925,8275,8850,600
4925,2022-09-02,INTP,9300,9300,9475,9300,9475,175
4926,2022-09-02,MAPI,1010,0,1060,1010,1050,40
4927,2022-09-02,SIDO,705,0,720,705,715,10
4928,2022-09-02,UNTR,33275,33300,33950,33300,33900,625
4929,2022-09-02,UNVR,4540,4540,4600,4540,4550,10
4930,2022-09-05,ACES,705,0,705,665,665,-40
4931,2022-09-05,AMRT,2060,2080,2150,2040,2100,40
4932,2022-09-05,ASII,6925,6900,6925,6850,6875,-50
4933,2022-09-05,HRUM,1685,1685,1815,1685,1810,125
4934,2022-09-05,INKP,8850,8850,8975,8700,8725,-125
4935,2022-09-05,INTP,9475,9450,9475,9325,9450,-25
4936,2022-09-05,MAPI,1050,0,1050,1010,1020,-30
4937,2022-09-05,SIDO,715,0,720,705,715,0
4938,2022-09-05,UNTR,33900,33850,34975,33675,34350,450
4939,2022-09-05,UNVR,4550,4550,4570,4510,4530,-20
4940,2022-09-06,ACES,665,0,695,655,660,-5
4941,2022-09-06,AMRT,2100,2110,2150,2070,2080,-20
4942,2022-09-06,ASII,6875,6875,6950,6850,6900,25
4943,2022-09-06,HRUM,1810,1840,1885,1820,1855,45
4944,2022-09-06,INKP,8725,8750,8800,8600,8675,-50
4945,2022-09-06,INTP,9450,9450,9475,9325,9450,0
4946,2022-09-06,MAPI,1020,0,1030,990,990,-30
4947,2022-09-06,SIDO,715,0,720,710,715,0
4948,2022-09-06,UNTR,34350,34850,35925,34550,35500,1150
4949,2022-09-06,UNVR,4530,4530,4540,4450,4510,-20
4950,2022-09-07,ACES,660,0,685,660,680,20
4951,2022-09-07,AMRT,2080,2080,2130,2060,2100,20
4952,2022-09-07,ASII,6900,6800,6875,6625,6650,-250
4953,2022-09-07,HRUM,1855,1855,1855,1780,1810,-45
4954,2022-09-07,INKP,8675,8700,8950,8550,8900,225
4955,2022-09-07,INTP,9450,9450,9650,9400,9550,100
4956,2022-09-07,MAPI,990,0,1005,955,965,-25
4957,2022-09-07,SIDO,715,0,725,710,715,0
4958,2022-09-07,UNTR,35500,35425,35425,34700,35075,-425
4959,2022-09-07,UNVR,4510,4510,4590,4490,4590,80
4960,2022-09-08,ACES,680,0,690,680,685,5
4961,2022-09-08,AMRT,2100,2120,2130,2090,2090,-10
4962,2022-09-08,ASII,6650,6650,6750,6625,6650,0
4963,2022-09-08,HRUM,1810,1800,1830,1765,1770,-40
4964,2022-09-08,INKP,8900,8950,9725,8950,9675,775
4965,2022-09-08,INTP,9550,9650,9650,9550,9575,25
4966,2022-09-08,MAPI,965,0,995,965,985,20
4967,2022-09-08,SIDO,715,0,720,710,720,5
4968,2022-09-08,UNTR,35075,35025,35500,34400,34400,-675
4969,2022-09-08,UNVR,4590,4590,4610,4520,4520,-70
4970,2022-09-09,ACES,685,0,690,670,675,-10
4971,2022-09-09,AMRT,2090,2120,2130,2100,2110,20
4972,2022-09-09,ASII,6650,6675,6775,6625,6775,125
4973,2022-09-09,HRUM,1770,1770,1830,1740,1830,60
4974,2022-09-09,INKP,9675,9700,9900,9525,9525,-150
4975,2022-09-09,INTP,9575,9600,9700,9575,9625,50
4976,2022-09-09,MAPI,985,0,995,975,995,10
4977,2022-09-09,SIDO,720,0,725,700,705,-15
4978,2022-09-09,UNTR,34400,34400,34500,34050,34300,-100
4979,2022-09-09,UNVR,4520,4520,4570,4500,4500,-20
4980,2022-09-12,ACES,675,0,685,670,680,5
4981,2022-09-12,AMRT,2110,2150,2300,2130,2140,30
4982,2022-09-12,ASII,6775,6775,6975,6725,6975,200
4983,2022-09-12,HRUM,1830,1850,1875,1805,1815,-15
4984,2022-09-12,INKP,9525,9525,9750,9425,9650,125
4985,2022-09-12,INTP,9625,9650,9650,9450,9525,-100
4986,2022-09-12,MAPI,995,0,1060,995,1055,60
4987,2022-09-12,SIDO,705,0,715,700,710,5
4988,2022-09-12,UNTR,34300,34325,34825,34275,34500,200
4989,2022-09-12,UNVR,4500,4510,4560,4510,4550,50
4990,2022-09-13,ACES,680,0,685,675,680,0
4991,2022-09-13,AMRT,2140,2190,2280,2160,2220,80
4992,2022-09-13,ASII,6975,7025,7225,6950,7200,225
4993,2022-09-13,HRUM,1815,1850,1950,1840,1920,105
4994,2022-09-13,INKP,9650,9650,9750,9550,9600,-50
4995,2022-09-13,INTP,9525,9525,9675,9475,9650,125
4996,2022-09-13,MAPI,1055,0,1060,1015,1020,-35
4997,2022-09-13,SIDO,710,0,720,710,715,5
4998,2022-09-13,UNTR,34500,34500,34750,34325,34350,-150
4999,2022-09-13,UNVR,4550,4570,4670,4560,4670,120
5000,2022-09-14,ACES,680,0,680,665,670,-10
5001,2022-09-14,AMRT,2220,2220,2250,2140,2250,30
5002,2022-09-14,ASII,7200,7100,7300,7050,7150,-50
5003,2022-09-14,HRUM,1920,1895,2000,1865,2000,80
5004,2022-09-14,INKP,9600,9500,9675,9400,9500,-100
5005,2022-09-14,INTP,9650,9550,9675,9525,9675,25
5006,2022-09-14,MAPI,1020,0,1050,1005,1050,30
5007,2022-09-14,SIDO,715,0,715,705,710,-5
5008,2022-09-14,UNTR,34350,34000,34175,33750,34000,-350
5009,2022-09-14,UNVR,4670,4640,4640,4600,4630,-40
5010,2022-09-15,ACES,670,0,675,665,670,0
5011,2022-09-15,AMRT,2250,2280,2360,2220,2330,80
5012,2022-09-15,ASII,7150,7125,7225,7050,7050,-100
5013,2022-09-15,HRUM,2000,2000,2050,1965,1970,-30
5014,2022-09-15,INKP,9500,9575,9675,9500,9500,0
5015,2022-09-15,INTP,9675,9675,9750,9550,9600,-75
5016,2022-09-15,MAPI,1050,0,1115,1050,1095,45
5017,2022-09-15,SIDO,710,0,715,705,710,0
5018,2022-09-15,UNTR,34000,35000,36200,34825,34900,900
5019,2022-09-15,UNVR,4630,4640,4660,4580,4600,-30
5020,2022-09-16,ACES,670,0,675,660,660,-10
5021,2022-09-16,AMRT,2330,2290,2330,2210,2230,-100
5022,2022-09-16,ASII,7050,7000,7050,6900,6900,-150
5023,2022-09-16,HRUM,1970,1950,1960,1900,1910,-60
5024,2022-09-16,INKP,9500,9500,9500,9200,9250,-250
5025,2022-09-16,INTP,9600,9625,9925,9575,9925,325
5026,2022-09-16,MAPI,1095,0,1125,1065,1080,-15
5027,2022-09-16,SIDO,710,0,725,710,710,0
5028,2022-09-16,UNTR,34900,34900,34900,33925,34325,-575
5029,2022-09-16,UNVR,4600,4640,4640,4610,4630,30
5030,2022-09-19,ACES,660,0,665,650,660,0
5031,2022-09-19,AMRT,2230,2300,2320,2230,2250,20
5032,2022-09-19,ASII,6900,6950,7225,6925,7125,225
5033,2022-09-19,HRUM,1910,1950,1955,1830,1880,-30
5034,2022-09-19,INKP,9250,9250,9375,8975,9300,50
5035,2022-09-19,INTP,9925,9925,9950,9750,9925,0
5036,2022-09-19,MAPI,1080,0,1115,1070,1100,20
5037,2022-09-19,SIDO,710,0,745,710,745,35
5038,2022-09-19,UNTR,34325,34050,34925,33900,34300,-25
5039,2022-09-19,UNVR,4630,4630,4630,4510,4600,-30
5040,2022-09-20,ACES,660,0,665,655,660,0
5041,2022-09-20,AMRT,2250,2250,2290,2230,2240,-10
5042,2022-09-20,ASII,7125,7150,7250,7100,7175,50
5043,2022-09-20,HRUM,1880,1885,1910,1840,1850,-30
5044,2022-09-20,INKP,9300,9300,9475,9075,9075,-225
5045,2022-09-20,INTP,9925,9975,10225,9850,10100,175
5046,2022-09-20,MAPI,1100,0,1145,1090,1135,35
5047,2022-09-20,SIDO,745,0,760,720,720,-25
5048,2022-09-20,UNTR,34300,34575,34950,34000,34150,-150
5049,2022-09-20,UNVR,4600,4630,4730,4620,4730,130
5050,2022-09-21,ACES,660,0,665,650,650,-10
5051,2022-09-21,AMRT,2240,2290,2320,2230,2300,60
5052,2022-09-21,ASII,7175,7125,7200,7100,7150,-25
5053,2022-09-21,HRUM,1850,1850,1900,1830,1900,50
5054,2022-09-21,INKP,9075,9050,9175,8900,8950,-125
5055,2022-09-21,INTP,10100,10175,10200,10000,10150,50
5056,2022-09-21,MAPI,1135,0,1150,1100,1140,5
5057,2022-09-21,SIDO,720,0,735,715,730,10
5058,2022-09-21,UNTR,34150,34000,34450,33425,34325,175
5059,2022-09-21,UNVR,4730,4730,4840,4730,4810,80
5060,2022-09-22,ACES,650,0,655,615,630,-20
5061,2022-09-22,AMRT,2300,2340,2400,2300,2310,10
5062,2022-09-22,ASII,7150,7025,7225,7000,7175,25
5063,2022-09-22,HRUM,1900,1870,1960,1865,1940,40
5064,2022-09-22,INKP,8950,8900,9125,8850,9100,150
5065,2022-09-22,INTP,10150,10050,10075,9900,10075,-75
5066,2022-09-22,MAPI,1140,0,1160,1110,1120,-20
5067,2022-09-22,SIDO,730,0,735,720,720,-10
5068,2022-09-22,UNTR,34325,34200,35100,33925,35100,775
5069,2022-09-22,UNVR,4810,4810,4810,4740,4810,0
5070,2022-09-23,ACES,630,0,640,620,625,-5
5071,2022-09-23,AMRT,2310,2390,2410,2320,2390,80
5072,2022-09-23,ASII,7175,7100,7175,7050,7150,-25
5073,2022-09-23,HRUM,1940,1930,2000,1905,1920,-20
5074,2022-09-23,INKP,9100,9100,9275,9075,9275,175
5075,2022-09-23,INTP,10075,10075,10225,9950,10125,50
5076,2022-09-23,MAPI,1120,0,1155,1075,1080,-40
5077,2022-09-23,SIDO,720,0,725,715,720,0
5078,2022-09-23,UNTR,35100,35000,35000,34000,34000,-1100
5079,2022-09-23,UNVR,4810,4810,4820,4770,4810,0
5080,2022-09-26,ACES,625,0,650,615,650,25
5081,2022-09-26,AMRT,2390,2450,2450,2340,2360,-30
5082,2022-09-26,ASII,7150,7000,7025,6850,6975,-175
5083,2022-09-26,HRUM,1920,1865,1875,1790,1825,-95
5084,2022-09-26,INKP,9275,9225,9250,8950,9100,-175
5085,2022-09-26,INTP,10125,10100,10175,9900,10025,-100
5086,2022-09-26,MAPI,1080,0,1130,1065,1120,40
5087,2022-09-26,SIDO,720,0,725,710,720,0
5088,2022-09-26,UNTR,34000,33300,33325,32000,33300,-700
5089,2022-09-26,UNVR,4810,4810,4830,4750,4790,-20
5090,2022-09-27,ACES,650,0,660,635,650,0
5091,2022-09-27,AMRT,2360,2360,2390,2280,2360,0
5092,2022-09-27,ASII,6975,7000,7050,6950,6950,-25
5093,2022-09-27,HRUM,1825,1825,1855,1800,1840,15
5094,2022-09-27,INKP,9100,9100,9250,9025,9050,-50
5095,2022-09-27,INTP,10025,10025,10025,9800,9875,-150
5096,2022-09-27,MAPI,1120,0,1130,1080,1115,-5
5097,2022-09-27,SIDO,720,0,720,710,715,-5
5098,2022-09-27,UNTR,33300,33300,33650,33075,33400,100
5099,2022-09-27,UNVR,4790,4800,4810,4770,4800,10
5100,2022-09-28,ACES,650,0,650,630,635,-15
5101,2022-09-28,AMRT,2360,2370,2380,2350,2380,20
5102,2022-09-28,ASII,6950,6950,7000,6800,6800,-150
5103,2022-09-28,HRUM,1840,1830,1835,1755,1760,-80
5104,2022-09-28,INKP,9050,9050,9100,8900,8900,-150
5105,2022-09-28,INTP,9875,9875,9925,9650,9825,-50
5106,2022-09-28,MAPI,1115,0,1115,1045,1050,-65
5107,2022-09-28,SIDO,715,0,720,710,710,-5
5108,2022-09-28,UNTR,33400,33400,33725,33000,33000,-400
5109,2022-09-28,UNVR,4800,4800,4840,4780,4810,10
5110,2022-09-29,ACES,635,0,655,630,640,5
5111,2022-09-29,AMRT,2380,2380,2400,2350,2400,20
5112,2022-09-29,ASII,6800,6850,6900,6700,6775,-25
5113,2022-09-29,HRUM,1760,1780,1815,1765,1790,30
5114,2022-09-29,INKP,8900,9000,9100,8950,9075,175
5115,2022-09-29,INTP,9825,9825,9875,9650,9725,-100
5116,2022-09-29,MAPI,1050,0,1105,1000,1060,10
5117,2022-09-29,SIDO,710,0,715,710,715,5
5118,2022-09-29,UNTR,33000,33000,33750,32800,33125,125
5119,2022-09-29,UNVR,4810,4800,4870,4790,4850,40
5120,2022-09-30,ACES,640,0,640,605,610,-30
5121,2022-09-30,AMRT,2400,2400,2400,2330,2390,-10
5122,2022-09-30,ASII,6775,6700,6750,6600,6625,-150
5123,2022-09-30,HRUM,1790,1770,1785,1715,1780,-10
5124,2022-09-30,INKP,9075,9075,9150,8625,9050,-25
5125,2022-09-30,INTP,9725,9700,9700,9475,9500,-225
5126,2022-09-30,MAPI,1060,0,1075,1035,1060,0
5127,2022-09-30,SIDO,715,0,715,700,710,-5
5128,2022-09-30,UNTR,33125,32875,33100,32575,32825,-300
5129,2022-09-30,UNVR,4850,4840,4850,4710,4830,-20
5130,2022-10-03,ACES,610,0,615,600,605,-5
5131,2022-10-03,AMRT,2390,2300,2400,2290,2380,-10
5132,2022-10-03,ASII,6625,6650,6700,6600,6625,0
5133,2022-10-03,HRUM,1780,1770,1820,1755,1785,5
5134,2022-10-03,INKP,9050,9050,9400,8850,9250,200
5135,2022-10-03,INTP,9500,9500,9525,9375,9400,-100
5136,2022-10-03,MAPI,1060,0,1070,1040,1050,-10
5137,2022-10-03,SIDO,710,0,710,705,705,-5
5138,2022-10-03,UNTR,32825,32825,33200,32675,33000,175
5139,2022-10-03,UNVR,4830,4830,4870,4820,4850,20
5140,2022-10-04,ACES,605,0,620,605,615,10
5141,2022-10-04,AMRT,2380,2390,2400,2380,2400,20
5142,2022-10-04,ASII,6625,6725,6800,6700,6725,100
5143,2022-10-04,HRUM,1785,1820,1845,1815,1835,50
5144,2022-10-04,INKP,9250,9375,9700,9350,9650,400
5145,2022-10-04,INTP,9400,9500,9500,9300,9300,-100
5146,2022-10-04,MAPI,1050,0,1085,1015,1020,-30
5147,2022-10-04,SIDO,705,0,710,700,705,0
5148,2022-10-04,UNTR,33000,33300,34100,33300,33800,800
5149,2022-10-04,UNVR,4850,4880,4900,4850,4870,20
5150,2022-10-05,ACES,615,0,630,610,615,0
5151,2022-10-05,AMRT,2400,2400,2400,2360,2390,-10
5152,2022-10-05,ASII,6725,6800,6825,6675,6675,-50
5153,2022-10-05,HRUM,1835,1840,1865,1825,1830,-5
5154,2022-10-05,INKP,9650,9650,9700,9375,9375,-275
5155,2022-10-05,INTP,9300,9375,9375,9225,9250,-50
5156,2022-10-05,MAPI,1020,0,1045,1020,1030,10
5157,2022-10-05,SIDO,705,0,710,700,700,-5
5158,2022-10-05,UNTR,33800,33125,34000,33075,33075,-725
5159,2022-10-05,UNVR,4870,4900,4900,4830,4830,-40
5160,2022-10-06,ACES,615,0,620,610,615,0
5161,2022-10-06,AMRT,2390,2400,2400,2370,2390,0
5162,2022-10-06,ASII,6675,6675,6750,6600,6600,-75
5163,2022-10-06,HRUM,1830,1830,1860,1825,1825,-5
5164,2022-10-06,INKP,9375,9375,9525,9300,9525,150
5165,2022-10-06,INTP,9250,9250,9300,9125,9125,-125
5166,2022-10-06,MAPI,1030,0,1085,1030,1070,40
5167,2022-10-06,SIDO,700,0,710,700,705,5
5168,2022-10-06,UNTR,33075,33375,33600,32800,32850,-225
5169,2022-10-06,UNVR,4830,4860,4900,4840,4900,70
5170,2022-10-07,ACES,615,0,620,605,610,-5
5171,2022-10-07,AMRT,2390,2390,2390,2330,2330,-60
5172,2022-10-07,ASII,6600,6550,6575,6450,6475,-125
5173,2022-10-07,HRUM,1825,1820,1835,1805,1820,-5
5174,2022-10-07,INKP,9525,9525,9525,9200,9250,-275
5175,2022-10-07,INTP,9125,9150,9175,9100,9125,0
5176,2022-10-07,MAPI,1070,0,1115,1050,1115,45
5177,2022-10-07,SIDO,705,0,720,705,715,10
5178,2022-10-07,UNTR,32850,32950,33175,32700,33000,150
5179,2022-10-07,UNVR,4900,4900,4910,4760,4840,-60
5180,2022-10-10,ACES,610,0,615,580,585,-25
5181,2022-10-10,AMRT,2330,2330,2390,2320,2390,60
5182,2022-10-10,ASII,6475,6425,6525,6375,6500,25
5183,2022-10-10,HRUM,1820,1800,1800,1755,1775,-45
5184,2022-10-10,INKP,9250,9175,9175,9025,9075,-175
5185,2022-10-10,INTP,9125,9125,9175,9075,9100,-25
5186,2022-10-10,MAPI,1115,0,1115,1065,1075,-40
5187,2022-10-10,SIDO,715,0,715,700,705,-10
5188,2022-10-10,UNTR,33000,32700,32700,32000,32300,-700
5189,2022-10-10,UNVR,4840,4840,4840,4700,4800,-40
5190,2022-10-11,ACES,585,0,600,575,585,0
5191,2022-10-11,AMRT,2390,2390,2400,2340,2340,-50
5192,2022-10-11,ASII,6500,6400,6575,6400,6525,25
5193,2022-10-11,HRUM,1775,1780,1780,1730,1730,-45
5194,2022-10-11,INKP,9075,9075,9075,8800,8875,-200
5195,2022-10-11,INTP,9100,9150,9375,9075,9350,250
5196,2022-10-11,MAPI,1075,0,1155,1070,1155,80
5197,2022-10-11,SIDO,705,0,710,695,700,-5
5198,2022-10-11,UNTR,32300,32300,32600,32050,32200,-100
5199,2022-10-11,UNVR,4800,4780,4780,4730,4730,-70
5200,2022-10-12,ACES,585,0,590,545,545,-40
5201,2022-10-12,AMRT,2340,2350,2400,2350,2390,50
5202,2022-10-12,ASII,6525,6450,6475,6350,6350,-175
5203,2022-10-12,HRUM,1730,1730,1765,1700,1720,-10
5204,2022-10-12,INKP,8875,8900,9025,8750,8925,50
5205,2022-10-12,INTP,9350,9400,9400,9125,9200,-150
5206,2022-10-12,MAPI,1155,0,1190,1125,1190,35
5207,2022-10-12,SIDO,700,0,700,655,660,-40
5208,2022-10-12,UNTR,32200,32300,32600,31400,32350,150
5209,2022-10-12,UNVR,4730,4730,4790,4660,4790,60
5210,2022-10-13,ACES,545,0,545,510,510,-35
5211,2022-10-13,AMRT,2390,2390,2500,2380,2490,100
5212,2022-10-13,ASII,6350,6375,6400,6275,6350,0
5213,2022-10-13,HRUM,1720,1755,1755,1720,1730,10
5214,2022-10-13,INKP,8925,8900,9125,8850,8950,25
5215,2022-10-13,INTP,9200,9200,9225,9100,9150,-50
5216,2022-10-13,MAPI,1190,0,1200,1150,1200,10
5217,2022-10-13,SIDO,660,0,665,640,655,-5
5218,2022-10-13,UNTR,32350,32425,32500,32000,32200,-150
5219,2022-10-13,UNVR,4790,4790,4840,4770,4840,50
5220,2022-10-14,ACES,510,0,535,510,525,15
5221,2022-10-14,AMRT,2490,2500,2560,2470,2510,20
5222,2022-10-14,ASII,6350,6500,6500,6350,6350,0
5223,2022-10-14,HRUM,1730,1750,1750,1700,1725,-5
5224,2022-10-14,INKP,8950,9075,9100,8725,8825,-125
5225,2022-10-14,INTP,9150,9200,9275,9050,9050,-100
5226,2022-10-14,MAPI,1200,0,1250,1170,1190,-10
5227,2022-10-14,SIDO,655,0,665,650,655,0
5228,2022-10-14,UNTR,32200,32350,33750,32350,33750,1550
5229,2022-10-14,UNVR,4840,4840,4860,4770,4810,-30
5230,2022-10-17,ACES,525,0,530,505,525,0
5231,2022-10-17,AMRT,2510,2490,2500,2450,2500,-10
5232,2022-10-17,ASII,6350,6325,6525,6200,6425,75
5233,2022-10-17,HRUM,1725,1715,1715,1620,1655,-70
5234,2022-10-17,INKP,8825,8800,8975,8675,8925,100
5235,2022-10-17,INTP,9050,9050,9150,9000,9150,100
5236,2022-10-17,MAPI,1190,0,1200,1125,1160,-30
5237,2022-10-17,SIDO,655,0,655,630,635,-20
5238,2022-10-17,UNTR,33750,33600,33600,32550,32900,-850
5239,2022-10-17,UNVR,4810,4850,4850,4800,4830,20
5240,2022-10-18,ACES,525,0,545,515,535,10
5241,2022-10-18,AMRT,2500,2500,2700,2490,2700,200
5242,2022-10-18,ASII,6425,6450,6500,6350,6350,-75
5243,2022-10-18,HRUM,1655,1680,1680,1600,1610,-45
5244,2022-10-18,INKP,8925,9000,9025,8750,8775,-150
5245,2022-10-18,INTP,9150,9200,9275,9100,9250,100
5246,2022-10-18,MAPI,1160,0,1180,1140,1140,-20
5247,2022-10-18,SIDO,635,0,655,635,650,15
5248,2022-10-18,UNTR,32900,32725,32850,32000,32000,-900
5249,2022-10-18,UNVR,4830,4850,4900,4810,4900,70
5250,2022-10-19,ACES,535,0,540,525,530,-5
5251,2022-10-19,AMRT,2700,2650,2650,2520,2590,-110
5252,2022-10-19,ASII,6350,6425,6525,6400,6525,175
5253,2022-10-19,HRUM,1610,1610,1610,1570,1575,-35
5254,2022-10-19,INKP,8775,8775,8825,8700,8775,0
5255,2022-10-19,INTP,9250,9250,9500,9175,9425,175
5256,2022-10-19,MAPI,1140,0,1250,1130,1215,75
5257,2022-10-19,SIDO,650,0,685,645,665,15
5258,2022-10-19,UNTR,32000,31700,32075,31500,31800,-200
5259,2022-10-19,UNVR,4900,4930,5375,4930,5350,450
5260,2022-10-20,ACES,530,0,535,500,500,-30
5261,2022-10-20,AMRT,2590,2590,2650,2570,2630,40
5262,2022-10-20,ASII,6525,6500,6525,6400,6425,-100
5263,2022-10-20,HRUM,1575,1585,1630,1575,1630,55
5264,2022-10-20,INKP,8775,8775,9150,8775,9050,275
5265,2022-10-20,INTP,9425,9400,9525,9200,9200,-225
5266,2022-10-20,MAPI,1215,0,1270,1185,1250,35
5267,2022-10-20,SIDO,665,0,685,655,655,-10
5268,2022-10-20,UNTR,31800,31850,32050,31600,31825,25
5269,2022-10-20,UNVR,5350,5350,5450,5225,5400,50
5270,2022-10-21,ACES,500,0,535,488,535,35
5271,2022-10-21,AMRT,2630,2620,2660,2600,2630,0
5272,2022-10-21,ASII,6425,6475,6675,6450,6575,150
5273,2022-10-21,HRUM,1630,1630,1650,1610,1610,-20
5274,2022-10-21,INKP,9050,9050,9075,8875,9000,-50
5275,2022-10-21,INTP,9200,9275,9325,9225,9250,50
5276,2022-10-21,MAPI,1250,0,1250,1200,1225,-25
5277,2022-10-21,SIDO,655,0,695,650,675,20
5278,2022-10-21,UNTR,31825,31900,32525,31900,32000,175
5279,2022-10-21,UNVR,5400,5400,5400,5250,5300,-100
5280,2022-10-24,ACES,535,0,555,535,540,5
5281,2022-10-24,AMRT,2630,2640,2670,2620,2630,0
5282,2022-10-24,ASII,6575,6575,6700,6575,6650,75
5283,2022-10-24,HRUM,1610,1615,1635,1595,1610,0
5284,2022-10-24,INKP,9000,9050,9275,8950,9125,125
5285,2022-10-24,INTP,9250,9275,9425,9250,9275,25
5286,2022-10-24,MAPI,1225,0,1265,1205,1240,15
5287,2022-10-24,SIDO,675,0,715,675,710,35
5288,2022-10-24,UNTR,32000,32000,32725,32000,32375,375
5289,2022-10-24,UNVR,5300,5275,5475,5250,5325,25
5290,2022-10-25,ACES,540,0,550,510,520,-20
5291,2022-10-25,AMRT,2630,2650,2730,2600,2700,70
5292,2022-10-25,ASII,6650,6700,6700,6600,6700,50
5293,2022-10-25,HRUM,1610,1615,1620,1555,1565,-45
5294,2022-10-25,INKP,9125,9175,9225,8925,9150,25
5295,2022-10-25,INTP,9275,9275,9275,9100,9125,-150
5296,2022-10-25,MAPI,1240,0,1240,1190,1200,-40
5297,2022-10-25,SIDO,710,0,725,700,705,-5
5298,2022-10-25,UNTR,32375,32400,32750,31875,32000,-375
5299,2022-10-25,UNVR,5325,5325,5375,5200,5275,-50
5300,2022-10-26,ACES,520,0,550,492,535,15
5301,2022-10-26,AMRT,2700,2680,2700,2650,2660,-40
5302,2022-10-26,ASII,6700,6700,6700,6575,6575,-125
5303,2022-10-26,HRUM,1565,1570,1610,1565,1605,40
5304,2022-10-26,INKP,9150,9175,9200,9025,9050,-100
5305,2022-10-26,INTP,9125,9125,9250,9125,9250,125
5306,2022-10-26,MAPI,1200,0,1265,1180,1185,-15
5307,2022-10-26,SIDO,705,0,720,700,715,10
5308,2022-10-26,UNTR,32000,32625,33200,32525,33200,1200
5309,2022-10-26,UNVR,5275,5250,5400,5175,5400,125
5310,2022-10-27,ACES,535,0,590,530,570,35
5311,2022-10-27,AMRT,2660,2680,2720,2680,2720,60
5312,2022-10-27,ASII,6575,6575,6675,6525,6650,75
5313,2022-10-27,HRUM,1605,1615,1670,1605,1615,10
5314,2022-10-27,INKP,9050,9050,9400,9050,9225,175
5315,2022-10-27,INTP,9250,9250,9300,9200,9200,-50
5316,2022-10-27,MAPI,1185,0,1330,1180,1250,65
5317,2022-10-27,SIDO,715,0,745,715,740,25
5318,2022-10-27,UNTR,33200,33200,33725,32750,32750,-450
5319,2022-10-27,UNVR,5400,5400,5450,5275,5350,-50
5320,2022-10-28,ACES,570,0,595,555,560,-10
5321,2022-10-28,AMRT,2720,2720,2770,2700,2760,40
5322,2022-10-28,ASII,6650,6650,6650,6500,6550,-100
5323,2022-10-28,HRUM,1615,1620,1625,1585,1590,-25
5324,2022-10-28,INKP,9225,9300,9400,9150,9300,75
5325,2022-10-28,INTP,9200,9200,9275,9125,9275,75
5326,2022-10-28,MAPI,1250,0,1260,1205,1235,-15
5327,2022-10-28,SIDO,740,0,750,730,740,0
5328,2022-10-28,UNTR,32750,32800,32975,32150,32250,-500
5329,2022-10-28,UNVR,5350,5050,5075,4980,4980,-370
5330,2022-10-31,ACES,560,0,575,550,565,5
5331,2022-10-31,AMRT,2760,2760,2840,2740,2820,60
5332,2022-10-31,ASII,6550,6550,6650,6550,6650,100
5333,2022-10-31,HRUM,1590,1615,1625,1595,1610,20
5334,2022-10-31,INKP,9300,9375,9600,9350,9600,300
5335,2022-10-31,INTP,9275,9275,9325,9200,9275,0
5336,2022-10-31,MAPI,1235,0,1260,1205,1205,-30
5337,2022-10-31,SIDO,740,0,745,730,740,0
5338,2022-10-31,UNTR,32250,32275,32750,32100,32300,50
5339,2022-10-31,UNVR,4980,4650,4740,4640,4640,-340
5340,2022-11-01,ACES,565,0,575,555,565,0
5341,2022-11-01,AMRT,2820,2820,2830,2650,2760,-60
5342,2022-11-01,ASII,6650,6650,6675,6475,6575,-75
5343,2022-11-01,HRUM,1610,1595,1595,1505,1505,-105
5344,2022-11-01,INKP,9600,9600,9650,9425,9600,0
5345,2022-11-01,INTP,9275,9425,10250,9425,10200,925
5346,2022-11-01,MAPI,1205,0,1310,1205,1305,100
5347,2022-11-01,SIDO,740,0,755,740,750,10
5348,2022-11-01,UNTR,32300,32400,32700,31400,31450,-850
5349,2022-11-01,UNVR,4640,4590,4690,4500,4530,-110
5350,2022-11-02,ACES,565,0,595,565,590,25
5351,2022-11-02,AMRT,2760,2760,2760,2610,2650,-110
5352,2022-11-02,ASII,6575,6525,6550,6375,6425,-150
5353,2022-11-02,HRUM,1505,1570,1605,1530,1530,25
5354,2022-11-02,INKP,9600,9600,9800,9500,9800,200
5355,2022-11-02,INTP,10200,10200,10200,10000,10100,-100
5356,2022-11-02,MAPI,1305,0,1350,1280,1350,45
5357,2022-11-02,SIDO,750,0,755,740,745,-5
5358,2022-11-02,UNTR,31450,31200,31350,30325,30700,-750
5359,2022-11-02,UNVR,4530,4530,4590,4460,4500,-30
5360,2022-11-03,ACES,590,0,610,575,580,-10
5361,2022-11-03,AMRT,2650,2640,2680,2500,2630,-20
5362,2022-11-03,ASII,6425,6375,6425,6350,6375,-50
5363,2022-11-03,HRUM,1530,1540,1585,1540,1580,50
5364,2022-11-03,INKP,9800,9800,10000,9600,9725,-75
5365,2022-11-03,INTP,10100,10025,10175,9950,10100,0
5366,2022-11-03,MAPI,1350,0,1355,1310,1335,-15
5367,2022-11-03,SIDO,745,0,745,730,740,-5
5368,2022-11-03,UNTR,30700,30675,31000,30150,31000,300
5369,2022-11-03,UNVR,4500,4510,4560,4500,4510,10
5370,2022-11-04,ACES,580,0,595,565,590,10
5371,2022-11-04,AMRT,2630,2640,2640,2570,2630,0
5372,2022-11-04,ASII,6375,6350,6425,6350,6425,50
5373,2022-11-04,HRUM,1580,1565,1595,1550,1590,10
5374,2022-11-04,INKP,9725,9725,10350,9725,10300,575
5375,2022-11-04,INTP,10100,10075,10600,10025,10475,375
5376,2022-11-04,MAPI,1335,0,1345,1275,1290,-45
5377,2022-11-04,SIDO,740,0,740,730,740,0
5378,2022-11-04,UNTR,31000,31000,31275,30400,31275,275
5379,2022-11-04,UNVR,4510,4530,4550,4470,4540,30
5380,2022-11-07,ACES,590,0,595,550,575,-15
5381,2022-11-07,AMRT,2630,2650,2700,2620,2660,30
5382,2022-11-07,ASII,6425,6425,6500,6425,6500,75
5383,2022-11-07,HRUM,1590,1605,1670,1605,1660,70
5384,2022-11-07,INKP,10300,10325,10350,10075,10300,0
5385,2022-11-07,INTP,10475,10475,10650,10225,10525,50
5386,2022-11-07,MAPI,1290,0,1320,1290,1305,15
5387,2022-11-07,SIDO,740,0,745,735,745,5
5388,2022-11-07,UNTR,31275,31225,31275,30700,31275,0
5389,2022-11-07,UNVR,4540,4540,4620,4500,4620,80
5390,2022-11-08,ACES,575,0,580,565,570,-5
5391,2022-11-08,AMRT,2660,2700,2720,2650,2690,30
5392,2022-11-08,ASII,6500,6500,6525,6450,6525,25
5393,2022-11-08,HRUM,1660,1660,1675,1630,1665,5
5394,2022-11-08,INKP,10300,10300,10400,10050,10200,-100
5395,2022-11-08,INTP,10525,10650,10700,10250,10250,-275
5396,2022-11-08,MAPI,1305,0,1310,1265,1290,-15
5397,2022-11-08,SIDO,745,0,745,725,730,-15
5398,2022-11-08,UNTR,31275,31275,31275,30800,31175,-100
5399,2022-11-08,UNVR,4620,4640,4650,4600,4630,10
5400,2022-11-09,ACES,570,0,570,560,565,-5
5401,2022-11-09,AMRT,2690,2700,2700,2560,2680,-10
5402,2022-11-09,ASII,6525,6525,6550,6475,6550,25
5403,2022-11-09,HRUM,1665,1665,1700,1635,1635,-30
5404,2022-11-09,INKP,10200,10225,10275,10025,10150,-50
5405,2022-11-09,INTP,10250,10225,10450,10050,10175,-75
5406,2022-11-09,MAPI,1290,0,1310,1275,1300,10
5407,2022-11-09,SIDO,730,0,735,725,730,0
5408,2022-11-09,UNTR,31175,31150,31150,30575,31000,-175
5409,2022-11-09,UNVR,4630,4630,4630,4520,4540,-90
5410,2022-11-10,ACES,565,0,570,555,555,-10
5411,2022-11-10,AMRT,2680,2670,2670,2580,2600,-80
5412,2022-11-10,ASII,6550,6550,6550,6450,6525,-25
5413,2022-11-10,HRUM,1635,1610,1610,1560,1565,-70
5414,2022-11-10,INKP,10150,10025,10125,9900,10000,-150
5415,2022-11-10,INTP,10175,10175,10475,10100,10475,300
5416,2022-11-10,MAPI,1300,0,1305,1275,1300,0
5417,2022-11-10,SIDO,730,0,740,720,740,10
5418,2022-11-10,UNTR,31000,30550,30550,29300,29400,-1600
5419,2022-11-10,UNVR,4540,4530,4580,4500,4560,20
5420,2022-11-11,ACES,555,0,570,550,560,5
5421,2022-11-11,AMRT,2600,2600,2620,2540,2600,0
5422,2022-11-11,ASII,6525,6600,6625,6450,6450,-75
5423,2022-11-11,HRUM,1565,1600,1620,1575,1595,30
5424,2022-11-11,INKP,10000,10200,10200,9925,10075,75
5425,2022-11-11,INTP,10475,10500,10575,10225,10250,-225
5426,2022-11-11,MAPI,1300,0,1365,1260,1310,10
5427,2022-11-11,SIDO,740,0,745,730,740,0
5428,2022-11-11,UNTR,29400,29500,29750,29000,29000,-400
5429,2022-11-11,UNVR,4560,4610,4610,4520,4540,-20
5430,2022-11-14,ACES,560,0,570,555,555,-5
5431,2022-11-14,AMRT,2600,2600,2660,2560,2640,40
5432,2022-11-14,ASII,6450,6450,6475,6300,6300,-150
5433,2022-11-14,HRUM,1595,1635,1690,1620,1660,65
5434,2022-11-14,INKP,10075,10150,10175,10025,10050,-25
5435,2022-11-14,INTP,10250,10250,10300,10150,10300,50
5436,2022-11-14,MAPI,1310,0,1310,1260,1300,-10
5437,2022-11-14,SIDO,740,0,765,735,765,25
5438,2022-11-14,UNTR,29000,29000,29200,28500,28700,-300
5439,2022-11-14,UNVR,4540,4540,4600,4530,4590,50
5440,2022-11-15,ACES,555,0,565,535,535,-20
5441,2022-11-15,AMRT,2640,2640,2770,2620,2760,120
5442,2022-11-15,ASII,6300,6300,6350,6200,6225,-75
5443,2022-11-15,HRUM,1660,1700,1735,1695,1700,40
5444,2022-11-15,INKP,10050,10150,10175,10000,10175,125
5445,2022-11-15,INTP,10300,10250,10250,10050,10100,-200
5446,2022-11-15,MAPI,1300,0,1310,1260,1270,-30
5447,2022-11-15,SIDO,765,0,775,760,770,5
5448,2022-11-15,UNTR,28700,28125,28775,28125,28650,-50
5449,2022-11-15,UNVR,4590,4590,4610,4540,4610,20
5450,2022-11-16,ACES,535,0,555,530,535,0
5451,2022-11-16,AMRT,2760,2770,2900,2760,2840,80
5452,2022-11-16,ASII,6225,6175,6200,6100,6175,-50
5453,2022-11-16,HRUM,1700,1725,1730,1670,1675,-25
5454,2022-11-16,INKP,10175,10150,10150,9800,9875,-300
5455,2022-11-16,INTP,10100,10100,10125,9700,9825,-275
5456,2022-11-16,MAPI,1270,0,1285,1235,1250,-20
5457,2022-11-16,SIDO,770,0,780,760,765,-5
5458,2022-11-16,UNTR,28650,28700,28800,28300,28750,100
5459,2022-11-16,UNVR,4610,4610,4610,4550,4610,0
5460,2022-11-17,ACES,535,0,560,540,555,20
5461,2022-11-17,AMRT,2840,2840,2860,2790,2820,-20
5462,2022-11-17,ASII,6175,6200,6300,6050,6300,125
5463,2022-11-17,HRUM,1675,1650,1685,1620,1680,5
5464,2022-11-17,INKP,9875,9825,9850,9650,9775,-100
5465,2022-11-17,INTP,9825,9750,9825,9525,9625,-200
5466,2022-11-17,MAPI,1250,0,1265,1190,1200,-50
5467,2022-11-17,SIDO,765,0,775,720,760,-5
5468,2022-11-17,UNTR,28750,28500,28700,28150,28625,-125
5469,2022-11-17,UNVR,4610,4600,4610,4560,4590,-20
5470,2022-11-18,ACES,555,0,575,555,570,15
5471,2022-11-18,AMRT,2820,2830,2850,2740,2830,10
5472,2022-11-18,ASII,6300,6275,6300,6200,6225,-75
5473,2022-11-18,HRUM,1680,1680,1680,1640,1640,-40
5474,2022-11-18,INKP,9775,10025,10325,9825,9875,100
5475,2022-11-18,INTP,9625,9625,9900,9600,9900,275
5476,2022-11-18,MAPI,1200,0,1275,1190,1260,60
5477,2022-11-18,SIDO,760,0,765,755,755,-5
5478,2022-11-18,UNTR,28625,28500,29050,28325,28800,175
5479,2022-11-18,UNVR,4590,4590,4660,4560,4640,50
5480,2022-11-21,ACES,570,0,580,555,555,-15
5481,2022-11-21,AMRT,2830,2820,2820,2720,2760,-70
5482,2022-11-21,ASII,6225,6275,6350,6250,6325,100
5483,2022-11-21,HRUM,1640,1665,1670,1635,1645,5
5484,2022-11-21,INKP,9875,9875,9975,9750,9825,-50
5485,2022-11-21,INTP,9900,9925,9950,9700,9750,-150
5486,2022-11-21,MAPI,1260,0,1340,1255,1340,80
5487,2022-11-21,SIDO,755,0,775,755,770,15
5488,2022-11-21,UNTR,28800,29100,29275,28675,28800,0
5489,2022-11-21,UNVR,4640,4630,4630,4550,4550,-90
5490,2022-11-22,ACES,555,0,565,535,540,-15
5491,2022-11-22,AMRT,2760,2790,2820,2750,2750,-10
5492,2022-11-22,ASII,6325,6325,6350,6225,6225,-100
5493,2022-11-22,HRUM,1645,1655,1660,1635,1650,5
5494,2022-11-22,INKP,9825,9825,9925,9700,9700,-125
5495,2022-11-22,INTP,9750,0,9800,9625,9625,-125
5496,2022-11-22,MAPI,1340,0,1345,1315,1330,-10
5497,2022-11-22,SIDO,770,0,775,750,770,0
5498,2022-11-22,UNTR,28800,28800,29200,28800,28950,150
5499,2022-11-22,UNVR,4550,4570,4620,4560,4560,10
5500,2022-11-23,ACES,540,0,550,535,545,5
5501,2022-11-23,AMRT,2750,2750,2860,2750,2780,30
5502,2022-11-23,ASII,6225,6275,6300,6200,6200,-25
5503,2022-11-23,HRUM,1650,1670,1715,1670,1685,35
5504,2022-11-23,INKP,9700,9700,9800,9600,9675,-25
5505,2022-11-23,INTP,9625,0,9775,9650,9675,50
5506,2022-11-23,MAPI,1330,0,1385,1305,1345,15
5507,2022-11-23,SIDO,770,0,775,765,765,-5
5508,2022-11-23,UNTR,28950,29050,29950,29050,29625,675
5509,2022-11-23,UNVR,4560,4580,4590,4550,4550,-10
5510,2022-11-24,ACES,545,0,550,540,540,-5
5511,2022-11-24,AMRT,2780,2790,2880,2790,2830,50
5512,2022-11-24,ASII,6200,6200,6275,6200,6200,0
5513,2022-11-24,HRUM,1685,1695,1700,1670,1675,-10
5514,2022-11-24,INKP,9675,9700,9700,9525,9575,-100
5515,2022-11-24,INTP,9675,9675,9900,9600,9750,75
5516,2022-11-24,MAPI,1345,0,1385,1340,1365,20
5517,2022-11-24,SIDO,765,0,770,760,765,0
5518,2022-11-24,UNTR,29625,29725,30100,29725,29975,350
5519,2022-11-24,UNVR,4550,4550,4600,4550,4560,10
5520,2022-11-25,ACES,540,0,545,535,540,0
5521,2022-11-25,AMRT,2830,2830,2840,2750,2770,-60
5522,2022-11-25,ASII,6200,6175,6200,6125,6175,-25
5523,2022-11-25,HRUM,1675,1680,1685,1635,1655,-20
5524,2022-11-25,INKP,9575,9575,9625,9500,9525,-50
5525,2022-11-25,INTP,9750,9750,9925,9700,9900,150
5526,2022-11-25,MAPI,1365,0,1385,1340,1365,0
5527,2022-11-25,SIDO,765,0,775,765,775,10
5528,2022-11-25,UNTR,29975,29950,30000,29500,29850,-125
5529,2022-11-25,UNVR,4560,4570,4600,4530,4600,40
5530,2022-11-28,ACES,540,0,550,535,540,0
5531,2022-11-28,AMRT,2770,2790,2910,2780,2860,90
5532,2022-11-28,ASII,6175,6175,6275,6150,6225,50
5533,2022-11-28,HRUM,1655,1655,1660,1600,1630,-25
5534,2022-11-28,INKP,9525,9500,9775,9500,9525,0
5535,2022-11-28,INTP,9900,9900,9975,9825,9925,25
5536,2022-11-28,MAPI,1365,0,1375,1335,1375,10
5537,2022-11-28,SIDO,775,0,775,765,775,0
5538,2022-11-28,UNTR,29850,29775,30025,29675,29750,-100
5539,2022-11-28,UNVR,4600,4600,4730,4560,4710,110
5540,2022-11-29,ACES,540,0,545,515,520,-20
5541,2022-11-29,AMRT,2860,2820,2900,2770,2840,-20
5542,2022-11-29,ASII,6225,6125,6150,6025,6050,-175
5543,2022-11-29,HRUM,1630,1640,1720,1630,1710,80
5544,2022-11-29,INKP,9525,9550,9750,9525,9750,225
5545,2022-11-29,INTP,9925,9925,9950,9825,9850,-75
5546,2022-11-29,MAPI,1375,0,1530,1355,1390,15
5547,2022-11-29,SIDO,775,0,780,770,775,0
5548,2022-11-29,UNTR,29750,29750,30825,29750,30700,950
5549,2022-11-29,UNVR,4710,4710,4710,4660,4700,-10
5550,2022-11-30,ACES,520,0,525,496,500,-20
5551,2022-11-30,AMRT,2840,2870,3090,2840,3090,250
5552,2022-11-30,ASII,6050,6050,6200,6025,6050,0
5553,2022-11-30,HRUM,1710,1730,1760,1730,1755,45
5554,2022-11-30,INKP,9750,9775,10000,9725,10000,250
5555,2022-11-30,INTP,9850,9775,10050,9775,9950,100
5556,2022-11-30,MAPI,1390,0,1480,1390,1450,60
5557,2022-11-30,SIDO,775,0,790,770,785,10
5558,2022-11-30,UNTR,30700,30700,31250,30450,30800,100
5559,2022-11-30,UNVR,4700,4660,4800,4620,4800,100
5560,2022-12-01,ACES,500,0,510,498,500,0
5561,2022-12-01,AMRT,3090,3090,3090,2940,2940,-150
5562,2022-12-01,ASII,6050,6100,6200,6100,6175,125
5563,2022-12-01,HRUM,1755,1770,1775,1755,1770,15
5564,2022-12-01,INKP,10000,10000,10025,9825,9875,-125
5565,2022-12-01,INTP,9950,9875,10025,9850,10000,50
5566,2022-12-01,MAPI,1450,0,1455,1410,1425,-25
5567,2022-12-01,SIDO,785,0,790,780,790,5
5568,2022-12-01,UNTR,30800,31000,31175,30525,30675,-125
5569,2022-12-01,UNVR,4800,4800,4800,4670,4710,-90
5570,2022-12-02,ACES,500,0,505,490,492,-8
5571,2022-12-02,AMRT,2940,2960,3010,2910,2950,10
5572,2022-12-02,ASII,6175,6175,6175,6050,6125,-50
5573,2022-12-02,HRUM,1770,1770,1770,1735,1755,-15
5574,2022-12-02,INKP,9875,9875,9950,9725,9925,50
5575,2022-12-02,INTP,10000,10050,10100,9850,10000,0
5576,2022-12-02,MAPI,1425,0,1475,1410,1475,50
5577,2022-12-02,SIDO,790,0,790,780,785,-5
5578,2022-12-02,UNTR,30675,30600,30600,29225,29225,-1450
5579,2022-12-02,UNVR,4710,4710,4710,4660,4710,0
5580,2022-12-05,ACES,492,0,505,476,478,-14
5581,2022-12-05,AMRT,2950,2930,2960,2910,2920,-30
5582,2022-12-05,ASII,6125,6075,6100,6000,6025,-100
5583,2022-12-05,HRUM,1755,1780,1810,1760,1775,20
5584,2022-12-05,INKP,9925,9950,9975,9825,9925,0
5585,2022-12-05,INTP,10000,10000,10000,9850,9925,-75
5586,2022-12-05,MAPI,1475,0,1480,1410,1435,-40
5587,2022-12-05,SIDO,785,0,790,755,770,-15
5588,2022-12-05,UNTR,29225,29225,29500,28500,28500,-725
5589,2022-12-05,UNVR,4710,4710,4800,4700,4740,30
5590,2022-12-06,ACES,478,0,478,460,460,-18
5591,2022-12-06,AMRT,2920,2940,2940,2820,2910,-10
5592,2022-12-06,ASII,6025,6000,6025,5800,5875,-150
5593,2022-12-06,HRUM,1775,1790,1805,1765,1770,-5
5594,2022-12-06,INKP,9925,9900,9925,9625,9750,-175
5595,2022-12-06,INTP,9925,9925,9975,9725,9975,50
5596,2022-12-06,MAPI,1435,0,1435,1345,1400,-35
5597,2022-12-06,SIDO,770,0,770,740,750,-20
5598,2022-12-06,UNTR,28500,28500,28625,27900,28100,-400
5599,2022-12-06,UNVR,4740,4740,4750,4670,4740,0
5600,2022-12-07,ACES,460,0,466,440,442,-18
5601,2022-12-07,AMRT,2910,2910,2940,2860,2880,-30
5602,2022-12-07,ASII,5875,5800,5900,5700,5725,-150
5603,2022-12-07,HRUM,1770,1785,1795,1750,1760,-10
5604,2022-12-07,INKP,9750,9750,9750,9475,9475,-275
5605,2022-12-07,INTP,9975,9950,9950,9750,9950,-25
5606,2022-12-07,MAPI,1400,0,1440,1390,1420,20
5607,2022-12-07,SIDO,750,0,755,730,755,5
5608,2022-12-07,UNTR,28100,28125,28650,27525,28050,-50
5609,2022-12-07,UNVR,4740,4740,4740,4670,4700,-40
5610,2022-12-08,ACES,442,0,454,436,442,0
5611,2022-12-08,AMRT,2880,2870,2880,2680,2680,-200
5612,2022-12-08,ASII,5725,5650,5800,5550,5675,-50
5613,2022-12-08,HRUM,1760,1770,1775,1705,1745,-15
5614,2022-12-08,INKP,9475,9475,9475,8975,9250,-225
5615,2022-12-08,INTP,9950,9950,9950,9500,9900,-50
5616,2022-12-08,MAPI,1420,0,1470,1400,1460,40
5617,2022-12-08,SIDO,755,0,770,750,760,5
5618,2022-12-08,UNTR,28050,27900,28025,27025,27300,-750
5619,2022-12-08,UNVR,4700,4670,4690,4560,4660,-40
5620,2022-12-09,ACES,442,0,448,432,436,-6
5621,2022-12-09,AMRT,2680,2530,2530,2500,2500,-180
5622,2022-12-09,ASII,5675,5700,5750,5650,5675,0
5623,2022-12-09,HRUM,1745,1745,1760,1735,1755,10
5624,2022-12-09,INKP,9250,9250,9325,9125,9275,25
5625,2022-12-09,INTP,9900,9900,9975,9825,9925,25
5626,2022-12-09,MAPI,1460,0,1475,1390,1425,-35
5627,2022-12-09,SIDO,760,0,770,750,765,5
5628,2022-12-09,UNTR,27300,27025,27175,26125,26125,-1175
5629,2022-12-09,UNVR,4660,4660,4660,4600,4620,-40
5630,2022-12-12,ACES,436,0,442,434,440,4
5631,2022-12-12,AMRT,2500,2330,2650,2330,2550,50
5632,2022-12-12,ASII,5675,5675,5725,5625,5675,0
5633,2022-12-12,HRUM,1755,1760,1800,1755,1795,40
5634,2022-12-12,INKP,9275,9275,9800,9075,9800,525
5635,2022-12-12,INTP,9925,9925,10100,9850,10000,75
5636,2022-12-12,MAPI,1425,0,1450,1390,1400,-25
5637,2022-12-12,SIDO,765,0,775,760,770,5
5638,2022-12-12,UNTR,26125,26125,26925,26025,26875,750
5639,2022-12-12,UNVR,4620,4620,4690,4580,4690,70
5640,2022-12-13,ACES,440,0,444,434,434,-6
5641,2022-12-13,AMRT,2550,2570,2650,2520,2600,50
5642,2022-12-13,ASII,5675,5700,5900,5675,5825,150
5643,2022-12-13,HRUM,1795,1800,1810,1755,1770,-25
5644,2022-12-13,INKP,9800,9800,9875,9575,9575,-225
5645,2022-12-13,INTP,10000,10075,10075,9875,10000,0
5646,2022-12-13,MAPI,1400,0,1430,1385,1420,20
5647,2022-12-13,SIDO,770,0,770,755,760,-10
5648,2022-12-13,UNTR,26875,26850,27125,26600,26825,-50
5649,2022-12-13,UNVR,4690,4700,4720,4630,4720,30
5650,2022-12-14,ACES,434,0,442,424,426,-8
5651,2022-12-14,AMRT,2600,2600,2610,2580,2590,-10
5652,2022-12-14,ASII,5825,5925,5950,5775,5825,0
5653,2022-12-14,HRUM,1770,1730,1755,1700,1745,-25
5654,2022-12-14,INKP,9575,9675,9750,9500,9650,75
5655,2022-12-14,INTP,10000,10000,10050,9925,9975,-25
5656,2022-12-14,MAPI,1420,0,1420,1385,1400,-20
5657,2022-12-14,SIDO,760,0,770,760,770,10
5658,2022-12-14,UNTR,26825,26825,27350,26825,26850,25
5659,2022-12-14,UNVR,4720,4720,4720,4670,4720,0
5660,2022-12-15,ACES,426,0,436,410,414,-12
5661,2022-12-15,AMRT,2590,2580,2600,2550,2570,-20
5662,2022-12-15,ASII,5825,5825,5850,5750,5800,-25
5663,2022-12-15,HRUM,1745,1745,1760,1725,1745,0
5664,2022-12-15,INKP,9650,0,9750,9575,9700,50
5665,2022-12-15,INTP,9975,9975,9975,9825,9850,-125
5666,2022-12-15,MAPI,1400,0,1400,1350,1360,-40
5667,2022-12-15,SIDO,770,0,770,760,760,-10
5668,2022-12-15,UNTR,26850,26775,26800,26525,26525,-325
5669,2022-12-15,UNVR,4720,4720,4720,4640,4700,-20
5670,2022-12-16,ACES,414,0,420,398,398,-16
5671,2022-12-16,AMRT,2570,2560,2590,2540,2560,-10
5672,2022-12-16,ASII,5800,5775,5800,5700,5775,-25
5673,2022-12-16,HRUM,1745,1735,1750,1710,1750,5
5674,2022-12-16,INKP,9700,9625,9800,9400,9800,100
5675,2022-12-16,INTP,9850,9800,9950,9775,9950,100
5676,2022-12-16,MAPI,1360,0,1360,1270,1305,-55
5677,2022-12-16,SIDO,760,0,765,740,755,-5
5678,2022-12-16,UNTR,26525,26475,26775,26250,26550,25
5679,2022-12-16,UNVR,4700,4690,4870,4660,4870,170
5680,2022-12-19,ACES,398,0,422,392,420,22
5681,2022-12-19,AMRT,2560,2550,2620,2530,2550,-10
5682,2022-12-19,ASII,5775,5850,5850,5650,5700,-75
5683,2022-12-19,HRUM,1750,1750,1755,1710,1725,-25
5684,2022-12-19,INKP,9800,9650,9700,9475,9525,-275
5685,2022-12-19,INTP,9950,9950,9950,9775,9875,-75
5686,2022-12-19,MAPI,1305,0,1375,1305,1335,30
5687,2022-12-19,SIDO,755,0,765,740,740,-15
5688,2022-12-19,UNTR,26550,26300,26850,26300,26850,300
5689,2022-12-19,UNVR,4870,4830,4830,4730,4730,-140
5690,2022-12-20,ACES,420,0,438,416,430,10
5691,2022-12-20,AMRT,2550,2550,2600,2520,2570,20
5692,2022-12-20,ASII,5700,5675,5750,5675,5700,0
5693,2022-12-20,HRUM,1725,1725,1725,1650,1655,-70
5694,2022-12-20,INKP,9525,9525,9525,9275,9300,-225
5695,2022-12-20,INTP,9875,9875,9925,9800,9850,-25
5696,2022-12-20,MAPI,1335,0,1440,1335,1435,100
5697,2022-12-20,SIDO,740,0,755,735,755,15
5698,2022-12-20,UNTR,26850,26850,27025,26400,26650,-200
5699,2022-12-20,UNVR,4730,4730,4770,4700,4770,40
5700,2022-12-21,ACES,430,0,440,422,430,0
5701,2022-12-21,AMRT,2570,2590,2640,2550,2600,30
5702,2022-12-21,ASII,5700,5700,5725,5650,5700,0
5703,2022-12-21,HRUM,1655,1660,1680,1660,1660,5
5704,2022-12-21,INKP,9300,9300,9450,9300,9375,75
5705,2022-12-21,INTP,9850,9850,9925,9750,9850,0
5706,2022-12-21,MAPI,1435,0,1445,1400,1420,-15
5707,2022-12-21,SIDO,755,0,765,755,765,10
5708,2022-12-21,UNTR,26650,26625,26850,26425,26625,-25
5709,2022-12-21,UNVR,4770,4770,4790,4740,4780,10
5710,2022-12-22,ACES,430,0,496,432,486,56
5711,2022-12-22,AMRT,2600,2600,2600,2570,2600,0
5712,2022-12-22,ASII,5700,5700,5775,5675,5775,75
5713,2022-12-22,HRUM,1660,1690,1695,1670,1685,25
5714,2022-12-22,INKP,9375,9375,9450,9150,9200,-175
5715,2022-12-22,INTP,9850,9850,9850,9625,9650,-200
5716,2022-12-22,MAPI,1420,0,1460,1420,1425,5
5717,2022-12-22,SIDO,765,0,785,755,770,5
5718,2022-12-22,UNTR,26625,26750,27000,26450,27000,375
5719,2022-12-22,UNVR,4780,4780,4840,4770,4840,60
5720,2022-12-23,ACES,486,0,498,470,480,-6
5721,2022-12-23,AMRT,2600,2590,2640,2560,2620,20
5722,2022-12-23,ASII,5775,5750,5775,5650,5675,-100
5723,2022-12-23,HRUM,1685,1685,1685,1650,1665,-20
5724,2022-12-23,INKP,9200,9200,9225,9050,9150,-50
5725,2022-12-23,INTP,9650,9650,9750,9625,9750,100
5726,2022-12-23,MAPI,1425,0,1445,1420,1445,20
5727,2022-12-23,SIDO,770,0,770,750,750,-20
5728,2022-12-23,UNTR,27000,27000,27000,26625,26875,-125
5729,2022-12-23,UNVR,4840,4830,4830,4760,4820,-20
5730,2022-12-26,ACES,480,0,520,480,500,20
5731,2022-12-26,AMRT,2620,2640,2700,2630,2650,30
5732,2022-12-26,ASII,5675,5675,5725,5625,5650,-25
5733,2022-12-26,HRUM,1665,1670,1670,1645,1645,-20
5734,2022-12-26,INKP,9150,9150,9200,9025,9075,-75
5735,2022-12-26,INTP,9750,9725,9875,9650,9825,75
5736,2022-12-26,MAPI,1445,0,1455,1370,1380,-65
5737,2022-12-26,SIDO,750,0,760,750,755,5
5738,2022-12-26,UNTR,26875,26900,26900,26375,26400,-475
5739,2022-12-26,UNVR,4820,4820,4820,4740,4750,-70
5740,2022-12-27,ACES,500,0,515,492,492,-8
5741,2022-12-27,AMRT,2650,2680,2820,2640,2820,170
5742,2022-12-27,ASII,5650,5700,5750,5650,5675,25
5743,2022-12-27,HRUM,1645,1660,1680,1615,1620,-25
5744,2022-12-27,INKP,9075,9075,9175,8975,9025,-50
5745,2022-12-27,INTP,9825,9800,10100,9800,10075,250
5746,2022-12-27,MAPI,1380,0,1440,1375,1410,30
5747,2022-12-27,SIDO,755,0,760,750,755,0
5748,2022-12-27,UNTR,26400,26400,26850,26375,26625,225
5749,2022-12-27,UNVR,4750,4760,4810,4740,4810,60
5750,2022-12-28,ACES,492,0,520,492,494,2
5751,2022-12-28,AMRT,2820,2820,2820,2660,2680,-140
5752,2022-12-28,ASII,5675,5725,5725,5575,5625,-50
5753,2022-12-28,HRUM,1620,1620,1630,1600,1605,-15
5754,2022-12-28,INKP,9025,9025,9025,8850,8900,-125
5755,2022-12-28,INTP,10075,10025,10050,9900,10025,-50
5756,2022-12-28,MAPI,1410,0,1415,1385,1415,5
5757,2022-12-28,SIDO,755,0,760,750,755,0
5758,2022-12-28,UNTR,26625,26625,26700,26025,26175,-450
5759,2022-12-28,UNVR,4810,4810,4820,4710,4770,-40
5760,2022-12-29,ACES,494,0,505,486,496,2
5761,2022-12-29,AMRT,2680,2670,2770,2610,2740,60
5762,2022-12-29,ASII,5625,5600,5675,5550,5650,25
5763,2022-12-29,HRUM,1605,1610,1620,1590,1605,0
5764,2022-12-29,INKP,8900,8900,8925,8775,8800,-100
5765,2022-12-29,INTP,10025,0,10025,9900,9925,-100
5766,2022-12-29,MAPI,1415,0,1430,1395,1415,0
5767,2022-12-29,SIDO,755,0,760,750,755,0
5768,2022-12-29,UNTR,26175,26125,26350,25675,26275,100
5769,2022-12-29,UNVR,4770,4740,4760,4700,4760,-10
5770,2022-12-30,ACES,496,0,510,494,496,0
5771,2022-12-30,AMRT,2740,2740,2750,2650,2650,-90
5772,2022-12-30,ASII,5650,5675,5750,5650,5700,50
5773,2022-12-30,HRUM,1605,1615,1635,1610,1620,15
5774,2022-12-30,INKP,8800,8800,8950,8725,8725,-75
5775,2022-12-30,INTP,9925,10000,10000,9875,9900,-25
5776,2022-12-30,MAPI,1415,0,1450,1395,1445,30
5777,2022-12-30,SIDO,755,0,760,750,755,0
5778,2022-12-30,UNTR,26275,26275,26400,26075,26075,-200
5779,2022-12-30,UNVR,4760,4780,4780,4700,4700,-60
