,date,stock_code,prev,open,high,low,close,change
4,02 Jan 2024,ACES,720,725,730,710,715,-5
37,02 Jan 2024,AMRT,2930,2930,2940,2840,2890,-40
60,02 Jan 2024,ASII,5650,5625,5700,5575,5700,50
361,02 Jan 2024,HRUM,1335,1335,1380,1330,1380,45
394,02 Jan 2024,INKP,8325,8325,8500,8250,8350,25
402,02 Jan 2024,INTP,9400,9400,9500,9375,9425,25
513,02 Jan 2024,MAPI,1790,1800,1985,1800,1895,105
744,02 Jan 2024,SIDO,525,525,530,510,510,-15
864,02 Jan 2024,UNTR,22625,22600,23575,22600,23475,850
865,02 Jan 2024,UNVR,3530,3530,3550,3500,3550,20
4,03 Jan 2024,ACES,715,720,730,710,715,0
37,03 Jan 2024,AMRT,2890,2860,2890,2800,2820,-70
60,03 Jan 2024,ASII,5700,5700,5700,5600,5600,-100
361,03 Jan 2024,HRUM,1380,1355,1380,1340,1355,-25
394,03 Jan 2024,INKP,8350,8350,8500,8250,8475,125
402,03 Jan 2024,INTP,9425,9425,9450,9300,9300,-125
513,03 Jan 2024,MAPI,1895,1905,1955,1880,1900,5
744,03 Jan 2024,SIDO,510,510,525,505,525,15
864,03 Jan 2024,UNTR,23475,23200,23400,22600,23225,-250
865,03 Jan 2024,UNVR,3550,3550,3560,3520,3530,-20
4,04 Jan 2024,ACES,715,715,745,715,735,20
37,04 Jan 2024,AMRT,2820,2830,2870,2820,2870,50
60,04 Jan 2024,ASII,5600,5600,5750,5600,5700,100
361,04 Jan 2024,HRUM,1355,1360,1410,1360,1385,30
394,04 Jan 2024,INKP,8475,8525,8525,8350,8425,-50
402,04 Jan 2024,INTP,9300,9275,9400,9275,9325,25
513,04 Jan 2024,MAPI,1900,1910,1930,1865,1885,-15
744,04 Jan 2024,SIDO,525,525,525,515,520,-5
864,04 Jan 2024,UNTR,23225,23225,23500,23225,23275,50
865,04 Jan 2024,UNVR,3530,3530,3560,3520,3520,-10
4,05 Jan 2024,ACES,735,740,760,735,750,15
37,05 Jan 2024,AMRT,2870,2870,2870,2790,2790,-80
60,05 Jan 2024,ASII,5700,5725,5750,5625,5625,-75
362,05 Jan 2024,HRUM,1385,1385,1405,1370,1375,-10
395,05 Jan 2024,INKP,8425,8425,8450,8325,8375,-50
403,05 Jan 2024,INTP,9325,9325,9375,9225,9225,-100
514,05 Jan 2024,MAPI,1885,1885,1895,1785,1795,-90
745,05 Jan 2024,SIDO,520,520,525,515,520,0
865,05 Jan 2024,UNTR,23275,23500,23550,23250,23250,-25
866,05 Jan 2024,UNVR,3520,3540,3580,3520,3520,0
4,08 Jan 2024,ACES,750,750,755,730,735,-15
37,08 Jan 2024,AMRT,2790,2790,2820,2790,2800,10
60,08 Jan 2024,ASII,5625,5625,5675,5550,5575,-50
363,08 Jan 2024,HRUM,1375,1380,1410,1375,1380,5
396,08 Jan 2024,INKP,8375,8375,8450,8125,8125,-250
404,08 Jan 2024,INTP,9225,9225,9275,9175,9225,0
515,08 Jan 2024,MAPI,1795,1800,1810,1775,1775,-20
746,08 Jan 2024,SIDO,520,520,525,515,520,0
866,08 Jan 2024,UNTR,23250,23300,23525,23000,23025,-225
867,08 Jan 2024,UNVR,3520,3530,3560,3470,3480,-40
4,09 Jan 2024,ACES,735,745,765,725,765,30
37,09 Jan 2024,AMRT,2800,2810,2820,2730,2740,-60
60,09 Jan 2024,ASII,5575,5600,5600,5525,5575,0
363,09 Jan 2024,HRUM,1380,1380,1385,1340,1345,-35
396,09 Jan 2024,INKP,8125,8150,8225,8000,8000,-125
404,09 Jan 2024,INTP,9225,0,9250,9150,9150,-75
515,09 Jan 2024,MAPI,1775,1780,1895,1780,1855,80
747,09 Jan 2024,SIDO,520,520,525,515,520,0
867,09 Jan 2024,UNTR,23025,23200,23350,23025,23100,75
868,09 Jan 2024,UNVR,3480,3480,3490,3420,3430,-50
4,10 Jan 2024,ACES,765,765,780,755,770,5
37,10 Jan 2024,AMRT,2740,2780,2790,2710,2750,10
60,10 Jan 2024,ASII,5575,5500,5575,5450,5525,-50
363,10 Jan 2024,HRUM,1345,1360,1380,1355,1360,15
396,10 Jan 2024,INKP,8000,7950,8225,7950,8000,0
404,10 Jan 2024,INTP,9150,9150,9250,9150,9150,0
515,10 Jan 2024,MAPI,1855,1855,1925,1845,1855,0
748,10 Jan 2024,SIDO,520,520,525,515,525,5
869,10 Jan 2024,UNTR,23100,23100,23450,23100,23300,200
870,10 Jan 2024,UNVR,3430,3430,3480,3410,3410,-20
4,10 Jan 2024,ACES,765,765,780,755,770,5
37,10 Jan 2024,AMRT,2740,2780,2790,2710,2750,10
60,10 Jan 2024,ASII,5575,5500,5575,5450,5525,-50
363,10 Jan 2024,HRUM,1345,1360,1380,1355,1360,15
396,10 Jan 2024,INKP,8000,7950,8225,7950,8000,0
404,10 Jan 2024,INTP,9150,9150,9250,9150,9150,0
515,10 Jan 2024,MAPI,1855,1855,1925,1845,1855,0
748,10 Jan 2024,SIDO,520,520,525,515,525,5
869,10 Jan 2024,UNTR,23100,23100,23450,23100,23300,200
870,10 Jan 2024,UNVR,3430,3430,3480,3410,3410,-20
4,11 Jan 2024,ACES,770,770,815,765,810,40
38,11 Jan 2024,AMRT,2750,2790,2790,2710,2710,-40
61,11 Jan 2024,ASII,5525,5550,5625,5525,5550,25
364,11 Jan 2024,HRUM,1360,1350,1360,1340,1345,-15
397,11 Jan 2024,INKP,8000,8000,8150,8000,8050,50
405,11 Jan 2024,INTP,9150,9225,9350,9200,9300,150
517,11 Jan 2024,MAPI,1855,1860,1870,1830,1845,-10
750,11 Jan 2024,SIDO,525,520,525,515,520,-5
871,11 Jan 2024,UNTR,23300,23350,23450,23250,23300,0
872,11 Jan 2024,UNVR,3410,3450,3450,3410,3410,0
4,12 Jan 2024,ACES,810,810,815,790,810,0
38,12 Jan 2024,AMRT,2710,2710,2710,2610,2640,-70
61,12 Jan 2024,ASII,5550,5550,5625,5550,5600,50
364,12 Jan 2024,HRUM,1345,1345,1360,1330,1350,5
397,12 Jan 2024,INKP,8050,8075,8150,8050,8100,50
405,12 Jan 2024,INTP,9300,9350,9350,9250,9275,-25
517,12 Jan 2024,MAPI,1845,1845,1855,1815,1820,-25
750,12 Jan 2024,SIDO,520,520,525,515,520,0
871,12 Jan 2024,UNTR,23300,23350,23925,23325,23900,600
872,12 Jan 2024,UNVR,3410,3430,3480,3410,3470,60
4,15 Jan 2024,ACES,810,810,815,795,810,0
38,15 Jan 2024,AMRT,2640,2640,2650,2570,2630,-10
61,15 Jan 2024,ASII,5600,5600,5625,5500,5525,-75
364,15 Jan 2024,HRUM,1350,1360,1375,1335,1340,-10
397,15 Jan 2024,INKP,8100,8100,8175,8075,8175,75
405,15 Jan 2024,INTP,9275,9275,9275,9150,9150,-125
517,15 Jan 2024,MAPI,1820,1830,1920,1825,1905,85
750,15 Jan 2024,SIDO,520,525,530,515,525,5
871,15 Jan 2024,UNTR,23900,23900,24750,23900,24725,825
872,15 Jan 2024,UNVR,3470,3470,3480,3430,3430,-40
4,16 Jan 2024,ACES,810,810,815,800,810,0
38,16 Jan 2024,AMRT,2630,2640,2700,2630,2670,40
61,16 Jan 2024,ASII,5525,5525,5525,5475,5500,-25
364,16 Jan 2024,HRUM,1340,1340,1350,1330,1335,-5
397,16 Jan 2024,INKP,8175,8150,8225,8075,8100,-75
405,16 Jan 2024,INTP,9150,9225,9325,9175,9275,125
517,16 Jan 2024,MAPI,1905,1920,1995,1920,1940,35
749,16 Jan 2024,SIDO,525,520,525,520,525,0
870,16 Jan 2024,UNTR,24725,24750,24800,24375,24600,-125
871,16 Jan 2024,UNVR,3430,3430,3470,3410,3410,-20
4,17 Jan 2024,ACES,810,810,810,790,800,-10
38,17 Jan 2024,AMRT,2670,2670,2680,2630,2650,-20
61,17 Jan 2024,ASII,5500,5500,5525,5350,5400,-100
364,17 Jan 2024,HRUM,1335,1340,1345,1310,1325,-10
397,17 Jan 2024,INKP,8100,8100,8125,7925,7975,-125
405,17 Jan 2024,INTP,9275,9300,9300,9150,9175,-100
517,17 Jan 2024,MAPI,1940,1940,1965,1885,1900,-40
749,17 Jan 2024,SIDO,525,525,530,520,520,-5
870,17 Jan 2024,UNTR,24600,25000,25000,24200,24225,-375
871,17 Jan 2024,UNVR,3410,3440,3440,3310,3320,-90
4,18 Jan 2024,ACES,800,800,805,790,800,0
38,18 Jan 2024,AMRT,2650,2650,2680,2650,2650,0
61,18 Jan 2024,ASII,5400,5400,5400,5325,5375,-25
365,18 Jan 2024,HRUM,1325,1320,1330,1310,1310,-15
398,18 Jan 2024,INKP,7975,7975,8050,7975,7975,0
406,18 Jan 2024,INTP,9175,9175,9250,9150,9150,-25
518,18 Jan 2024,MAPI,1900,1900,1945,1890,1920,20
750,18 Jan 2024,SIDO,520,520,530,520,520,0
871,18 Jan 2024,UNTR,24225,24225,24550,24050,24100,-125
872,18 Jan 2024,UNVR,3320,3330,3340,3290,3300,-20
4,19 Jan 2024,ACES,800,800,810,780,800,0
38,19 Jan 2024,AMRT,2650,2670,2700,2640,2640,-10
61,19 Jan 2024,ASII,5375,5375,5400,5300,5350,-25
365,19 Jan 2024,HRUM,1310,1315,1330,1300,1315,5
398,19 Jan 2024,INKP,7975,8050,8050,7900,8000,25
406,19 Jan 2024,INTP,9150,9225,9225,9125,9175,25
518,19 Jan 2024,MAPI,1920,1920,1960,1905,1945,25
750,19 Jan 2024,SIDO,520,520,520,515,515,-5
871,19 Jan 2024,UNTR,24100,24200,24300,23825,24075,-25
872,19 Jan 2024,UNVR,3300,3300,3300,3210,3240,-60
4,22 Jan 2024,ACES,800,800,815,790,810,10
38,22 Jan 2024,AMRT,2640,2670,2700,2640,2680,40
61,22 Jan 2024,ASII,5350,5350,5425,5225,5225,-125
365,22 Jan 2024,HRUM,1315,1315,1320,1275,1285,-30
398,22 Jan 2024,INKP,8000,8050,8050,7800,7925,-75
406,22 Jan 2024,INTP,9175,9150,9175,9000,9000,-175
518,22 Jan 2024,MAPI,1945,1950,2030,1930,1970,25
750,22 Jan 2024,SIDO,515,520,525,515,515,0
871,22 Jan 2024,UNTR,24075,24075,24075,23225,23250,-825
872,22 Jan 2024,UNVR,3240,3220,3240,3120,3120,-120
4,23 Jan 2024,ACES,810,815,825,805,825,15
38,23 Jan 2024,AMRT,2680,2700,2730,2650,2720,40
61,23 Jan 2024,ASII,5225,5150,5200,5075,5125,-100
365,23 Jan 2024,HRUM,1285,1285,1290,1225,1235,-50
398,23 Jan 2024,INKP,7925,7925,7950,7600,7675,-250
406,23 Jan 2024,INTP,9000,9000,9075,8925,9050,50
518,23 Jan 2024,MAPI,1970,1975,2030,1960,1995,25
750,23 Jan 2024,SIDO,515,515,520,500,500,-15
871,23 Jan 2024,UNTR,23250,23275,23425,22400,22700,-550
872,23 Jan 2024,UNVR,3120,3140,3200,3130,3180,60
4,24 Jan 2024,ACES,825,825,835,815,825,0
38,24 Jan 2024,AMRT,2720,2720,2720,2650,2670,-50
61,24 Jan 2024,ASII,5125,5150,5175,4980,5075,-50
365,24 Jan 2024,HRUM,1235,1235,1240,1135,1150,-85
398,24 Jan 2024,INKP,7675,7725,7875,7675,7775,100
406,24 Jan 2024,INTP,9050,9050,9225,8950,9225,175
518,24 Jan 2024,MAPI,1995,2000,2010,1985,1995,0
750,24 Jan 2024,SIDO,500,500,505,492,500,0
871,24 Jan 2024,UNTR,22700,22800,22850,22325,22550,-150
872,24 Jan 2024,UNVR,3180,3180,3220,3150,3200,20
4,25 Jan 2024,ACES,825,830,835,825,825,0
38,25 Jan 2024,AMRT,2670,2690,2700,2650,2670,0
61,25 Jan 2024,ASII,5075,5075,5150,5025,5050,-25
365,25 Jan 2024,HRUM,1150,1150,1215,1150,1180,30
398,25 Jan 2024,INKP,7775,7775,7775,7600,7600,-175
406,25 Jan 2024,INTP,9225,9175,9250,9075,9100,-125
518,25 Jan 2024,MAPI,1995,1990,1990,1925,1935,-60
750,25 Jan 2024,SIDO,500,500,510,498,505,5
871,25 Jan 2024,UNTR,22550,22475,23250,22475,23125,575
872,25 Jan 2024,UNVR,3200,3190,3200,3150,3160,-40
4,26 Jan 2024,ACES,825,825,835,810,820,-5
38,26 Jan 2024,AMRT,2670,2660,2670,2620,2630,-40
61,26 Jan 2024,ASII,5050,5050,5075,4990,5075,25
365,26 Jan 2024,HRUM,1180,1180,1185,1150,1155,-25
398,26 Jan 2024,INKP,7600,7600,7950,7600,7900,300
406,26 Jan 2024,INTP,9100,9375,9375,9100,9225,125
518,26 Jan 2024,MAPI,1935,1910,1915,1855,1875,-60
750,26 Jan 2024,SIDO,505,510,510,500,500,-5
871,26 Jan 2024,UNTR,23125,23150,23250,22925,22975,-150
872,26 Jan 2024,UNVR,3160,3160,3170,3130,3160,0
4,29 Jan 2024,ACES,820,820,835,815,835,15
38,29 Jan 2024,AMRT,2630,2640,2690,2620,2690,60
61,29 Jan 2024,ASII,5075,5075,5075,4910,4930,-145
365,29 Jan 2024,HRUM,1155,1155,1170,1120,1150,-5
398,29 Jan 2024,INKP,7900,7950,7950,7850,7900,0
406,29 Jan 2024,INTP,9225,9250,9250,9050,9075,-150
518,29 Jan 2024,MAPI,1875,1875,1915,1875,1900,25
750,29 Jan 2024,SIDO,500,500,510,498,505,5
871,29 Jan 2024,UNTR,22975,23025,23325,23025,23325,350
872,29 Jan 2024,UNVR,3160,3160,3160,3070,3080,-80
4,30 Jan 2024,ACES,835,835,835,820,830,-5
38,30 Jan 2024,AMRT,2690,2670,2680,2630,2650,-40
61,30 Jan 2024,ASII,4930,4920,5175,4900,5100,170
365,30 Jan 2024,HRUM,1150,1160,1270,1155,1200,50
398,30 Jan 2024,INKP,7900,7900,7900,7675,7700,-200
406,30 Jan 2024,INTP,9075,9150,9150,9050,9075,0
518,30 Jan 2024,MAPI,1900,1910,2030,1910,1970,70
750,30 Jan 2024,SIDO,505,505,510,500,505,0
872,30 Jan 2024,UNTR,23325,23325,23325,22800,22850,-475
873,30 Jan 2024,UNVR,3080,3080,3130,3010,3130,50
4,31 Jan 2024,ACES,830,830,850,825,850,20
38,31 Jan 2024,AMRT,2650,2660,2690,2630,2650,0
61,31 Jan 2024,ASII,5100,5125,5150,5050,5125,25
365,31 Jan 2024,HRUM,1200,1220,1230,1160,1175,-25
398,31 Jan 2024,INKP,7700,7725,7825,7650,7825,125
406,31 Jan 2024,INTP,9075,9075,9125,9025,9025,-50
518,31 Jan 2024,MAPI,1970,1990,2000,1955,1955,-15
750,31 Jan 2024,SIDO,505,505,510,505,510,5
872,31 Jan 2024,UNTR,22850,23025,23200,22875,22950,100
873,31 Jan 2024,UNVR,3130,3130,3150,3100,3100,-30
4,01 Feb 2024,ACES,850,850,865,835,855,5
38,01 Feb 2024,AMRT,2650,2650,2670,2640,2650,0
61,01 Feb 2024,ASII,5125,5100,5175,5075,5125,0
365,01 Feb 2024,HRUM,1175,1175,1205,1160,1190,15
398,01 Feb 2024,INKP,7825,7775,7800,7650,7700,-125
406,01 Feb 2024,INTP,9025,9025,9050,8925,8925,-100
518,01 Feb 2024,MAPI,1955,1960,1980,1930,1960,5
750,01 Feb 2024,SIDO,510,510,510,500,505,-5
872,01 Feb 2024,UNTR,22950,22925,23075,22575,22800,-150
873,01 Feb 2024,UNVR,3100,3100,3130,3090,3100,0
4,02 Feb 2024,ACES,855,855,855,810,820,-35
38,02 Feb 2024,AMRT,2650,2650,2670,2640,2650,0
61,02 Feb 2024,ASII,5125,5150,5325,5125,5325,200
365,02 Feb 2024,HRUM,1190,1195,1195,1155,1180,-10
398,02 Feb 2024,INKP,7700,7700,8200,7650,8125,425
406,02 Feb 2024,INTP,8925,8950,9000,8900,8925,0
518,02 Feb 2024,MAPI,1960,1965,1995,1965,1975,15
750,02 Feb 2024,SIDO,505,505,505,500,500,-5
872,02 Feb 2024,UNTR,22800,22850,22950,22725,22850,50
873,02 Feb 2024,UNVR,3100,3100,3200,3100,3170,70
4,05 Feb 2024,ACES,820,820,825,800,810,-10
38,05 Feb 2024,AMRT,2650,2650,2660,2600,2600,-50
61,05 Feb 2024,ASII,5325,5325,5350,5150,5175,-150
365,05 Feb 2024,HRUM,1180,1180,1185,1155,1155,-25
398,05 Feb 2024,INKP,8125,8150,8175,7900,7900,-225
406,05 Feb 2024,INTP,8925,8975,9025,8875,8900,-25
518,05 Feb 2024,MAPI,1975,1985,1995,1910,1930,-45
750,05 Feb 2024,SIDO,500,500,505,500,505,5
872,05 Feb 2024,UNTR,22850,22850,22925,22675,22675,-175
873,05 Feb 2024,UNVR,3170,3190,3240,3180,3200,30
4,06 Feb 2024,ACES,810,820,845,815,830,20
38,06 Feb 2024,AMRT,2600,2620,2640,2600,2600,0
61,06 Feb 2024,ASII,5175,5175,5275,5150,5250,75
365,06 Feb 2024,HRUM,1155,1160,1175,1125,1140,-15
398,06 Feb 2024,INKP,7900,7950,8075,7875,8000,100
406,06 Feb 2024,INTP,8900,8900,9125,8875,8950,50
518,06 Feb 2024,MAPI,1930,1930,1960,1925,1955,25
750,06 Feb 2024,SIDO,505,505,505,500,500,-5
872,06 Feb 2024,UNTR,22675,22700,22975,22700,22800,125
873,06 Feb 2024,UNVR,3200,3220,3270,3170,3250,50
4,07 Feb 2024,ACES,830,835,845,820,830,0
39,07 Feb 2024,AMRT,2600,2610,2650,2600,2630,30
62,07 Feb 2024,ASII,5250,5250,5325,5250,5325,75
366,07 Feb 2024,HRUM,1140,1140,1140,1090,1105,-35
399,07 Feb 2024,INKP,8000,8000,8150,7950,7950,-50
407,07 Feb 2024,INTP,8950,9050,9050,8800,8800,-150
519,07 Feb 2024,MAPI,1955,1960,2010,1955,1975,20
752,07 Feb 2024,SIDO,500,505,505,500,500,0
876,07 Feb 2024,UNTR,22800,22850,23100,22825,22900,100
877,07 Feb 2024,UNVR,3250,3250,3280,3240,3270,20
4,12 Feb 2024,ACES,830,830,830,810,815,-15
39,12 Feb 2024,AMRT,2630,2610,2640,2490,2580,-50
62,12 Feb 2024,ASII,5325,5300,5350,5225,5300,-25
366,12 Feb 2024,HRUM,1105,1105,1135,1075,1115,10
399,12 Feb 2024,INKP,7950,7975,8000,7800,7850,-100
407,12 Feb 2024,INTP,8800,8800,8975,8800,8900,100
520,12 Feb 2024,MAPI,1975,1980,1990,1955,1965,-10
755,12 Feb 2024,SIDO,500,500,510,498,505,5
879,12 Feb 2024,UNTR,22900,22900,23325,22900,23225,325
880,12 Feb 2024,UNVR,3270,3170,3170,2920,2920,-350
4,13 Feb 2024,ACES,815,815,825,810,820,5
39,13 Feb 2024,AMRT,2580,2570,2630,2510,2610,30
62,13 Feb 2024,ASII,5300,5300,5300,5150,5200,-100
366,13 Feb 2024,HRUM,1115,1130,1150,1110,1135,20
400,13 Feb 2024,INKP,7850,7950,8025,7850,7950,100
408,13 Feb 2024,INTP,8900,8900,8900,8725,8725,-175
521,13 Feb 2024,MAPI,1965,1965,1970,1930,1970,5
756,13 Feb 2024,SIDO,505,505,510,498,500,-5
880,13 Feb 2024,UNTR,23225,23225,23450,23050,23150,-75
881,13 Feb 2024,UNVR,2920,2920,2930,2800,2800,-120
4,15 Feb 2024,ACES,820,825,830,815,825,5
39,15 Feb 2024,AMRT,2610,2730,2740,2650,2700,90
62,15 Feb 2024,ASII,5200,5325,5325,5075,5125,-75
367,15 Feb 2024,HRUM,1135,1165,1220,1160,1190,55
401,15 Feb 2024,INKP,7950,8050,8150,7825,7875,-75
409,15 Feb 2024,INTP,8725,8800,9300,8800,9100,375
522,15 Feb 2024,MAPI,1970,1980,2050,1970,2000,30
757,15 Feb 2024,SIDO,500,505,525,500,520,20
881,15 Feb 2024,UNTR,23150,23325,23450,23125,23200,50
882,15 Feb 2024,UNVR,2800,2860,2940,2830,2930,130
4,16 Feb 2024,ACES,825,825,825,765,775,-50
39,16 Feb 2024,AMRT,2700,2730,2800,2710,2770,70
62,16 Feb 2024,ASII,5125,5125,5200,5100,5200,75
367,16 Feb 2024,HRUM,1190,1190,1190,1155,1175,-15
401,16 Feb 2024,INKP,7875,7900,8050,7875,7975,100
409,16 Feb 2024,INTP,9100,9100,9100,8825,8825,-275
522,16 Feb 2024,MAPI,2000,2000,2000,1930,1935,-65
757,16 Feb 2024,SIDO,520,520,560,520,560,40
881,16 Feb 2024,UNTR,23200,23250,23400,23100,23250,50
882,16 Feb 2024,UNVR,2930,2930,2940,2830,2830,-100
4,19 Feb 2024,ACES,775,775,795,760,760,-15
39,19 Feb 2024,AMRT,2770,2770,2780,2730,2750,-20
62,19 Feb 2024,ASII,5200,5200,5250,5075,5125,-75
367,19 Feb 2024,HRUM,1175,1175,1180,1145,1175,0
401,19 Feb 2024,INKP,7975,8000,8025,7850,7850,-125
409,19 Feb 2024,INTP,8825,8850,8900,8825,8825,0
522,19 Feb 2024,MAPI,1935,1935,1955,1850,1900,-35
757,19 Feb 2024,SIDO,560,560,575,540,570,10
881,19 Feb 2024,UNTR,23250,23250,23275,22900,22950,-300
882,19 Feb 2024,UNVR,2830,2830,2870,2800,2800,-30
4,20 Feb 2024,ACES,760,760,795,760,785,25
39,20 Feb 2024,AMRT,2750,2750,2790,2730,2790,40
62,20 Feb 2024,ASII,5125,5125,5250,5125,5200,75
367,20 Feb 2024,HRUM,1175,1175,1185,1160,1175,0
401,20 Feb 2024,INKP,7850,7900,7925,7700,7725,-125
409,20 Feb 2024,INTP,8825,8875,9100,8825,9050,225
522,20 Feb 2024,MAPI,1900,1900,1920,1875,1885,-15
757,20 Feb 2024,SIDO,570,600,610,575,580,10
881,20 Feb 2024,UNTR,22950,22975,23075,22750,22900,-50
882,20 Feb 2024,UNVR,2800,2800,2820,2760,2760,-40
4,21 Feb 2024,ACES,785,790,795,775,795,10
39,21 Feb 2024,AMRT,2790,2790,2810,2670,2770,-20
62,21 Feb 2024,ASII,5200,5200,5300,5175,5250,50
367,21 Feb 2024,HRUM,1175,1175,1205,1155,1155,-20
401,21 Feb 2024,INKP,7725,7775,7775,7700,7775,50
409,21 Feb 2024,INTP,9050,9050,9075,8900,9025,-25
522,21 Feb 2024,MAPI,1885,1895,1930,1885,1930,45
757,21 Feb 2024,SIDO,580,580,605,565,600,20
881,21 Feb 2024,UNTR,22900,22925,23175,22900,23025,125
882,21 Feb 2024,UNVR,2760,2760,2770,2650,2690,-70
4,22 Feb 2024,ACES,795,800,850,800,835,40
39,22 Feb 2024,AMRT,2770,2760,2760,2710,2750,-20
62,22 Feb 2024,ASII,5250,5275,5300,5275,5275,25
367,22 Feb 2024,HRUM,1155,1160,1215,1155,1210,55
401,22 Feb 2024,INKP,7775,7800,7925,7725,7900,125
409,22 Feb 2024,INTP,9025,9025,9100,8975,9075,50
522,22 Feb 2024,MAPI,1930,1950,1980,1935,1975,45
757,22 Feb 2024,SIDO,600,600,620,590,615,15
881,22 Feb 2024,UNTR,23025,23075,23150,23000,23125,100
882,22 Feb 2024,UNVR,2690,2690,2740,2690,2720,30
4,23 Feb 2024,ACES,835,835,845,830,840,5
39,23 Feb 2024,AMRT,2750,2750,2750,2660,2680,-70
62,23 Feb 2024,ASII,5275,5250,5275,5100,5125,-150
367,23 Feb 2024,HRUM,1210,1230,1235,1205,1225,15
401,23 Feb 2024,INKP,7900,7975,7975,7825,7925,25
409,23 Feb 2024,INTP,9075,9075,9075,8900,9050,-25
522,23 Feb 2024,MAPI,1975,1975,1975,1930,1955,-20
757,23 Feb 2024,SIDO,615,615,625,610,625,10
881,23 Feb 2024,UNTR,23125,23150,23150,22800,22800,-325
882,23 Feb 2024,UNVR,2720,2730,2740,2660,2690,-30
4,26 Feb 2024,ACES,840,840,860,840,850,10
39,26 Feb 2024,AMRT,2680,2700,2710,2650,2690,10
62,26 Feb 2024,ASII,5125,5150,5200,5075,5125,0
367,26 Feb 2024,HRUM,1225,1225,1230,1200,1220,-5
401,26 Feb 2024,INKP,7925,7950,7975,7825,7900,-25
409,26 Feb 2024,INTP,9050,9050,9200,8950,9125,75
522,26 Feb 2024,MAPI,1955,1950,1950,1910,1915,-40
757,26 Feb 2024,SIDO,625,625,625,605,620,-5
881,26 Feb 2024,UNTR,22800,22900,23100,22875,23000,200
882,26 Feb 2024,UNVR,2690,2690,2690,2590,2590,-100
4,27 Feb 2024,ACES,850,855,855,835,835,-15
39,27 Feb 2024,AMRT,2690,2650,2680,2630,2660,-30
62,27 Feb 2024,ASII,5125,5125,5175,5050,5175,50
367,27 Feb 2024,HRUM,1220,1235,1240,1190,1200,-20
401,27 Feb 2024,INKP,7900,7900,7925,7750,7800,-100
409,27 Feb 2024,INTP,9125,9150,9175,8975,9075,-50
522,27 Feb 2024,MAPI,1915,1925,1945,1890,1920,5
757,27 Feb 2024,SIDO,620,620,630,615,620,0
881,27 Feb 2024,UNTR,23000,23000,23850,22825,23850,850
882,27 Feb 2024,UNVR,2590,2590,2640,2570,2620,30
4,28 Feb 2024,ACES,835,845,845,830,830,-5
39,28 Feb 2024,AMRT,2660,2670,2710,2650,2700,40
62,28 Feb 2024,ASII,5175,5325,5425,5200,5225,50
367,28 Feb 2024,HRUM,1200,1220,1235,1205,1230,30
401,28 Feb 2024,INKP,7800,7825,8125,7750,8125,325
409,28 Feb 2024,INTP,9075,9075,9125,9025,9100,25
522,28 Feb 2024,MAPI,1920,1930,1940,1915,1935,15
757,28 Feb 2024,SIDO,620,620,620,610,615,-5
881,28 Feb 2024,UNTR,23850,24000,24350,23800,23850,0
882,28 Feb 2024,UNVR,2620,2620,2720,2610,2700,80
4,29 Feb 2024,ACES,830,830,845,820,835,5
39,29 Feb 2024,AMRT,2700,2710,2750,2700,2750,50
62,29 Feb 2024,ASII,5225,5250,5300,5200,5225,0
367,29 Feb 2024,HRUM,1230,1240,1265,1215,1250,20
401,29 Feb 2024,INKP,8125,8150,8850,8125,8725,600
409,29 Feb 2024,INTP,9100,9100,9125,8975,9075,-25
522,29 Feb 2024,MAPI,1935,1935,1935,1920,1920,-15
757,29 Feb 2024,SIDO,615,615,620,600,615,0
881,29 Feb 2024,UNTR,23850,23875,23950,23500,23525,-325
882,29 Feb 2024,UNVR,2700,2710,2730,2640,2730,30
4,01 Mar 2024,ACES,835,840,845,820,825,-10
39,01 Mar 2024,AMRT,2750,2750,2750,2700,2720,-30
62,01 Mar 2024,ASII,5225,5225,5275,5150,5225,0
367,01 Mar 2024,HRUM,1250,1255,1280,1235,1260,10
401,01 Mar 2024,INKP,8725,8725,9100,8525,8975,250
409,01 Mar 2024,INTP,9075,8975,9175,8950,9175,100
522,01 Mar 2024,MAPI,1920,1930,1975,1925,1970,50
757,01 Mar 2024,SIDO,615,615,615,595,610,-5
881,01 Mar 2024,UNTR,23525,23525,23775,23450,23725,200
882,01 Mar 2024,UNVR,2730,2710,2730,2660,2730,0
4,04 Mar 2024,ACES,825,830,830,810,820,-5
39,04 Mar 2024,AMRT,2720,2740,2770,2710,2750,30
62,04 Mar 2024,ASII,5225,5250,5275,5175,5200,-25
367,04 Mar 2024,HRUM,1260,1260,1270,1245,1260,0
401,04 Mar 2024,INKP,8975,8950,8950,8625,8725,-250
409,04 Mar 2024,INTP,9175,9125,9125,8975,8975,-200
522,04 Mar 2024,MAPI,1970,1975,2030,1965,1990,20
757,04 Mar 2024,SIDO,610,610,630,600,620,10
881,04 Mar 2024,UNTR,23725,23775,24175,23775,24000,275
882,04 Mar 2024,UNVR,2730,2730,2740,2660,2670,-60
4,05 Mar 2024,ACES,820,820,825,805,805,-15
39,05 Mar 2024,AMRT,2750,2750,2760,2720,2720,-30
62,05 Mar 2024,ASII,5200,5225,5225,5100,5100,-100
367,05 Mar 2024,HRUM,1260,1260,1285,1240,1240,-20
401,05 Mar 2024,INKP,8725,8725,8800,8450,8575,-150
409,05 Mar 2024,INTP,8975,9000,9000,8825,8925,-50
522,05 Mar 2024,MAPI,1990,1990,1990,1965,1970,-20
757,05 Mar 2024,SIDO,620,620,625,615,620,0
881,05 Mar 2024,UNTR,24000,24025,24375,24025,24125,125
882,05 Mar 2024,UNVR,2670,2670,2690,2640,2670,0
4,06 Mar 2024,ACES,805,810,820,800,800,-5
39,06 Mar 2024,AMRT,2720,2740,2770,2720,2750,30
62,06 Mar 2024,ASII,5100,5125,5200,5100,5175,75
367,06 Mar 2024,HRUM,1240,1240,1275,1210,1265,25
401,06 Mar 2024,INKP,8575,8575,8600,8250,8300,-275
409,06 Mar 2024,INTP,8925,8925,8925,8850,8900,-25
522,06 Mar 2024,MAPI,1970,1970,1980,1950,1975,5
757,06 Mar 2024,SIDO,620,620,620,600,610,-10
881,06 Mar 2024,UNTR,24125,24200,24400,24025,24325,200
882,06 Mar 2024,UNVR,2670,2680,2720,2670,2690,20
4,07 Mar 2024,ACES,800,805,830,805,820,20
39,07 Mar 2024,AMRT,2750,2730,2790,2730,2760,10
62,07 Mar 2024,ASII,5175,5175,5200,5100,5125,-50
367,07 Mar 2024,HRUM,1265,1265,1335,1245,1320,55
401,07 Mar 2024,INKP,8300,8300,8500,8250,8375,75
409,07 Mar 2024,INTP,8900,8850,8900,8750,8750,-150
522,07 Mar 2024,MAPI,1975,1955,1995,1955,1980,5
757,07 Mar 2024,SIDO,610,605,620,605,620,10
881,07 Mar 2024,UNTR,24325,24325,24400,24000,24000,-325
882,07 Mar 2024,UNVR,2690,2700,2730,2680,2730,40
4,08 Mar 2024,ACES,820,820,835,820,825,5
39,08 Mar 2024,AMRT,2760,2760,2810,2750,2790,30
62,08 Mar 2024,ASII,5125,5150,5175,5125,5150,25
367,08 Mar 2024,HRUM,1320,1325,1335,1275,1295,-25
401,08 Mar 2024,INKP,8375,8400,8450,8300,8325,-50
409,08 Mar 2024,INTP,8750,8750,8825,8700,8725,-25
522,08 Mar 2024,MAPI,1980,1980,1985,1860,1885,-95
757,08 Mar 2024,SIDO,620,615,625,610,625,5
881,08 Mar 2024,UNTR,24000,24025,24325,24025,24175,175
882,08 Mar 2024,UNVR,2730,2730,2740,2660,2660,-70
4,13 Mar 2024,ACES,825,830,850,830,835,10
39,13 Mar 2024,AMRT,2790,2810,2840,2790,2820,30
62,13 Mar 2024,ASII,5150,5150,5200,5125,5150,0
367,13 Mar 2024,HRUM,1295,1300,1375,1290,1360,65
401,13 Mar 2024,INKP,8325,8400,8625,8350,8500,175
409,13 Mar 2024,INTP,8725,8725,8750,8500,8525,-200
522,13 Mar 2024,MAPI,1885,1915,1950,1865,1920,35
757,13 Mar 2024,SIDO,625,625,630,615,620,-5
881,13 Mar 2024,UNTR,24175,24125,24150,23500,23525,-650
882,13 Mar 2024,UNVR,2660,2720,2720,2660,2720,60
4,14 Mar 2024,ACES,835,835,845,820,840,5
39,14 Mar 2024,AMRT,2820,2830,2900,2820,2900,80
62,14 Mar 2024,ASII,5150,5175,5300,5150,5275,125
367,14 Mar 2024,HRUM,1360,1365,1390,1345,1380,20
401,14 Mar 2024,INKP,8500,8550,8600,8325,8600,100
409,14 Mar 2024,INTP,8525,8575,8775,8575,8700,175
522,14 Mar 2024,MAPI,1920,1940,1960,1915,1935,15
757,14 Mar 2024,SIDO,620,620,620,605,615,-5
881,14 Mar 2024,UNTR,23525,23575,24125,23550,24125,600
882,14 Mar 2024,UNVR,2720,2720,2720,2660,2690,-30
4,15 Mar 2024,ACES,840,840,845,830,835,-5
39,15 Mar 2024,AMRT,2900,2900,2910,2820,2880,-20
62,15 Mar 2024,ASII,5275,5300,5300,5175,5175,-100
367,15 Mar 2024,HRUM,1380,1390,1420,1370,1410,30
401,15 Mar 2024,INKP,8600,8600,8625,8450,8550,-50
409,15 Mar 2024,INTP,8700,8775,8775,8625,8625,-75
522,15 Mar 2024,MAPI,1935,1940,1965,1930,1930,-5
757,15 Mar 2024,SIDO,615,610,615,600,605,-10
881,15 Mar 2024,UNTR,24125,24125,24775,24000,24175,50
882,15 Mar 2024,UNVR,2690,2660,2690,2620,2640,-50
4,18 Mar 2024,ACES,835,835,845,825,825,-10
39,18 Mar 2024,AMRT,2880,2890,2900,2840,2870,-10
62,18 Mar 2024,ASII,5175,5200,5250,5150,5150,-25
367,18 Mar 2024,HRUM,1410,1410,1445,1370,1440,30
401,18 Mar 2024,INKP,8550,8550,9225,8550,9150,600
409,18 Mar 2024,INTP,8625,8625,8725,8625,8625,0
522,18 Mar 2024,MAPI,1930,1930,1940,1895,1905,-25
757,18 Mar 2024,SIDO,605,605,610,600,600,-5
881,18 Mar 2024,UNTR,24175,24225,24575,24225,24275,100
882,18 Mar 2024,UNVR,2640,2640,2800,2640,2770,130
4,19 Mar 2024,ACES,825,825,855,825,845,20
39,19 Mar 2024,AMRT,2870,2860,2930,2860,2890,20
62,19 Mar 2024,ASII,5150,5150,5250,5150,5225,75
367,19 Mar 2024,HRUM,1440,1440,1445,1390,1395,-45
401,19 Mar 2024,INKP,9150,9150,9400,9050,9150,0
409,19 Mar 2024,INTP,8625,8625,8675,8525,8550,-75
522,19 Mar 2024,MAPI,1905,1905,1925,1825,1825,-80
757,19 Mar 2024,SIDO,600,600,610,600,605,5
881,19 Mar 2024,UNTR,24275,24300,24475,24275,24375,100
882,19 Mar 2024,UNVR,2770,2780,2790,2740,2740,-30
4,20 Mar 2024,ACES,845,850,945,850,930,85
39,20 Mar 2024,AMRT,2890,2900,2920,2870,2900,10
62,20 Mar 2024,ASII,5225,5225,5275,5225,5275,50
367,20 Mar 2024,HRUM,1395,1395,1415,1345,1365,-30
401,20 Mar 2024,INKP,9150,9150,9225,8950,9200,50
409,20 Mar 2024,INTP,8550,8600,8650,8500,8550,0
522,20 Mar 2024,MAPI,1825,1825,1840,1780,1815,-10
757,20 Mar 2024,SIDO,605,605,630,600,630,25
881,20 Mar 2024,UNTR,24375,24375,24550,24375,24550,175
882,20 Mar 2024,UNVR,2740,2760,2820,2740,2760,20
4,21 Mar 2024,ACES,930,930,950,915,920,-10
39,21 Mar 2024,AMRT,2900,2910,2910,2880,2900,0
62,21 Mar 2024,ASII,5275,5300,5400,5275,5350,75
367,21 Mar 2024,HRUM,1365,1365,1395,1355,1390,25
401,21 Mar 2024,INKP,9200,9300,9325,9075,9150,-50
409,21 Mar 2024,INTP,8550,8600,8725,8550,8575,25
522,21 Mar 2024,MAPI,1815,1815,1870,1805,1805,-10
757,21 Mar 2024,SIDO,630,635,645,625,635,5
881,21 Mar 2024,UNTR,24550,24550,24900,24550,24775,225
882,21 Mar 2024,UNVR,2760,2760,2780,2720,2720,-40
4,22 Mar 2024,ACES,920,925,935,910,915,-5
39,22 Mar 2024,AMRT,2900,2900,2940,2890,2900,0
62,22 Mar 2024,ASII,5350,5375,5375,5325,5375,25
367,22 Mar 2024,HRUM,1390,1390,1395,1345,1385,-5
401,22 Mar 2024,INKP,9150,9150,9475,9150,9350,200
409,22 Mar 2024,INTP,8575,8750,8825,8575,8600,25
522,22 Mar 2024,MAPI,1805,1805,1820,1775,1815,10
757,22 Mar 2024,SIDO,635,640,640,610,630,-5
881,22 Mar 2024,UNTR,24775,24775,24775,24525,24600,-175
882,22 Mar 2024,UNVR,2720,2720,2750,2670,2720,0
4,25 Mar 2024,ACES,915,910,945,900,930,15
39,25 Mar 2024,AMRT,2900,2880,2910,2850,2900,0
62,25 Mar 2024,ASII,5375,5375,5425,5325,5350,-25
367,25 Mar 2024,HRUM,1385,1385,1385,1345,1355,-30
401,25 Mar 2024,INKP,9350,9350,9825,9325,9675,325
409,25 Mar 2024,INTP,8600,8625,8725,8600,8725,125
522,25 Mar 2024,MAPI,1815,1820,1835,1805,1815,0
757,25 Mar 2024,SIDO,630,630,630,615,620,-10
881,25 Mar 2024,UNTR,24600,24700,24825,24400,24550,-50
882,25 Mar 2024,UNVR,2720,2720,2760,2690,2760,40
4,26 Mar 2024,ACES,930,930,930,910,925,-5
39,26 Mar 2024,AMRT,2900,2910,2920,2890,2900,0
62,26 Mar 2024,ASII,5350,5350,5375,5250,5300,-50
367,26 Mar 2024,HRUM,1355,1360,1365,1325,1335,-20
401,26 Mar 2024,INKP,9675,9750,9875,9525,9700,25
409,26 Mar 2024,INTP,8725,8725,8725,8625,8700,-25
522,26 Mar 2024,MAPI,1815,1815,1830,1805,1825,10
757,26 Mar 2024,SIDO,620,620,625,615,615,-5
881,26 Mar 2024,UNTR,24550,24550,24650,24225,24300,-250
882,26 Mar 2024,UNVR,2760,2760,2770,2730,2770,10
4,27 Mar 2024,ACES,925,925,930,905,910,-15
39,27 Mar 2024,AMRT,2900,2900,2930,2870,2900,0
62,27 Mar 2024,ASII,5300,5300,5325,5250,5275,-25
367,27 Mar 2024,HRUM,1335,1340,1390,1330,1380,45
401,27 Mar 2024,INKP,9700,9800,9875,9575,9775,75
409,27 Mar 2024,INTP,8700,8700,8775,8650,8750,50
522,27 Mar 2024,MAPI,1825,1825,1835,1790,1800,-25
757,27 Mar 2024,SIDO,615,620,635,620,625,10
881,27 Mar 2024,UNTR,24300,24450,24700,24450,24600,300
882,27 Mar 2024,UNVR,2770,2730,2770,2720,2730,-40
4,28 Mar 2024,ACES,910,910,915,880,880,-30
39,28 Mar 2024,AMRT,2900,2920,2920,2900,2910,10
62,28 Mar 2024,ASII,5275,5275,5275,5100,5150,-125
367,28 Mar 2024,HRUM,1380,1390,1400,1335,1350,-30
401,28 Mar 2024,INKP,9775,9800,9925,9575,9575,-200
409,28 Mar 2024,INTP,8750,8750,8775,8600,8750,0
522,28 Mar 2024,MAPI,1800,1805,1820,1790,1820,20
757,28 Mar 2024,SIDO,625,625,630,620,620,-5
881,28 Mar 2024,UNTR,24600,24625,24650,24175,24175,-425
882,28 Mar 2024,UNVR,2730,2730,2740,2650,2700,-30
4,01 Apr 2024,ACES,880,880,910,855,910,30
39,01 Apr 2024,AMRT,2910,2910,2920,2890,2910,0
63,01 Apr 2024,ASII,5150,5175,5225,5150,5200,50
368,01 Apr 2024,HRUM,1350,1350,1365,1330,1355,5
402,01 Apr 2024,INKP,9575,9550,9725,9225,9550,-25
410,01 Apr 2024,INTP,8750,8750,8925,8625,8925,175
523,01 Apr 2024,MAPI,1820,1815,1860,1815,1840,20
758,01 Apr 2024,SIDO,620,620,625,600,610,-10
882,01 Apr 2024,UNTR,24175,24350,24350,23850,24025,-150
883,01 Apr 2024,UNVR,2700,2700,2730,2630,2730,30
4,02 Apr 2024,ACES,910,910,965,910,955,45
39,02 Apr 2024,AMRT,2910,2920,2920,2890,2910,0
63,02 Apr 2024,ASII,5200,5225,5275,5175,5275,75
368,02 Apr 2024,HRUM,1355,1355,1435,1355,1425,70
402,02 Apr 2024,INKP,9550,9500,9725,9250,9650,100
410,02 Apr 2024,INTP,8925,8800,8825,8700,8825,-100
523,02 Apr 2024,MAPI,1840,1865,1910,1860,1895,55
758,02 Apr 2024,SIDO,610,610,615,605,605,-5
882,02 Apr 2024,UNTR,24025,24100,24900,24025,24900,875
883,02 Apr 2024,UNVR,2730,2720,2740,2700,2740,10
4,03 Apr 2024,ACES,955,955,965,945,955,0
39,03 Apr 2024,AMRT,2910,2910,2910,2880,2890,-20
63,03 Apr 2024,ASII,5275,5275,5275,5200,5250,-25
368,03 Apr 2024,HRUM,1425,1430,1540,1430,1470,45
402,03 Apr 2024,INKP,9650,9550,9975,9450,9900,250
410,03 Apr 2024,INTP,8825,8825,8825,8675,8700,-125
523,03 Apr 2024,MAPI,1895,1900,1905,1840,1860,-35
758,03 Apr 2024,SIDO,605,605,645,605,640,35
882,03 Apr 2024,UNTR,24900,24900,25375,24700,25250,350
883,03 Apr 2024,UNVR,2740,2740,2740,2670,2690,-50
4,04 Apr 2024,ACES,955,955,985,930,965,10
39,04 Apr 2024,AMRT,2890,2900,2910,2880,2900,10
63,04 Apr 2024,ASII,5250,5250,5250,5150,5175,-75
368,04 Apr 2024,HRUM,1470,1475,1510,1445,1455,-15
402,04 Apr 2024,INKP,9900,9900,9925,9650,9650,-250
410,04 Apr 2024,INTP,8700,8725,8725,8625,8725,25
523,04 Apr 2024,MAPI,1860,1880,1910,1850,1900,40
758,04 Apr 2024,SIDO,640,645,670,640,660,20
882,04 Apr 2024,UNTR,25250,25250,25275,25000,25050,-200
883,04 Apr 2024,UNVR,2690,2690,2790,2690,2710,20
4,05 Apr 2024,ACES,965,960,960,945,950,-15
39,05 Apr 2024,AMRT,2900,2900,2900,2870,2880,-20
63,05 Apr 2024,ASII,5175,5150,5325,5150,5275,100
368,05 Apr 2024,HRUM,1455,1460,1470,1415,1440,-15
402,05 Apr 2024,INKP,9650,9650,9800,9525,9575,-75
410,05 Apr 2024,INTP,8725,8675,8675,8600,8625,-100
523,05 Apr 2024,MAPI,1900,1900,1925,1885,1890,-10
758,05 Apr 2024,SIDO,660,660,705,655,675,15
882,05 Apr 2024,UNTR,25050,25125,25425,25125,25250,200
883,05 Apr 2024,UNVR,2710,2710,2730,2680,2680,-30
4,16 Apr 2024,ACES,950,935,935,885,910,-40
39,16 Apr 2024,AMRT,2880,2670,2790,2660,2700,-180
63,16 Apr 2024,ASII,5275,5175,5225,5100,5100,-175
369,16 Apr 2024,HRUM,1440,1450,1580,1430,1565,125
403,16 Apr 2024,INKP,9575,9300,9800,9300,9725,150
411,16 Apr 2024,INTP,8625,8600,8775,8550,8775,150
524,16 Apr 2024,MAPI,1890,1830,1835,1805,1810,-80
760,16 Apr 2024,SIDO,675,670,680,640,675,0
884,16 Apr 2024,UNTR,25250,25225,26400,25000,26250,1000
885,16 Apr 2024,UNVR,2680,2600,2630,2540,2540,-140
4,17 Apr 2024,ACES,910,910,930,910,920,10
39,17 Apr 2024,AMRT,2700,2740,2820,2710,2790,90
63,17 Apr 2024,ASII,5100,5150,5175,5100,5125,25
369,17 Apr 2024,HRUM,1565,1565,1580,1535,1565,0
403,17 Apr 2024,INKP,9725,9725,9750,9375,9500,-225
411,17 Apr 2024,INTP,8775,8775,8775,8450,8450,-325
524,17 Apr 2024,MAPI,1810,1815,1840,1790,1795,-15
760,17 Apr 2024,SIDO,675,675,675,660,665,-10
884,17 Apr 2024,UNTR,26250,26300,26300,25575,25575,-675
885,17 Apr 2024,UNVR,2540,2540,2550,2370,2370,-170
4,18 Apr 2024,ACES,920,925,950,925,940,20
39,18 Apr 2024,AMRT,2790,2800,2820,2740,2790,0
63,18 Apr 2024,ASII,5125,5150,5150,5050,5100,-25
369,18 Apr 2024,HRUM,1565,1570,1590,1345,1370,-195
403,18 Apr 2024,INKP,9500,9525,9850,9500,9650,150
411,18 Apr 2024,INTP,8450,8500,8500,8225,8225,-225
524,18 Apr 2024,MAPI,1795,1800,1830,1770,1775,-20
760,18 Apr 2024,SIDO,665,665,675,660,665,0
884,18 Apr 2024,UNTR,25575,25575,25825,25200,25525,-50
885,18 Apr 2024,UNVR,2370,2370,2430,2370,2390,20
4,19 Apr 2024,ACES,940,940,945,915,920,-20
39,19 Apr 2024,AMRT,2790,2810,2840,2740,2800,10
63,19 Apr 2024,ASII,5100,5050,5075,4870,4900,-200
369,19 Apr 2024,HRUM,1370,1375,1395,1270,1290,-80
403,19 Apr 2024,INKP,9650,9650,9775,9500,9650,0
411,19 Apr 2024,INTP,8225,8175,8175,7650,7650,-575
524,19 Apr 2024,MAPI,1775,1770,1775,1655,1695,-80
760,19 Apr 2024,SIDO,665,665,690,645,685,20
884,19 Apr 2024,UNTR,25525,25675,25725,25200,25350,-175
885,19 Apr 2024,UNVR,2390,2380,2440,2330,2380,-10
4,22 Apr 2024,ACES,920,935,960,930,945,25
39,22 Apr 2024,AMRT,2800,2830,2890,2800,2880,80
63,22 Apr 2024,ASII,4900,4940,4990,4940,4950,50
369,22 Apr 2024,HRUM,1290,1300,1360,1290,1335,45
403,22 Apr 2024,INKP,9650,9650,9900,9650,9850,200
411,22 Apr 2024,INTP,7650,7700,7850,7650,7725,75
524,22 Apr 2024,MAPI,1695,1720,1745,1615,1675,-20
760,22 Apr 2024,SIDO,685,690,715,690,710,25
884,22 Apr 2024,UNTR,25350,25525,25675,25225,25300,-50
885,22 Apr 2024,UNVR,2380,2400,2430,2370,2410,30
4,23 Apr 2024,ACES,945,950,980,950,970,25
39,23 Apr 2024,AMRT,2880,2900,2980,2890,2940,60
63,23 Apr 2024,ASII,4950,4990,5075,4990,5025,75
369,23 Apr 2024,HRUM,1335,1335,1375,1335,1355,20
403,23 Apr 2024,INKP,9850,9900,9950,9675,9725,-125
411,23 Apr 2024,INTP,7725,7775,7900,7750,7825,100
524,23 Apr 2024,MAPI,1675,1685,1690,1620,1635,-40
760,23 Apr 2024,SIDO,710,710,715,705,715,5
884,23 Apr 2024,UNTR,25300,25300,25400,24800,24950,-350
885,23 Apr 2024,UNVR,2410,2420,2430,2330,2330,-80
4,24 Apr 2024,ACES,970,975,985,960,970,0
39,24 Apr 2024,AMRT,2940,2930,2940,2850,2900,-40
63,24 Apr 2024,ASII,5025,5000,5050,4910,4910,-115
369,24 Apr 2024,HRUM,1355,1365,1375,1300,1300,-55
403,24 Apr 2024,INKP,9725,9725,10000,9700,9825,100
411,24 Apr 2024,INTP,7825,7825,7850,7675,7675,-150
524,24 Apr 2024,MAPI,1635,1650,1700,1650,1675,40
760,24 Apr 2024,SIDO,715,715,720,710,720,5
884,24 Apr 2024,UNTR,24950,25050,25450,24450,24850,-100
885,24 Apr 2024,UNVR,2330,2350,2420,2350,2390,60
4,25 Apr 2024,ACES,970,970,995,965,975,5
39,25 Apr 2024,AMRT,2900,2930,2940,2890,2930,30
63,25 Apr 2024,ASII,4910,4910,4980,4910,4950,40
369,25 Apr 2024,HRUM,1300,1300,1325,1275,1320,20
403,25 Apr 2024,INKP,9825,9925,9925,9625,9650,-175
411,25 Apr 2024,INTP,7675,7675,7700,7500,7625,-50
524,25 Apr 2024,MAPI,1675,1680,1680,1625,1635,-40
760,25 Apr 2024,SIDO,720,720,750,715,725,5
884,25 Apr 2024,UNTR,24850,24850,25000,24100,24250,-600
885,25 Apr 2024,UNVR,2390,2500,2690,2500,2640,250
4,26 Apr 2024,ACES,975,975,975,890,910,-65
39,26 Apr 2024,AMRT,2930,2940,2940,2840,2840,-90
63,26 Apr 2024,ASII,4950,4980,4980,4880,4880,-70
369,26 Apr 2024,HRUM,1320,1320,1325,1285,1300,-20
403,26 Apr 2024,INKP,9650,9650,9725,8800,8975,-675
411,26 Apr 2024,INTP,7625,7700,7725,7525,7600,-25
524,26 Apr 2024,MAPI,1635,1635,1660,1530,1555,-80
760,26 Apr 2024,SIDO,725,730,745,690,705,-20
884,26 Apr 2024,UNTR,24250,24300,24450,24150,24150,-100
885,26 Apr 2024,UNVR,2640,2650,2750,2590,2590,-50
4,29 Apr 2024,ACES,910,910,940,910,935,25
39,29 Apr 2024,AMRT,2840,2920,2970,2760,2940,100
63,29 Apr 2024,ASII,4880,4920,5050,4900,5025,145
369,29 Apr 2024,HRUM,1300,1300,1395,1290,1390,90
403,29 Apr 2024,INKP,8975,9000,9525,8675,9475,500
411,29 Apr 2024,INTP,7600,7600,7700,7575,7625,25
524,29 Apr 2024,MAPI,1555,1555,1675,1530,1655,100
760,29 Apr 2024,SIDO,705,705,725,705,725,20
884,29 Apr 2024,UNTR,24150,24200,25100,23850,24875,725
885,29 Apr 2024,UNVR,2590,2600,2610,2480,2590,0
4,30 Apr 2024,ACES,935,935,940,920,935,0
39,30 Apr 2024,AMRT,2940,2970,2970,2900,2930,-10
63,30 Apr 2024,ASII,5025,5050,5225,4980,5150,125
369,30 Apr 2024,HRUM,1390,1390,1420,1375,1410,20
403,30 Apr 2024,INKP,9475,9475,9625,9225,9375,-100
411,30 Apr 2024,INTP,7625,7650,7900,7650,7750,125
524,30 Apr 2024,MAPI,1655,1665,1665,1570,1575,-80
760,30 Apr 2024,SIDO,725,720,730,715,730,5
884,30 Apr 2024,UNTR,24875,24575,25100,24550,24825,-50
885,30 Apr 2024,UNVR,2590,2590,2670,2560,2620,30
4,02 Mei 2024,ACES,935,935,935,870,910,-25
39,02 Mei 2024,AMRT,2930,2920,2920,2840,2870,-60
63,02 Mei 2024,ASII,5150,5225,5275,5175,5175,25
369,02 Mei 2024,HRUM,1410,1425,1425,1350,1350,-60
403,02 Mei 2024,INKP,9375,9375,9525,9175,9225,-150
411,02 Mei 2024,INTP,7750,7550,7625,7100,7225,-525
524,02 Mei 2024,MAPI,1575,1575,1575,1400,1440,-135
760,02 Mei 2024,SIDO,730,730,735,705,715,-15
884,02 Mei 2024,UNTR,24825,24850,24850,24100,24300,-525
885,02 Mei 2024,UNVR,2620,2620,2640,2570,2640,20
4,03 Mei 2024,ACES,910,915,925,870,880,-30
39,03 Mei 2024,AMRT,2870,2880,2910,2870,2900,30
63,03 Mei 2024,ASII,5175,5225,5250,5200,5225,50
369,03 Mei 2024,HRUM,1350,1365,1395,1345,1375,25
403,03 Mei 2024,INKP,9225,9225,9400,9225,9325,100
411,03 Mei 2024,INTP,7225,7275,7400,7100,7200,-25
524,03 Mei 2024,MAPI,1440,1450,1510,1430,1485,45
760,03 Mei 2024,SIDO,715,715,720,705,720,5
884,03 Mei 2024,UNTR,24300,24300,24425,23850,23950,-350
885,03 Mei 2024,UNVR,2640,2640,2650,2570,2600,-40
4,06 Mei 2024,ACES,880,895,900,865,875,-5
39,06 Mei 2024,AMRT,2900,2940,2950,2890,2900,0
63,06 Mei 2024,ASII,5225,5250,5250,5075,5100,-125
369,06 Mei 2024,HRUM,1375,1390,1415,1370,1385,10
403,06 Mei 2024,INKP,9325,9500,9550,9375,9450,125
411,06 Mei 2024,INTP,7200,7300,7350,7025,7125,-75
524,06 Mei 2024,MAPI,1485,1490,1495,1430,1445,-40
760,06 Mei 2024,SIDO,720,720,725,710,720,0
884,06 Mei 2024,UNTR,23950,22500,22525,22250,22400,-1550
885,06 Mei 2024,UNVR,2600,2650,2650,2570,2600,0
4,07 Mei 2024,ACES,875,875,900,875,890,15
39,07 Mei 2024,AMRT,2900,2920,2920,2860,2880,-20
63,07 Mei 2024,ASII,5100,5100,5125,5025,5050,-50
370,07 Mei 2024,HRUM,1385,1390,1405,1380,1400,15
404,07 Mei 2024,INKP,9450,9450,9750,9350,9425,-25
412,07 Mei 2024,INTP,7125,7100,7100,7025,7075,-50
525,07 Mei 2024,MAPI,1445,1450,1460,1405,1405,-40
761,07 Mei 2024,SIDO,720,720,725,710,720,0
885,07 Mei 2024,UNTR,22400,22400,22400,22150,22250,-150
886,07 Mei 2024,UNVR,2600,2600,2600,2530,2540,-60
4,08 Mei 2024,ACES,890,895,915,875,875,-15
39,08 Mei 2024,AMRT,2880,2900,2920,2830,2880,0
63,08 Mei 2024,ASII,5050,5075,5150,5000,5125,75
370,08 Mei 2024,HRUM,1400,1405,1410,1345,1345,-55
404,08 Mei 2024,INKP,9425,9475,9525,9350,9525,100
412,08 Mei 2024,INTP,7075,7025,7050,6800,6800,-275
525,08 Mei 2024,MAPI,1405,1410,1525,1405,1495,90
761,08 Mei 2024,SIDO,720,720,725,710,720,0
886,08 Mei 2024,UNTR,22250,22300,22375,22050,22100,-150
887,08 Mei 2024,UNVR,2540,2540,2580,2530,2560,20
4,13 Mei 2024,ACES,875,880,885,805,855,-20
39,13 Mei 2024,AMRT,2880,2850,2870,2800,2830,-50
63,13 Mei 2024,ASII,5125,5150,5175,5075,5075,-50
370,13 Mei 2024,HRUM,1345,1355,1360,1320,1345,0
404,13 Mei 2024,INKP,9525,9450,9725,9350,9675,150
412,13 Mei 2024,INTP,6800,6825,6825,6650,6675,-125
525,13 Mei 2024,MAPI,1495,1490,1540,1450,1525,30
761,13 Mei 2024,SIDO,720,720,720,705,715,-5
886,13 Mei 2024,UNTR,22100,22100,22300,22050,22200,100
887,13 Mei 2024,UNVR,2560,2560,2690,2560,2650,90
4,14 Mei 2024,ACES,855,855,875,845,855,0
39,14 Mei 2024,AMRT,2830,2820,2840,2790,2800,-30
63,14 Mei 2024,ASII,5075,4680,4690,4580,4580,-495
370,14 Mei 2024,HRUM,1345,1345,1360,1330,1345,0
404,14 Mei 2024,INKP,9675,9675,9725,9475,9475,-200
412,14 Mei 2024,INTP,6675,6725,6775,6575,6625,-50
525,14 Mei 2024,MAPI,1525,1530,1530,1475,1510,-15
761,14 Mei 2024,SIDO,715,715,730,705,720,5
886,14 Mei 2024,UNTR,22200,22300,22650,22150,22500,300
887,14 Mei 2024,UNVR,2650,2670,2710,2640,2700,50
4,15 Mei 2024,ACES,855,855,880,855,875,20
39,15 Mei 2024,AMRT,2800,2800,2820,2750,2790,-10
63,15 Mei 2024,ASII,4580,4570,4620,4530,4530,-50
370,15 Mei 2024,HRUM,1345,1345,1345,1295,1305,-40
404,15 Mei 2024,INKP,9475,9475,9775,9475,9700,225
412,15 Mei 2024,INTP,6625,6650,6675,6450,6625,0
525,15 Mei 2024,MAPI,1510,1510,1515,1480,1510,0
761,15 Mei 2024,SIDO,720,720,720,710,715,-5
886,15 Mei 2024,UNTR,22500,22550,22650,22250,22250,-250
887,15 Mei 2024,UNVR,2700,2700,2710,2650,2680,-20
4,16 Mei 2024,ACES,875,875,885,850,850,-25
39,16 Mei 2024,AMRT,2790,2810,2890,2800,2850,60
63,16 Mei 2024,ASII,4530,4590,4720,4540,4710,180
370,16 Mei 2024,HRUM,1305,1315,1320,1285,1300,-5
404,16 Mei 2024,INKP,9700,9700,9775,9575,9700,0
412,16 Mei 2024,INTP,6625,6675,6950,6625,6775,150
525,16 Mei 2024,MAPI,1510,1520,1520,1480,1485,-25
761,16 Mei 2024,SIDO,715,715,720,710,715,0
886,16 Mei 2024,UNTR,22250,22325,22400,22100,22150,-100
887,16 Mei 2024,UNVR,2680,2680,2700,2660,2700,20
4,17 Mei 2024,ACES,850,865,865,835,845,-5
39,17 Mei 2024,AMRT,2850,2810,2840,2760,2800,-50
63,17 Mei 2024,ASII,4710,4710,4810,4690,4800,90
370,17 Mei 2024,HRUM,1300,1310,1400,1310,1395,95
404,17 Mei 2024,INKP,9700,9700,9900,9700,9800,100
412,17 Mei 2024,INTP,6775,6775,6925,6775,6850,75
525,17 Mei 2024,MAPI,1485,1475,1505,1455,1490,5
761,17 Mei 2024,SIDO,715,715,720,710,715,0
886,17 Mei 2024,UNTR,22150,22150,22350,22150,22300,150
887,17 Mei 2024,UNVR,2700,2700,2750,2700,2710,10
4,20 Mei 2024,ACES,845,860,865,845,850,5
39,20 Mei 2024,AMRT,2800,2800,2840,2800,2800,0
63,20 Mei 2024,ASII,4800,4800,4830,4730,4740,-60
370,20 Mei 2024,HRUM,1395,1415,1445,1395,1410,15
404,20 Mei 2024,INKP,9800,9800,9875,9625,9700,-100
412,20 Mei 2024,INTP,6850,6850,6875,6750,6875,25
525,20 Mei 2024,MAPI,1490,1500,1500,1465,1485,-5
761,20 Mei 2024,SIDO,715,715,715,700,705,-10
886,20 Mei 2024,UNTR,22300,22300,22850,22300,22850,550
887,20 Mei 2024,UNVR,2710,2710,2750,2680,2700,-10
4,21 Mei 2024,ACES,850,855,855,800,800,-50
39,21 Mei 2024,AMRT,2800,2840,2840,2750,2760,-40
63,21 Mei 2024,ASII,4740,4750,4770,4700,4700,-40
370,21 Mei 2024,HRUM,1410,1410,1415,1355,1365,-45
404,21 Mei 2024,INKP,9700,9725,9800,9550,9625,-75
412,21 Mei 2024,INTP,6875,6875,7125,6825,7000,125
525,21 Mei 2024,MAPI,1485,1495,1495,1405,1405,-80
761,21 Mei 2024,SIDO,705,705,710,670,690,-15
886,21 Mei 2024,UNTR,22850,22950,22950,22325,22425,-425
887,21 Mei 2024,UNVR,2700,2710,2910,2700,2910,210
4,22 Mei 2024,ACES,800,810,810,775,800,0
39,22 Mei 2024,AMRT,2760,2800,2850,2780,2830,70
63,22 Mei 2024,ASII,4700,4720,4730,4700,4710,10
370,22 Mei 2024,HRUM,1365,1365,1365,1325,1330,-35
404,22 Mei 2024,INKP,9625,9725,9725,9575,9625,0
412,22 Mei 2024,INTP,7000,7050,7050,6875,7000,0
525,22 Mei 2024,MAPI,1405,1420,1430,1390,1390,-15
761,22 Mei 2024,SIDO,690,690,715,690,715,25
886,22 Mei 2024,UNTR,22425,22400,22625,22200,22600,175
887,22 Mei 2024,UNVR,2910,2910,3090,2870,3060,150
4,27 Mei 2024,ACES,800,805,820,800,815,15
39,27 Mei 2024,AMRT,2830,2880,2880,2770,2800,-30
63,27 Mei 2024,ASII,4710,4700,4720,4550,4550,-160
370,27 Mei 2024,HRUM,1330,1340,1345,1305,1320,-10
404,27 Mei 2024,INKP,9625,9625,9650,9200,9275,-350
412,27 Mei 2024,INTP,7000,6975,6975,6700,6700,-300
525,27 Mei 2024,MAPI,1390,1390,1400,1335,1345,-45
761,27 Mei 2024,SIDO,715,715,715,680,700,-15
886,27 Mei 2024,UNTR,22600,22600,22650,22400,22625,25
887,27 Mei 2024,UNVR,3060,3090,3270,3090,3260,200
4,28 Mei 2024,ACES,815,815,825,800,810,-5
39,28 Mei 2024,AMRT,2800,2860,2910,2820,2880,80
63,28 Mei 2024,ASII,4550,4560,4600,4510,4510,-40
370,28 Mei 2024,HRUM,1320,1320,1390,1320,1385,65
404,28 Mei 2024,INKP,9275,9250,9675,9125,9600,325
412,28 Mei 2024,INTP,6700,6625,6775,6625,6700,0
525,28 Mei 2024,MAPI,1345,1350,1355,1315,1345,0
761,28 Mei 2024,SIDO,700,690,715,685,705,5
886,28 Mei 2024,UNTR,22625,22675,22700,22325,22475,-150
887,28 Mei 2024,UNVR,3260,3290,3390,3160,3280,20
4,29 Mei 2024,ACES,810,810,835,805,825,15
39,29 Mei 2024,AMRT,2880,2820,2840,2770,2800,-80
63,29 Mei 2024,ASII,4510,4800,4800,4370,4460,-50
370,29 Mei 2024,HRUM,1385,1390,1410,1370,1385,0
404,29 Mei 2024,INKP,9600,9550,9650,9400,9550,-50
412,29 Mei 2024,INTP,6700,6675,6675,6575,6575,-125
525,29 Mei 2024,MAPI,1345,1350,1350,1285,1300,-45
761,29 Mei 2024,SIDO,705,705,715,690,700,-5
886,29 Mei 2024,UNTR,22475,22500,22525,22275,22525,50
887,29 Mei 2024,UNVR,3280,3280,3280,2970,3010,-270
4,30 Mei 2024,ACES,825,830,835,810,815,-10
39,30 Mei 2024,AMRT,2800,2820,2850,2760,2760,-40
63,30 Mei 2024,ASII,4460,4450,4450,4310,4320,-140
370,30 Mei 2024,HRUM,1385,1400,1400,1335,1365,-20
404,30 Mei 2024,INKP,9550,9600,9700,9250,9475,-75
412,30 Mei 2024,INTP,6575,6575,6575,6375,6475,-100
525,30 Mei 2024,MAPI,1300,1300,1310,1270,1295,-5
761,30 Mei 2024,SIDO,700,700,700,670,700,0
886,30 Mei 2024,UNTR,22525,22500,22500,22125,22275,-250
887,30 Mei 2024,UNVR,3010,3000,3190,2970,3110,100
4,31 Mei 2024,ACES,815,815,830,815,820,5
39,31 Mei 2024,AMRT,2760,2780,2820,2650,2650,-110
63,31 Mei 2024,ASII,4320,4340,4370,4290,4290,-30
370,31 Mei 2024,HRUM,1365,1365,1410,1340,1400,35
404,31 Mei 2024,INKP,9475,9475,9525,9100,9100,-375
412,31 Mei 2024,INTP,6475,6475,6725,6425,6475,0
525,31 Mei 2024,MAPI,1295,1295,1315,1240,1270,-25
761,31 Mei 2024,SIDO,700,700,710,680,710,10
886,31 Mei 2024,UNTR,22275,22350,22650,22075,22075,-200
887,31 Mei 2024,UNVR,3110,3160,3230,3120,3120,10
4,02 Jan 2023,ACES,496,0,510,496,510,14
35,02 Jan 2023,AMRT,2650,2660,2750,2650,2740,90
58,02 Jan 2023,ASII,5700,5725,5725,5625,5700,0
332,02 Jan 2023,HRUM,1620,1620,1635,1610,1620,0
362,02 Jan 2023,INKP,8725,8725,8850,8675,8675,-50
370,02 Jan 2023,INTP,9900,9900,9950,9800,9950,50
470,02 Jan 2023,MAPI,1445,0,1530,1400,1415,-30
678,02 Jan 2023,SIDO,755,0,760,740,745,-10
790,02 Jan 2023,UNTR,26075,26100,26150,25800,25800,-275
791,02 Jan 2023,UNVR,4700,4700,4700,4610,4620,-80
4,03 Jan 2023,ACES,510,0,550,510,510,0
35,03 Jan 2023,AMRT,2740,2740,2860,2710,2770,30
58,03 Jan 2023,ASII,5700,5675,5700,5625,5650,-50
332,03 Jan 2023,HRUM,1620,1630,1660,1620,1645,25
362,03 Jan 2023,INKP,8675,8675,8850,8675,8750,75
370,03 Jan 2023,INTP,9950,9950,9950,9825,9850,-100
470,03 Jan 2023,MAPI,1415,0,1440,1400,1415,0
678,03 Jan 2023,SIDO,745,0,755,735,745,0
790,03 Jan 2023,UNTR,25800,25850,26000,25700,25900,100
791,03 Jan 2023,UNVR,4620,4600,4650,4570,4600,-20
4,04 Jan 2023,ACES,510,0,525,500,500,-10
35,04 Jan 2023,AMRT,2770,2780,2840,2740,2740,-30
58,04 Jan 2023,ASII,5650,5650,5700,5625,5675,25
332,04 Jan 2023,HRUM,1645,1660,1665,1620,1625,-20
362,04 Jan 2023,INKP,8750,8750,8800,8300,8400,-350
370,04 Jan 2023,INTP,9850,9850,9925,9675,9775,-75
470,04 Jan 2023,MAPI,1415,0,1430,1350,1395,-20
678,04 Jan 2023,SIDO,745,0,760,740,755,10
790,04 Jan 2023,UNTR,25900,25900,26000,24150,24150,-1750
791,04 Jan 2023,UNVR,4600,4610,4690,4610,4640,40
4,05 Jan 2023,ACES,500,0,505,484,488,-12
35,05 Jan 2023,AMRT,2740,2750,2820,2670,2810,70
58,05 Jan 2023,ASII,5675,5650,5700,5375,5375,-300
332,05 Jan 2023,HRUM,1625,1605,1610,1520,1530,-95
362,05 Jan 2023,INKP,8400,8400,8475,8125,8325,-75
370,05 Jan 2023,INTP,9775,9775,9825,9550,9625,-150
470,05 Jan 2023,MAPI,1395,0,1400,1320,1345,-50
678,05 Jan 2023,SIDO,755,0,760,735,740,-15
790,05 Jan 2023,UNTR,24150,24025,24900,23600,24675,525
791,05 Jan 2023,UNVR,4640,4650,4730,4600,4730,90
4,06 Jan 2023,ACES,488,0,500,480,490,2
35,06 Jan 2023,AMRT,2810,2810,2890,2770,2800,-10
58,06 Jan 2023,ASII,5375,5400,5525,5350,5450,75
335,06 Jan 2023,HRUM,1530,1500,1555,1480,1520,-10
365,06 Jan 2023,INKP,8325,8300,8625,8250,8625,300
373,06 Jan 2023,INTP,9625,9575,10150,9550,10050,425
473,06 Jan 2023,MAPI,1345,0,1370,1300,1300,-45
681,06 Jan 2023,SIDO,740,0,745,735,745,5
794,06 Jan 2023,UNTR,24675,24825,25200,24500,24975,300
795,06 Jan 2023,UNVR,4730,4720,4760,4670,4760,30
4,09 Jan 2023,ACES,490,0,505,490,492,2
35,09 Jan 2023,AMRT,2800,2810,2830,2700,2740,-60
58,09 Jan 2023,ASII,5450,5500,5500,5275,5350,-100
336,09 Jan 2023,HRUM,1520,1540,1585,1515,1575,55
366,09 Jan 2023,INKP,8625,8625,8725,8500,8600,-25
374,09 Jan 2023,INTP,10050,10125,10275,10000,10275,225
474,09 Jan 2023,MAPI,1300,0,1335,1280,1280,-20
682,09 Jan 2023,SIDO,745,0,750,725,730,-15
796,09 Jan 2023,UNTR,24975,25000,25200,24275,24700,-275
797,09 Jan 2023,UNVR,4760,4760,4770,4690,4760,0
4,10 Jan 2023,ACES,492,0,498,470,482,-10
35,10 Jan 2023,AMRT,2740,2740,2760,2670,2720,-20
58,10 Jan 2023,ASII,5350,5375,5375,5275,5325,-25
336,10 Jan 2023,HRUM,1575,1565,1635,1560,1630,55
366,10 Jan 2023,INKP,8600,8600,8625,8350,8550,-50
374,10 Jan 2023,INTP,10275,10125,10175,10000,10050,-225
474,10 Jan 2023,MAPI,1280,0,1280,1195,1210,-70
682,10 Jan 2023,SIDO,730,0,735,705,710,-20
796,10 Jan 2023,UNTR,24700,24575,25250,24300,24950,250
797,10 Jan 2023,UNVR,4760,4760,4770,4660,4690,-70
4,11 Jan 2023,ACES,482,0,484,450,450,-32
35,11 Jan 2023,AMRT,2720,2720,2730,2610,2670,-50
58,11 Jan 2023,ASII,5325,5325,5350,5200,5225,-100
337,11 Jan 2023,HRUM,1630,1640,1650,1595,1640,10
367,11 Jan 2023,INKP,8550,8550,8575,8400,8550,0
375,11 Jan 2023,INTP,10050,10100,10275,9975,10175,125
475,11 Jan 2023,MAPI,1210,0,1320,1210,1290,80
683,11 Jan 2023,SIDO,710,0,715,700,705,-5
797,11 Jan 2023,UNTR,24950,24725,25075,24400,25075,125
798,11 Jan 2023,UNVR,4690,4680,4700,4640,4700,10
4,12 Jan 2023,ACES,450,0,470,442,466,16
35,12 Jan 2023,AMRT,2670,2660,2740,2660,2710,40
58,12 Jan 2023,ASII,5225,5200,5375,5200,5350,125
337,12 Jan 2023,HRUM,1640,1620,1640,1605,1615,-25
367,12 Jan 2023,INKP,8550,8550,8775,8475,8750,200
375,12 Jan 2023,INTP,10175,10275,10450,10175,10300,125
475,12 Jan 2023,MAPI,1290,0,1320,1265,1290,0
683,12 Jan 2023,SIDO,705,0,715,700,715,10
797,12 Jan 2023,UNTR,25075,24900,25125,24800,24950,-125
798,12 Jan 2023,UNVR,4700,4700,4760,4660,4760,60
4,13 Jan 2023,ACES,466,0,470,444,450,-16
35,13 Jan 2023,AMRT,2710,2720,2770,2700,2760,50
58,13 Jan 2023,ASII,5350,5375,5500,5300,5450,100
337,13 Jan 2023,HRUM,1615,1625,1685,1625,1670,55
367,13 Jan 2023,INKP,8750,8750,8750,8475,8625,-125
375,13 Jan 2023,INTP,10300,10300,10425,10200,10275,-25
475,13 Jan 2023,MAPI,1290,0,1300,1270,1295,5
683,13 Jan 2023,SIDO,715,0,730,710,730,15
797,13 Jan 2023,UNTR,24950,25000,25025,24025,24150,-800
798,13 Jan 2023,UNVR,4760,4750,4790,4720,4790,30
4,16 Jan 2023,ACES,450,0,456,440,440,-10
35,16 Jan 2023,AMRT,2760,2760,2790,2660,2680,-80
58,16 Jan 2023,ASII,5450,5525,5600,5475,5600,150
337,16 Jan 2023,HRUM,1670,1685,1700,1660,1695,25
367,16 Jan 2023,INKP,8625,8650,8650,8500,8625,0
375,16 Jan 2023,INTP,10275,10300,10425,10250,10250,-25
475,16 Jan 2023,MAPI,1295,0,1335,1270,1320,25
683,16 Jan 2023,SIDO,730,0,735,725,725,-5
797,16 Jan 2023,UNTR,24150,24175,24350,24100,24225,75
798,16 Jan 2023,UNVR,4790,4790,4800,4750,4770,-20
4,17 Jan 2023,ACES,440,0,446,432,436,-4
35,17 Jan 2023,AMRT,2680,2690,2750,2660,2720,40
58,17 Jan 2023,ASII,5600,5600,5650,5500,5550,-50
337,17 Jan 2023,HRUM,1695,1695,1740,1685,1730,35
367,17 Jan 2023,INKP,8625,8625,8800,8600,8725,100
375,17 Jan 2023,INTP,10250,10250,10275,9800,9975,-275
475,17 Jan 2023,MAPI,1320,0,1365,1320,1350,30
683,17 Jan 2023,SIDO,725,0,735,720,725,0
797,17 Jan 2023,UNTR,24225,24225,24600,24225,24325,100
798,17 Jan 2023,UNVR,4770,4770,4800,4720,4760,-10
4,18 Jan 2023,ACES,436,0,446,436,440,4
35,18 Jan 2023,AMRT,2720,2730,2760,2690,2730,10
58,18 Jan 2023,ASII,5550,5550,5650,5550,5650,100
337,18 Jan 2023,HRUM,1730,1730,1750,1705,1725,-5
367,18 Jan 2023,INKP,8725,8700,8875,8625,8875,150
375,18 Jan 2023,INTP,9975,9975,9975,9750,9825,-150
475,18 Jan 2023,MAPI,1350,0,1375,1305,1335,-15
683,18 Jan 2023,SIDO,725,0,730,720,725,0
797,18 Jan 2023,UNTR,24325,24300,24750,24275,24750,425
798,18 Jan 2023,UNVR,4760,4760,4800,4720,4800,40
4,19 Jan 2023,ACES,440,0,442,426,430,-10
35,19 Jan 2023,AMRT,2730,2730,2760,2710,2750,20
58,19 Jan 2023,ASII,5650,5650,5875,5650,5850,200
337,19 Jan 2023,HRUM,1725,1730,1755,1730,1745,20
367,19 Jan 2023,INKP,8875,8800,8875,8725,8750,-125
375,19 Jan 2023,INTP,9825,9750,10075,9725,10000,175
475,19 Jan 2023,MAPI,1335,0,1395,1330,1390,55
683,19 Jan 2023,SIDO,725,0,730,720,725,0
797,19 Jan 2023,UNTR,24750,24650,26275,24600,26250,1500
798,19 Jan 2023,UNVR,4800,4800,4830,4770,4800,0
4,20 Jan 2023,ACES,430,0,458,430,458,28
35,20 Jan 2023,AMRT,2750,2760,2760,2670,2760,10
58,20 Jan 2023,ASII,5850,5875,5900,5775,5900,50
337,20 Jan 2023,HRUM,1745,1755,1785,1755,1755,10
367,20 Jan 2023,INKP,8750,8800,8975,8700,8825,75
375,20 Jan 2023,INTP,10000,9975,9975,9775,9800,-200
475,20 Jan 2023,MAPI,1390,0,1420,1365,1415,25
683,20 Jan 2023,SIDO,725,0,730,715,725,0
797,20 Jan 2023,UNTR,26250,26350,26775,25950,26775,525
798,20 Jan 2023,UNVR,4800,4800,4830,4760,4810,10
4,24 Jan 2023,ACES,458,0,478,444,450,-8
35,24 Jan 2023,AMRT,2760,2740,2740,2660,2670,-90
58,24 Jan 2023,ASII,5900,5900,5950,5850,5925,25
337,24 Jan 2023,HRUM,1755,1740,1775,1715,1725,-30
367,24 Jan 2023,INKP,8825,8900,8925,8725,8800,-25
375,24 Jan 2023,INTP,9800,9825,9900,9750,9775,-25
475,24 Jan 2023,MAPI,1415,0,1420,1380,1395,-20
684,24 Jan 2023,SIDO,725,0,735,720,725,0
798,24 Jan 2023,UNTR,26775,26775,26925,26025,26125,-650
799,24 Jan 2023,UNVR,4810,4810,4850,4790,4830,20
4,25 Jan 2023,ACES,450,0,454,446,450,0
35,25 Jan 2023,AMRT,2670,2670,2690,2630,2660,-10
58,25 Jan 2023,ASII,5925,5900,5950,5850,5950,25
337,25 Jan 2023,HRUM,1725,1725,1740,1710,1725,0
367,25 Jan 2023,INKP,8800,8800,8825,8700,8775,-25
375,25 Jan 2023,INTP,9775,9775,9900,9750,9850,75
475,25 Jan 2023,MAPI,1395,0,1405,1315,1335,-60
684,25 Jan 2023,SIDO,725,0,735,720,735,10
798,25 Jan 2023,UNTR,26125,26125,26125,25725,26050,-75
799,25 Jan 2023,UNVR,4830,4830,4860,4810,4850,20
4,26 Jan 2023,ACES,450,0,488,452,486,36
35,26 Jan 2023,AMRT,2660,2660,2750,2640,2750,90
58,26 Jan 2023,ASII,5950,5925,5950,5850,5900,-50
337,26 Jan 2023,HRUM,1725,1725,1730,1680,1685,-40
367,26 Jan 2023,INKP,8775,8750,8800,8475,8500,-275
375,26 Jan 2023,INTP,9850,9900,10275,9900,10100,250
475,26 Jan 2023,MAPI,1335,0,1345,1295,1310,-25
684,26 Jan 2023,SIDO,735,0,775,735,770,35
798,26 Jan 2023,UNTR,26050,25900,25900,25250,25250,-800
799,26 Jan 2023,UNVR,4850,4850,4870,4760,4800,-50
4,27 Jan 2023,ACES,486,0,520,484,496,10
35,27 Jan 2023,AMRT,2750,2750,2810,2710,2790,40
58,27 Jan 2023,ASII,5900,5925,5950,5875,5875,-25
337,27 Jan 2023,HRUM,1685,1685,1705,1675,1690,5
367,27 Jan 2023,INKP,8500,8500,8775,8500,8525,25
375,27 Jan 2023,INTP,10100,10100,10100,9850,9900,-200
476,27 Jan 2023,MAPI,1310,0,1340,1250,1265,-45
685,27 Jan 2023,SIDO,770,0,775,760,760,-10
799,27 Jan 2023,UNTR,25250,25275,25800,25275,25575,325
800,27 Jan 2023,UNVR,4800,4800,4820,4750,4750,-50
4,30 Jan 2023,ACES,496,0,510,494,498,2
35,30 Jan 2023,AMRT,2790,2790,2850,2730,2850,60
58,30 Jan 2023,ASII,5875,5875,5900,5775,5875,0
337,30 Jan 2023,HRUM,1690,1690,1710,1660,1695,5
367,30 Jan 2023,INKP,8525,8600,8625,8400,8500,-25
375,30 Jan 2023,INTP,9900,9850,9925,9775,9825,-75
476,30 Jan 2023,MAPI,1265,0,1325,1270,1315,50
685,30 Jan 2023,SIDO,760,0,775,755,765,5
799,30 Jan 2023,UNTR,25575,25275,25775,24950,25250,-325
800,30 Jan 2023,UNVR,4750,4750,4780,4710,4760,10
4,31 Jan 2023,ACES,498,0,515,490,490,-8
35,31 Jan 2023,AMRT,2850,2840,2860,2750,2830,-20
58,31 Jan 2023,ASII,5875,5925,6025,5900,6000,125
337,31 Jan 2023,HRUM,1695,1695,1750,1690,1730,35
367,31 Jan 2023,INKP,8500,8500,8550,8325,8325,-175
375,31 Jan 2023,INTP,9825,9825,10050,9825,10000,175
476,31 Jan 2023,MAPI,1315,0,1335,1295,1300,-15
685,31 Jan 2023,SIDO,765,0,770,750,755,-10
799,31 Jan 2023,UNTR,25250,25200,25350,24550,24550,-700
800,31 Jan 2023,UNVR,4760,4760,4760,4660,4660,-100
4,01 Feb 2023,ACES,490,490,505,476,480,-10
35,01 Feb 2023,AMRT,2830,2840,3150,2790,2970,140
58,01 Feb 2023,ASII,6000,6000,6000,5925,6000,0
338,01 Feb 2023,HRUM,1730,1730,1760,1730,1745,15
368,01 Feb 2023,INKP,8325,8400,8650,8400,8450,125
376,01 Feb 2023,INTP,10000,10075,10175,9850,9900,-100
477,01 Feb 2023,MAPI,1300,0,1470,1300,1390,90
686,01 Feb 2023,SIDO,755,760,785,750,780,25
800,01 Feb 2023,UNTR,24550,24600,25025,24575,24725,175
801,01 Feb 2023,UNVR,4660,4630,4680,4620,4630,-30
4,02 Feb 2023,ACES,480,482,505,482,494,14
35,02 Feb 2023,AMRT,2970,2970,3020,2920,2950,-20
58,02 Feb 2023,ASII,6000,5950,5975,5875,5925,-75
338,02 Feb 2023,HRUM,1745,1745,1755,1690,1695,-50
368,02 Feb 2023,INKP,8450,8550,8700,8525,8525,75
376,02 Feb 2023,INTP,9900,10100,10425,10000,10350,450
477,02 Feb 2023,MAPI,1390,0,1440,1390,1400,10
686,02 Feb 2023,SIDO,780,780,790,780,780,0
800,02 Feb 2023,UNTR,24725,24725,25000,24100,24100,-625
801,02 Feb 2023,UNVR,4630,4630,4740,4630,4730,100
4,03 Feb 2023,ACES,494,500,500,486,492,-2
35,03 Feb 2023,AMRT,2950,2990,2990,2920,2990,40
58,03 Feb 2023,ASII,5925,5975,5975,5875,5875,-50
338,03 Feb 2023,HRUM,1695,1700,1710,1645,1645,-50
368,03 Feb 2023,INKP,8525,8575,8700,8575,8675,150
376,03 Feb 2023,INTP,10350,10350,10650,10325,10600,250
477,03 Feb 2023,MAPI,1400,0,1435,1385,1385,-15
686,03 Feb 2023,SIDO,780,785,790,780,785,5
800,03 Feb 2023,UNTR,24100,24175,24350,23950,24000,-100
801,03 Feb 2023,UNVR,4730,4740,4740,4680,4690,-40
4,06 Feb 2023,ACES,492,494,510,490,498,6
35,06 Feb 2023,AMRT,2990,2980,3000,2880,2920,-70
58,06 Feb 2023,ASII,5875,5875,5900,5825,5850,-25
338,06 Feb 2023,HRUM,1645,1630,1670,1610,1640,-5
368,06 Feb 2023,INKP,8675,8675,8675,8525,8625,-50
376,06 Feb 2023,INTP,10600,10750,11125,10700,10975,375
477,06 Feb 2023,MAPI,1385,0,1470,1385,1440,55
687,06 Feb 2023,SIDO,785,785,790,780,785,0
801,06 Feb 2023,UNTR,24000,24000,24225,23800,23925,-75
802,06 Feb 2023,UNVR,4690,4690,4730,4660,4730,40
4,07 Feb 2023,ACES,498,500,500,488,490,-8
35,07 Feb 2023,AMRT,2920,2920,2950,2890,2940,20
58,07 Feb 2023,ASII,5850,5825,5925,5825,5875,25
338,07 Feb 2023,HRUM,1640,1685,1700,1660,1690,50
368,07 Feb 2023,INKP,8625,8625,8650,8500,8525,-100
376,07 Feb 2023,INTP,10975,10900,11050,10775,10775,-200
478,07 Feb 2023,MAPI,1440,0,1515,1440,1495,55
688,07 Feb 2023,SIDO,785,785,790,780,790,5
802,07 Feb 2023,UNTR,23925,24425,25375,24300,24900,975
803,07 Feb 2023,UNVR,4730,4730,4890,4720,4860,130
4,08 Feb 2023,ACES,490,492,505,492,496,6
35,08 Feb 2023,AMRT,2940,2950,3000,2940,2950,10
58,08 Feb 2023,ASII,5875,5875,5900,5775,5800,-75
340,08 Feb 2023,HRUM,1690,1700,1705,1665,1695,5
370,08 Feb 2023,INKP,8525,8550,8600,8475,8575,50
378,08 Feb 2023,INTP,10775,10725,11000,10675,10950,175
480,08 Feb 2023,MAPI,1495,0,1520,1465,1480,-15
691,08 Feb 2023,SIDO,790,790,800,785,800,10
805,08 Feb 2023,UNTR,24900,25100,25275,24650,24800,-100
806,08 Feb 2023,UNVR,4860,4860,5025,4810,5025,165
4,09 Feb 2023,ACES,496,498,520,494,510,14
35,09 Feb 2023,AMRT,2950,2980,2980,2940,2950,0
58,09 Feb 2023,ASII,5800,5825,5850,5675,5675,-125
340,09 Feb 2023,HRUM,1695,1670,1690,1665,1675,-20
370,09 Feb 2023,INKP,8575,8575,8625,8550,8550,-25
378,09 Feb 2023,INTP,10950,10950,11125,10825,10975,25
480,09 Feb 2023,MAPI,1480,0,1480,1420,1440,-40
691,09 Feb 2023,SIDO,800,800,805,795,800,0
805,09 Feb 2023,UNTR,24800,24575,24925,24500,24500,-300
806,09 Feb 2023,UNVR,5025,5025,5050,4920,4920,-105
4,10 Feb 2023,ACES,510,515,515,492,505,-5
35,10 Feb 2023,AMRT,2950,2950,2960,2880,2950,0
58,10 Feb 2023,ASII,5675,5600,5700,5550,5700,25
340,10 Feb 2023,HRUM,1675,1660,1660,1575,1650,-25
370,10 Feb 2023,INKP,8550,8550,8600,8400,8600,50
378,10 Feb 2023,INTP,10975,11100,11500,11075,11475,500
480,10 Feb 2023,MAPI,1440,0,1455,1430,1440,0
691,10 Feb 2023,SIDO,800,805,810,790,800,0
805,10 Feb 2023,UNTR,24500,24225,24600,24200,24500,0
806,10 Feb 2023,UNVR,4920,4770,4770,4580,4580,-340
4,13 Feb 2023,ACES,505,505,545,500,545,40
35,13 Feb 2023,AMRT,2950,2950,3030,2940,2970,20
58,13 Feb 2023,ASII,5700,5700,5750,5675,5725,25
340,13 Feb 2023,HRUM,1650,1665,1670,1615,1625,-25
370,13 Feb 2023,INKP,8600,8600,8600,8425,8475,-125
378,13 Feb 2023,INTP,11475,11450,11575,11275,11400,-75
480,13 Feb 2023,MAPI,1440,0,1600,1435,1575,135
691,13 Feb 2023,SIDO,800,800,840,795,830,30
805,13 Feb 2023,UNTR,24500,24800,24875,24450,24625,125
806,13 Feb 2023,UNVR,4580,4580,4580,4490,4520,-60
4,14 Feb 2023,ACES,545,550,565,530,540,-5
35,14 Feb 2023,AMRT,2970,2980,3010,2960,3010,40
58,14 Feb 2023,ASII,5725,5750,5800,5700,5725,0
340,14 Feb 2023,HRUM,1625,1620,1635,1595,1630,5
370,14 Feb 2023,INKP,8475,8475,8475,8225,8250,-225
378,14 Feb 2023,INTP,11400,11425,11850,11425,11700,300
480,14 Feb 2023,MAPI,1575,0,1575,1520,1520,-55
691,14 Feb 2023,SIDO,830,830,875,830,870,40
805,14 Feb 2023,UNTR,24625,24650,24750,24450,24750,125
806,14 Feb 2023,UNVR,4520,4520,4570,4520,4560,40
4,15 Feb 2023,ACES,540,545,550,540,545,5
35,15 Feb 2023,AMRT,3010,3010,3070,2970,3070,60
58,15 Feb 2023,ASII,5725,5725,5725,5575,5675,-50
340,15 Feb 2023,HRUM,1630,1625,1655,1610,1640,10
370,15 Feb 2023,INKP,8250,8275,8300,8075,8175,-75
378,15 Feb 2023,INTP,11700,11700,11700,11275,11525,-175
480,15 Feb 2023,MAPI,1520,0,1565,1505,1520,0
691,15 Feb 2023,SIDO,870,875,880,850,870,0
805,15 Feb 2023,UNTR,24750,24775,25200,24525,24875,125
806,15 Feb 2023,UNVR,4560,4560,4560,4500,4550,-10
4,16 Feb 2023,ACES,545,545,560,540,555,10
35,16 Feb 2023,AMRT,3070,3070,3100,2980,2980,-90
58,16 Feb 2023,ASII,5675,5700,5700,5625,5700,25
340,16 Feb 2023,HRUM,1640,1650,1655,1605,1605,-35
370,16 Feb 2023,INKP,8175,8175,8225,8050,8125,-50
378,16 Feb 2023,INTP,11525,11550,11575,11300,11400,-125
481,16 Feb 2023,MAPI,1520,0,1565,1520,1530,10
692,16 Feb 2023,SIDO,870,870,890,865,890,20
806,16 Feb 2023,UNTR,24875,24900,24975,24550,24650,-225
807,16 Feb 2023,UNVR,4550,4550,4560,4510,4520,-30
4,17 Feb 2023,ACES,555,560,565,530,540,-15
35,17 Feb 2023,AMRT,2980,2980,3020,2910,2980,0
58,17 Feb 2023,ASII,5700,5700,5725,5625,5675,-25
340,17 Feb 2023,HRUM,1605,1605,1615,1565,1605,0
370,17 Feb 2023,INKP,8125,8100,8100,7950,7950,-175
378,17 Feb 2023,INTP,11400,11375,11475,11000,11000,-400
481,17 Feb 2023,MAPI,1530,0,1545,1475,1495,-35
692,17 Feb 2023,SIDO,890,890,890,835,870,-20
806,17 Feb 2023,UNTR,24650,24575,24650,24350,24625,-25
807,17 Feb 2023,UNVR,4520,4520,4530,4480,4510,-10
4,20 Feb 2023,ACES,540,540,550,530,540,0
35,20 Feb 2023,AMRT,2980,2980,3040,2980,3040,60
58,20 Feb 2023,ASII,5675,5675,5700,5575,5600,-75
340,20 Feb 2023,HRUM,1605,1600,1625,1575,1615,10
370,20 Feb 2023,INKP,7950,7900,7975,7850,7925,-25
378,20 Feb 2023,INTP,11000,11100,11325,11000,11100,100
481,20 Feb 2023,MAPI,1495,0,1560,1485,1540,45
692,20 Feb 2023,SIDO,870,865,870,840,860,-10
806,20 Feb 2023,UNTR,24625,24525,24525,24000,24300,-325
807,20 Feb 2023,UNVR,4510,4520,4560,4500,4540,30
4,21 Feb 2023,ACES,540,545,555,540,545,5
35,21 Feb 2023,AMRT,3040,3040,3060,3010,3060,20
58,21 Feb 2023,ASII,5600,5600,5650,5550,5575,-25
340,21 Feb 2023,HRUM,1615,1615,1635,1585,1605,-10
370,21 Feb 2023,INKP,7925,7925,8150,7925,8050,125
378,21 Feb 2023,INTP,11100,11175,11475,11175,11400,300
481,21 Feb 2023,MAPI,1540,0,1575,1540,1550,10
692,21 Feb 2023,SIDO,860,860,865,850,865,5
806,21 Feb 2023,UNTR,24300,24300,24400,24000,24000,-300
807,21 Feb 2023,UNVR,4540,4540,4540,4500,4500,-40
4,22 Feb 2023,ACES,545,540,545,520,525,-20
35,22 Feb 2023,AMRT,3060,3050,3060,3020,3030,-30
58,22 Feb 2023,ASII,5575,5550,5650,5550,5625,50
340,22 Feb 2023,HRUM,1605,1625,1630,1575,1575,-30
370,22 Feb 2023,INKP,8050,8050,8100,7950,8000,-50
378,22 Feb 2023,INTP,11400,11300,11400,11175,11275,-125
481,22 Feb 2023,MAPI,1550,0,1565,1520,1550,0
692,22 Feb 2023,SIDO,865,860,895,855,880,15
806,22 Feb 2023,UNTR,24000,24250,24400,24050,24325,325
807,22 Feb 2023,UNVR,4500,4490,4490,4380,4480,-20
4,23 Feb 2023,ACES,525,530,535,500,510,-15
35,23 Feb 2023,AMRT,3030,3030,3030,2950,2980,-50
58,23 Feb 2023,ASII,5625,5650,5700,5575,5650,25
340,23 Feb 2023,HRUM,1575,1575,1600,1575,1600,25
370,23 Feb 2023,INKP,8000,8000,8050,7875,7950,-50
378,23 Feb 2023,INTP,11275,11275,11350,11125,11200,-75
481,23 Feb 2023,MAPI,1550,0,1635,1550,1590,40
692,23 Feb 2023,SIDO,880,880,880,865,880,0
806,23 Feb 2023,UNTR,24325,24475,24900,24375,24700,375
807,23 Feb 2023,UNVR,4480,4490,4490,4400,4400,-80
4,24 Feb 2023,ACES,510,515,535,510,515,5
35,24 Feb 2023,AMRT,2980,3000,3010,2910,2910,-70
58,24 Feb 2023,ASII,5650,5675,5800,5650,5750,100
340,24 Feb 2023,HRUM,1600,1600,1610,1590,1590,-10
370,24 Feb 2023,INKP,7950,7950,8100,7950,8025,75
378,24 Feb 2023,INTP,11200,11300,11300,11100,11100,-100
481,24 Feb 2023,MAPI,1590,0,1665,1580,1600,10
693,24 Feb 2023,SIDO,880,880,880,865,865,-15
807,24 Feb 2023,UNTR,24700,24900,25200,24800,24950,250
808,24 Feb 2023,UNVR,4400,4400,4440,4350,4350,-50
4,27 Feb 2023,ACES,515,515,525,500,510,-5
35,27 Feb 2023,AMRT,2910,2920,2950,2840,2950,40
58,27 Feb 2023,ASII,5750,5725,5800,5700,5800,50
341,27 Feb 2023,HRUM,1590,1595,1615,1580,1590,0
371,27 Feb 2023,INKP,8025,8075,8075,7975,8025,0
379,27 Feb 2023,INTP,11100,11100,11400,10950,11025,-75
482,27 Feb 2023,MAPI,1600,0,1610,1550,1590,-10
694,27 Feb 2023,SIDO,865,865,875,850,855,-10
808,27 Feb 2023,UNTR,24950,25025,25200,24900,25175,225
809,27 Feb 2023,UNVR,4350,4350,4350,4210,4300,-50
4,28 Feb 2023,ACES,510,510,515,500,505,-5
35,28 Feb 2023,AMRT,2950,2950,2960,2860,2900,-50
58,28 Feb 2023,ASII,5800,6200,6275,6100,6100,300
341,28 Feb 2023,HRUM,1590,1600,1635,1595,1630,40
371,28 Feb 2023,INKP,8025,8000,8000,7900,7925,-100
379,28 Feb 2023,INTP,11025,11075,11175,10875,11125,100
482,28 Feb 2023,MAPI,1590,0,1590,1510,1510,-80
694,28 Feb 2023,SIDO,855,855,880,850,880,25
808,28 Feb 2023,UNTR,25175,29200,30150,27750,27900,2725
809,28 Feb 2023,UNVR,4300,4300,4320,4180,4180,-120
4,01 Mar 2023,ACES,505,505,515,505,505,0
35,01 Mar 2023,AMRT,2900,2900,2930,2860,2890,-10
58,01 Mar 2023,ASII,6100,6100,6175,6050,6150,50
342,01 Mar 2023,HRUM,1630,1630,1660,1615,1655,25
372,01 Mar 2023,INKP,7925,7925,8000,7925,8000,75
380,01 Mar 2023,INTP,11125,11125,11275,11025,11275,150
483,01 Mar 2023,MAPI,1510,0,1610,1515,1550,40
695,01 Mar 2023,SIDO,880,875,890,860,885,5
809,01 Mar 2023,UNTR,27900,28050,28350,27550,27575,-325
810,01 Mar 2023,UNVR,4180,4170,4200,4110,4150,-30
4,02 Mar 2023,ACES,505,505,510,492,494,-11
35,02 Mar 2023,AMRT,2890,2900,2970,2900,2960,70
58,02 Mar 2023,ASII,6150,6150,6175,6075,6150,0
342,02 Mar 2023,HRUM,1655,1665,1690,1650,1670,15
372,02 Mar 2023,INKP,8000,8025,8050,7925,7925,-75
380,02 Mar 2023,INTP,11275,11250,11300,11125,11125,-150
483,02 Mar 2023,MAPI,1550,0,1645,1550,1620,70
695,02 Mar 2023,SIDO,885,880,915,870,910,25
809,02 Mar 2023,UNTR,27575,27700,28450,27650,28325,750
810,02 Mar 2023,UNVR,4150,4160,4220,4150,4150,0
4,03 Mar 2023,ACES,494,494,510,486,496,2
35,03 Mar 2023,AMRT,2960,2960,2980,2770,2770,-190
58,03 Mar 2023,ASII,6150,6150,6150,6025,6050,-100
343,03 Mar 2023,HRUM,1670,1675,1695,1675,1690,20
373,03 Mar 2023,INKP,7925,7950,8000,7850,7850,-75
381,03 Mar 2023,INTP,11125,11275,11600,11175,11425,300
484,03 Mar 2023,MAPI,1620,0,1635,1555,1560,-60
696,03 Mar 2023,SIDO,910,910,915,890,895,-15
810,03 Mar 2023,UNTR,28325,28375,28475,28000,28125,-200
811,03 Mar 2023,UNVR,4150,4150,4170,4050,4060,-90
4,06 Mar 2023,ACES,496,505,510,498,498,2
35,06 Mar 2023,AMRT,2770,2800,2860,2790,2820,50
58,06 Mar 2023,ASII,6050,6100,6125,6050,6075,25
343,06 Mar 2023,HRUM,1690,1690,1695,1650,1660,-30
373,06 Mar 2023,INKP,7850,7875,7925,7800,7825,-25
381,06 Mar 2023,INTP,11425,11475,11600,11275,11300,-125
484,06 Mar 2023,MAPI,1560,0,1595,1555,1570,10
697,06 Mar 2023,SIDO,895,895,900,885,900,5
811,06 Mar 2023,UNTR,28125,28175,28275,27650,27650,-475
812,06 Mar 2023,UNVR,4060,4080,4190,4070,4170,110
4,07 Mar 2023,ACES,498,500,505,494,496,-2
35,07 Mar 2023,AMRT,2820,2820,2840,2810,2810,-10
58,07 Mar 2023,ASII,6075,6050,6075,5900,5950,-125
343,07 Mar 2023,HRUM,1660,1660,1665,1625,1665,5
373,07 Mar 2023,INKP,7825,7825,7850,7650,7725,-100
381,07 Mar 2023,INTP,11300,11250,11400,11125,11250,-50
484,07 Mar 2023,MAPI,1570,0,1610,1555,1600,30
697,07 Mar 2023,SIDO,900,900,910,895,900,0
811,07 Mar 2023,UNTR,27650,27650,27675,26800,26825,-825
812,07 Mar 2023,UNVR,4170,4160,4160,4080,4080,-90
4,08 Mar 2023,ACES,496,494,496,480,486,-10
35,08 Mar 2023,AMRT,2810,2810,2870,2790,2870,60
58,08 Mar 2023,ASII,5950,5900,5975,5875,5925,-25
344,08 Mar 2023,HRUM,1665,1665,1665,1590,1630,-35
374,08 Mar 2023,INKP,7725,7700,7700,7550,7600,-125
382,08 Mar 2023,INTP,11250,11250,11475,11200,11475,225
485,08 Mar 2023,MAPI,1600,0,1615,1565,1570,-30
699,08 Mar 2023,SIDO,900,895,895,880,885,-15
814,08 Mar 2023,UNTR,26825,26725,26875,26200,26400,-425
815,08 Mar 2023,UNVR,4080,4080,4120,4060,4100,20
4,09 Mar 2023,ACES,486,488,505,486,500,14
35,09 Mar 2023,AMRT,2870,2880,2890,2830,2830,-40
58,09 Mar 2023,ASII,5925,5975,6050,5950,6025,100
344,09 Mar 2023,HRUM,1630,1620,1630,1605,1610,-20
374,09 Mar 2023,INKP,7600,7600,7775,7575,7575,-25
382,09 Mar 2023,INTP,11475,11450,11475,11300,11475,0
485,09 Mar 2023,MAPI,1570,0,1575,1495,1520,-50
699,09 Mar 2023,SIDO,885,890,900,880,885,0
814,09 Mar 2023,UNTR,26400,26825,27425,26600,27025,625
815,09 Mar 2023,UNVR,4100,4100,4140,4080,4100,0
4,10 Mar 2023,ACES,500,500,505,492,500,0
35,10 Mar 2023,AMRT,2830,2840,2880,2790,2810,-20
58,10 Mar 2023,ASII,6025,5975,6000,5900,5975,-50
344,10 Mar 2023,HRUM,1610,1615,1645,1605,1635,25
374,10 Mar 2023,INKP,7575,7575,7600,7375,7400,-175
382,10 Mar 2023,INTP,11475,11400,11475,11325,11475,0
485,10 Mar 2023,MAPI,1520,0,1525,1445,1465,-55
700,10 Mar 2023,SIDO,885,885,900,855,900,15
815,10 Mar 2023,UNTR,27025,27000,27150,26600,26825,-200
816,10 Mar 2023,UNVR,4100,4100,4140,4080,4110,10
4,13 Mar 2023,ACES,500,496,505,494,500,0
35,13 Mar 2023,AMRT,2810,2820,2870,2800,2870,60
58,13 Mar 2023,ASII,5975,5900,5975,5850,5925,-50
344,13 Mar 2023,HRUM,1635,1635,1655,1620,1625,-10
374,13 Mar 2023,INKP,7400,7450,7775,7400,7425,25
382,13 Mar 2023,INTP,11475,11475,11475,10900,11025,-450
485,13 Mar 2023,MAPI,1465,0,1540,1425,1540,75
700,13 Mar 2023,SIDO,900,890,890,845,845,-55
815,13 Mar 2023,UNTR,26825,27300,28175,27125,28075,1250
816,13 Mar 2023,UNVR,4110,4090,4180,4080,4160,50
4,14 Mar 2023,ACES,500,498,500,466,468,-32
35,14 Mar 2023,AMRT,2870,2870,2890,2840,2840,-30
58,14 Mar 2023,ASII,5925,5900,5925,5750,5775,-150
344,14 Mar 2023,HRUM,1625,1625,1630,1550,1555,-70
374,14 Mar 2023,INKP,7425,7475,7525,7325,7350,-75
382,14 Mar 2023,INTP,11025,11000,11150,10800,11000,-25
485,14 Mar 2023,MAPI,1540,0,1580,1450,1465,-75
700,14 Mar 2023,SIDO,845,855,875,830,835,-10
815,14 Mar 2023,UNTR,28075,28025,28025,27100,27100,-975
816,14 Mar 2023,UNVR,4160,4140,4240,4130,4210,50
4,15 Mar 2023,ACES,468,472,482,436,456,-12
35,15 Mar 2023,AMRT,2840,2870,2900,2840,2850,10
58,15 Mar 2023,ASII,5775,5850,5875,5775,5775,0
344,15 Mar 2023,HRUM,1555,1560,1580,1500,1530,-25
374,15 Mar 2023,INKP,7350,7400,7500,7175,7175,-175
382,15 Mar 2023,INTP,11000,10900,11000,10250,10250,-750
485,15 Mar 2023,MAPI,1465,0,1570,1470,1545,80
700,15 Mar 2023,SIDO,835,840,855,840,850,15
815,15 Mar 2023,UNTR,27100,27700,27700,27225,27250,150
816,15 Mar 2023,UNVR,4210,4210,4230,4100,4100,-110
4,16 Mar 2023,ACES,456,452,458,436,440,-16
35,16 Mar 2023,AMRT,2850,2870,2900,2790,2800,-50
58,16 Mar 2023,ASII,5775,5775,5875,5675,5850,75
344,16 Mar 2023,HRUM,1530,1525,1565,1425,1425,-105
374,16 Mar 2023,INKP,7175,7150,7150,6775,6825,-350
382,16 Mar 2023,INTP,10250,9900,9975,9550,9750,-500
485,16 Mar 2023,MAPI,1545,0,1600,1495,1600,55
700,16 Mar 2023,SIDO,850,850,850,815,835,-15
815,16 Mar 2023,UNTR,27250,26900,27300,26475,26925,-325
816,16 Mar 2023,UNVR,4100,4100,4120,4040,4070,-30
4,17 Mar 2023,ACES,440,442,454,442,442,2
35,17 Mar 2023,AMRT,2800,2810,2920,2810,2860,60
58,17 Mar 2023,ASII,5850,5875,5925,5850,5850,0
344,17 Mar 2023,HRUM,1425,1430,1465,1430,1465,40
374,17 Mar 2023,INKP,6825,6875,7025,6875,6875,50
382,17 Mar 2023,INTP,9750,9750,10200,9725,10000,250
485,17 Mar 2023,MAPI,1600,0,1635,1565,1600,0
700,17 Mar 2023,SIDO,835,835,845,825,825,-10
815,17 Mar 2023,UNTR,26925,27000,28450,27000,28450,1525
816,17 Mar 2023,UNVR,4070,4070,4170,4070,4160,90
4,20 Mar 2023,ACES,442,442,458,438,450,8
35,20 Mar 2023,AMRT,2860,2870,2900,2810,2850,-10
58,20 Mar 2023,ASII,5850,5850,5900,5800,5875,25
344,20 Mar 2023,HRUM,1465,1465,1470,1430,1440,-25
374,20 Mar 2023,INKP,6875,6925,7125,6925,7125,250
382,20 Mar 2023,INTP,10000,10000,10200,9925,10125,125
485,20 Mar 2023,MAPI,1600,0,1600,1515,1525,-75
700,20 Mar 2023,SIDO,825,825,830,820,820,-5
815,20 Mar 2023,UNTR,28450,28250,28275,27425,27700,-750
816,20 Mar 2023,UNVR,4160,4160,4170,4100,4160,0
4,21 Mar 2023,ACES,450,452,458,444,450,0
35,21 Mar 2023,AMRT,2850,2850,2900,2810,2900,50
58,21 Mar 2023,ASII,5875,5850,5975,5850,5875,0
344,21 Mar 2023,HRUM,1440,1440,1465,1390,1390,-50
374,21 Mar 2023,INKP,7125,7150,7400,7150,7400,275
382,21 Mar 2023,INTP,10125,10150,10275,10025,10075,-50
485,21 Mar 2023,MAPI,1525,0,1545,1480,1495,-30
700,21 Mar 2023,SIDO,820,825,835,820,825,5
815,21 Mar 2023,UNTR,27700,27725,27775,27450,27475,-225
816,21 Mar 2023,UNVR,4160,4160,4200,4150,4200,40
4,24 Mar 2023,ACES,450,454,470,450,468,18
35,24 Mar 2023,AMRT,2900,2920,2990,2860,2930,30
58,24 Mar 2023,ASII,5875,5925,6000,5900,5950,75
344,24 Mar 2023,HRUM,1390,1400,1410,1390,1390,0
374,24 Mar 2023,INKP,7400,7400,7500,7325,7350,-50
382,24 Mar 2023,INTP,10075,10100,10150,9900,10075,0
485,24 Mar 2023,MAPI,1495,0,1560,1495,1515,20
700,24 Mar 2023,SIDO,825,825,865,825,845,20
815,24 Mar 2023,UNTR,27475,27875,28225,27525,27675,200
816,24 Mar 2023,UNVR,4200,4370,4370,4240,4270,70
4,27 Mar 2023,ACES,468,470,478,460,468,0
35,27 Mar 2023,AMRT,2930,2910,2930,2850,2900,-30
58,27 Mar 2023,ASII,5950,5950,5975,5875,5875,-75
344,27 Mar 2023,HRUM,1390,1415,1440,1400,1405,15
374,27 Mar 2023,INKP,7350,7375,7500,7350,7400,50
382,27 Mar 2023,INTP,10075,10075,10075,9800,9950,-125
485,27 Mar 2023,MAPI,1515,0,1530,1495,1500,-15
700,27 Mar 2023,SIDO,845,845,865,845,855,10
815,27 Mar 2023,UNTR,27675,27825,28200,27675,27800,125
816,27 Mar 2023,UNVR,4270,4270,4290,4230,4290,20
4,28 Mar 2023,ACES,468,472,474,462,466,-2
35,28 Mar 2023,AMRT,2900,2920,2990,2900,2980,80
58,28 Mar 2023,ASII,5875,5900,5925,5850,5850,-25
344,28 Mar 2023,HRUM,1405,1410,1470,1410,1460,55
374,28 Mar 2023,INKP,7400,7400,7625,7400,7600,200
382,28 Mar 2023,INTP,9950,10125,10750,10100,10725,775
485,28 Mar 2023,MAPI,1500,0,1620,1500,1600,100
700,28 Mar 2023,SIDO,855,860,875,855,865,10
815,28 Mar 2023,UNTR,27800,27825,28650,27700,28575,775
816,28 Mar 2023,UNVR,4290,4290,4320,4280,4300,10
4,29 Mar 2023,ACES,466,466,472,464,468,2
35,29 Mar 2023,AMRT,2980,2970,2980,2910,2950,-30
58,29 Mar 2023,ASII,5850,5850,6050,5850,5950,100
344,29 Mar 2023,HRUM,1460,1485,1535,1485,1500,40
374,29 Mar 2023,INKP,7600,7600,7675,7475,7625,25
382,29 Mar 2023,INTP,10725,10750,10850,10575,10625,-100
485,29 Mar 2023,MAPI,1600,0,1680,1585,1625,25
700,29 Mar 2023,SIDO,865,865,875,860,860,-5
815,29 Mar 2023,UNTR,28575,28750,29450,28700,29125,550
816,29 Mar 2023,UNVR,4300,4300,4370,4300,4360,60
4,30 Mar 2023,ACES,468,470,486,470,482,14
35,30 Mar 2023,AMRT,2950,2950,2960,2820,2870,-80
58,30 Mar 2023,ASII,5950,5975,5975,5900,5900,-50
345,30 Mar 2023,HRUM,1500,1510,1515,1475,1475,-25
375,30 Mar 2023,INKP,7625,7650,7750,7550,7650,25
383,30 Mar 2023,INTP,10625,10650,10900,10575,10725,100
486,30 Mar 2023,MAPI,1625,0,1650,1515,1540,-85
701,30 Mar 2023,SIDO,860,860,865,840,840,-20
816,30 Mar 2023,UNTR,29125,29000,29425,28975,28975,-150
817,30 Mar 2023,UNVR,4360,4360,4370,4260,4260,-100
4,31 Mar 2023,ACES,482,484,490,474,478,-4
35,31 Mar 2023,AMRT,2870,2880,2960,2870,2880,10
58,31 Mar 2023,ASII,5900,5950,6025,5925,6000,100
345,31 Mar 2023,HRUM,1475,1475,1495,1460,1460,-15
375,31 Mar 2023,INKP,7650,7650,7675,7500,7500,-150
383,31 Mar 2023,INTP,10725,10675,10675,10400,10525,-200
486,31 Mar 2023,MAPI,1540,0,1560,1510,1510,-30
701,31 Mar 2023,SIDO,840,845,870,845,870,30
816,31 Mar 2023,UNTR,28975,29000,29100,28700,29100,125
817,31 Mar 2023,UNVR,4260,4270,4360,4260,4350,90
4,03 Apr 2023,ACES,478,480,490,480,480,2
35,03 Apr 2023,AMRT,2880,2920,2940,2890,2920,40
58,03 Apr 2023,ASII,6000,6050,6100,5975,6000,0
345,03 Apr 2023,HRUM,1460,1485,1520,1475,1485,25
375,03 Apr 2023,INKP,7500,7500,7575,7450,7475,-25
383,03 Apr 2023,INTP,10525,10575,10675,10200,10500,-25
486,03 Apr 2023,MAPI,1510,0,1540,1450,1450,-60
701,03 Apr 2023,SIDO,870,870,875,855,860,-10
816,03 Apr 2023,UNTR,29100,29150,29350,28800,28850,-250
817,03 Apr 2023,UNVR,4350,4350,4350,4250,4290,-60
4,04 Apr 2023,ACES,480,480,486,472,474,-6
35,04 Apr 2023,AMRT,2920,2920,2940,2840,2870,-50
58,04 Apr 2023,ASII,6000,6025,6050,5950,6025,25
345,04 Apr 2023,HRUM,1485,1510,1580,1510,1570,85
375,04 Apr 2023,INKP,7475,7500,7525,7350,7450,-25
383,04 Apr 2023,INTP,10500,10500,10600,10300,10450,-50
486,04 Apr 2023,MAPI,1450,0,1475,1400,1400,-50
701,04 Apr 2023,SIDO,860,860,865,840,845,-15
816,04 Apr 2023,UNTR,28850,29100,29700,29025,29625,775
817,04 Apr 2023,UNVR,4290,4280,4290,4220,4290,0
4,05 Apr 2023,ACES,474,474,480,464,464,-10
35,05 Apr 2023,AMRT,2870,2880,2890,2770,2800,-70
58,05 Apr 2023,ASII,6025,6025,6050,5975,6000,-25
346,05 Apr 2023,HRUM,1570,1565,1570,1540,1550,-20
376,05 Apr 2023,INKP,7450,7425,7425,7225,7275,-175
384,05 Apr 2023,INTP,10450,10500,10525,9725,9725,-725
487,05 Apr 2023,MAPI,1400,0,1450,1385,1385,-15
702,05 Apr 2023,SIDO,845,845,855,835,835,-10
817,05 Apr 2023,UNTR,29625,29475,30125,29325,29800,175
818,05 Apr 2023,UNVR,4290,4290,4320,4250,4250,-40
4,06 Apr 2023,ACES,464,468,470,450,452,-12
35,06 Apr 2023,AMRT,2800,2800,2820,2650,2700,-100
58,06 Apr 2023,ASII,6000,6000,6000,5925,5925,-75
346,06 Apr 2023,HRUM,1550,1555,1595,1540,1585,35
376,06 Apr 2023,INKP,7275,7250,7625,7250,7275,0
384,06 Apr 2023,INTP,9725,9825,9975,9750,9900,175
487,06 Apr 2023,MAPI,1385,0,1430,1340,1415,30
702,06 Apr 2023,SIDO,835,835,845,820,830,-5
816,06 Apr 2023,UNTR,29800,30000,30075,29725,29800,0
817,06 Apr 2023,UNVR,4250,4250,4290,4230,4250,0
4,10 Apr 2023,ACES,452,454,456,440,444,-8
35,10 Apr 2023,AMRT,2700,2700,2830,2700,2810,110
58,10 Apr 2023,ASII,5925,5950,5975,5875,5975,50
346,10 Apr 2023,HRUM,1585,1585,1585,1520,1550,-35
376,10 Apr 2023,INKP,7275,7300,7450,7250,7425,150
384,10 Apr 2023,INTP,9900,9900,9950,9800,9900,0
487,10 Apr 2023,MAPI,1415,0,1440,1360,1365,-50
703,10 Apr 2023,SIDO,830,825,825,800,805,-25
817,10 Apr 2023,UNTR,29800,30000,30200,29800,30200,400
818,10 Apr 2023,UNVR,4250,4250,4290,4230,4290,40
4,11 Apr 2023,ACES,444,444,452,442,444,0
35,11 Apr 2023,AMRT,2810,2820,2830,2760,2810,0
58,11 Apr 2023,ASII,5975,5950,6100,5925,6075,100
346,11 Apr 2023,HRUM,1550,1555,1590,1545,1550,0
376,11 Apr 2023,INKP,7425,7425,7500,7400,7475,50
384,11 Apr 2023,INTP,9900,9900,10325,9825,10325,425
487,11 Apr 2023,MAPI,1365,0,1385,1325,1330,-35
703,11 Apr 2023,SIDO,805,810,840,810,825,20
817,11 Apr 2023,UNTR,30200,30250,30800,30025,30400,200
818,11 Apr 2023,UNVR,4290,4290,4290,4200,4200,-90
4,12 Apr 2023,ACES,444,448,454,446,452,8
35,12 Apr 2023,AMRT,2810,2790,2810,2690,2800,-10
58,12 Apr 2023,ASII,6075,6150,6300,6125,6250,175
346,12 Apr 2023,HRUM,1550,1555,1575,1555,1565,15
376,12 Apr 2023,INKP,7475,7475,7650,7425,7625,150
384,12 Apr 2023,INTP,10325,10325,10600,10200,10400,75
487,12 Apr 2023,MAPI,1330,0,1405,1330,1370,40
704,12 Apr 2023,SIDO,825,830,835,815,815,-10
818,12 Apr 2023,UNTR,30400,30600,31700,30200,31250,850
819,12 Apr 2023,UNVR,4200,4210,4220,4180,4190,-10
4,13 Apr 2023,ACES,452,452,454,444,446,-6
35,13 Apr 2023,AMRT,2800,2770,2770,2710,2740,-60
58,13 Apr 2023,ASII,6250,6225,6275,6175,6250,0
346,13 Apr 2023,HRUM,1565,1585,1585,1535,1575,10
376,13 Apr 2023,INKP,7625,7650,7700,7500,7500,-125
384,13 Apr 2023,INTP,10400,10400,10425,10200,10200,-200
487,13 Apr 2023,MAPI,1370,0,1390,1305,1390,20
704,13 Apr 2023,SIDO,815,815,830,810,815,0
818,13 Apr 2023,UNTR,31250,31400,31500,31050,31050,-200
819,13 Apr 2023,UNVR,4190,4160,4180,4100,4100,-90
4,14 Apr 2023,ACES,446,446,450,444,446,0
35,14 Apr 2023,AMRT,2740,2740,2760,2730,2750,10
58,14 Apr 2023,ASII,6250,6275,6300,6200,6200,-50
346,14 Apr 2023,HRUM,1575,1570,1570,1545,1545,-30
376,14 Apr 2023,INKP,7500,7525,7575,7450,7475,-25
384,14 Apr 2023,INTP,10200,10250,10400,10225,10275,75
487,14 Apr 2023,MAPI,1390,0,1455,1390,1430,40
704,14 Apr 2023,SIDO,815,815,825,810,810,-5
818,14 Apr 2023,UNTR,31050,31000,31150,30225,30225,-825
819,14 Apr 2023,UNVR,4100,4120,4220,4120,4150,50
4,17 Apr 2023,ACES,446,446,452,432,440,-6
35,17 Apr 2023,AMRT,2750,2750,2760,2700,2720,-30
58,17 Apr 2023,ASII,6200,6200,6275,6200,6225,25
346,17 Apr 2023,HRUM,1545,1545,1550,1500,1500,-45
376,17 Apr 2023,INKP,7475,7525,7625,7450,7525,50
384,17 Apr 2023,INTP,10275,10225,10375,10150,10325,50
487,17 Apr 2023,MAPI,1430,0,1475,1420,1465,35
704,17 Apr 2023,SIDO,810,810,820,805,820,10
818,17 Apr 2023,UNTR,30225,30300,31125,30300,30500,275
819,17 Apr 2023,UNVR,4150,4160,4180,4090,4130,-20
4,18 Apr 2023,ACES,440,442,444,438,440,0
35,18 Apr 2023,AMRT,2720,2710,2740,2700,2720,0
58,18 Apr 2023,ASII,6225,6275,6475,6275,6425,200
347,18 Apr 2023,HRUM,1500,1500,1530,1500,1510,10
377,18 Apr 2023,INKP,7525,7525,7550,7450,7500,-25
385,18 Apr 2023,INTP,10325,10325,10450,10325,10350,25
488,18 Apr 2023,MAPI,1465,0,1475,1430,1430,-35
707,18 Apr 2023,SIDO,820,815,815,800,800,-20
821,18 Apr 2023,UNTR,30500,30650,31250,30650,31075,575
822,18 Apr 2023,UNVR,4130,4130,4150,4090,4090,-40
4,26 Apr 2023,ACES,440,440,444,438,442,2
35,26 Apr 2023,AMRT,2720,2790,2910,2740,2910,190
58,26 Apr 2023,ASII,6425,6625,6700,6500,6700,275
347,26 Apr 2023,HRUM,1510,1510,1540,1510,1540,30
377,26 Apr 2023,INKP,7500,7600,7925,7525,7925,425
385,26 Apr 2023,INTP,10350,10250,10450,10000,10450,100
488,26 Apr 2023,MAPI,1430,0,1495,1400,1410,-20
707,26 Apr 2023,SIDO,800,805,820,800,820,20
821,26 Apr 2023,UNTR,31075,31200,31500,31200,31400,325
822,26 Apr 2023,UNVR,4090,4090,4100,3960,4100,10
4,27 Apr 2023,ACES,442,444,448,440,446,4
35,27 Apr 2023,AMRT,2910,2900,2900,2810,2840,-70
58,27 Apr 2023,ASII,6700,6675,6725,6625,6700,0
347,27 Apr 2023,HRUM,1540,1540,1545,1510,1510,-30
377,27 Apr 2023,INKP,7925,7925,7950,7775,7900,-25
385,27 Apr 2023,INTP,10450,10350,10650,10350,10500,50
488,27 Apr 2023,MAPI,1410,0,1410,1365,1370,-40
707,27 Apr 2023,SIDO,820,820,820,800,800,-20
821,27 Apr 2023,UNTR,31400,31400,31400,31000,31075,-325
822,27 Apr 2023,UNVR,4100,4150,4470,4150,4400,300
4,28 Apr 2023,ACES,446,446,454,446,450,4
35,28 Apr 2023,AMRT,2840,2850,2900,2820,2900,60
58,28 Apr 2023,ASII,6700,6700,6750,6675,6750,50
347,28 Apr 2023,HRUM,1510,1520,1530,1510,1510,0
377,28 Apr 2023,INKP,7900,7900,7975,7750,7775,-125
385,28 Apr 2023,INTP,10500,10550,10850,10300,10850,350
488,28 Apr 2023,MAPI,1370,0,1385,1350,1370,0
707,28 Apr 2023,SIDO,800,800,800,780,790,-10
821,28 Apr 2023,UNTR,31075,28900,28900,28900,28900,-2175
822,28 Apr 2023,UNVR,4400,4400,4440,4360,4400,0
4,02 Mei 2023,ACES,450,450,452,442,444,-6
35,02 Mei 2023,AMRT,2900,2900,2920,2840,2910,10
58,02 Mei 2023,ASII,6750,6775,6775,6600,6675,-75
347,02 Mei 2023,HRUM,1510,1515,1515,1455,1460,-50
377,02 Mei 2023,INKP,7775,7775,7800,7550,7650,-125
385,02 Mei 2023,INTP,10850,10500,10500,10100,10100,-750
488,02 Mei 2023,MAPI,1370,0,1490,1390,1410,40
707,02 Mei 2023,SIDO,790,785,800,780,795,5
821,02 Mei 2023,UNTR,28900,26900,26900,26900,26900,-2000
822,02 Mei 2023,UNVR,4400,4400,4410,4280,4400,0
4,03 Mei 2023,ACES,444,444,456,444,450,6
35,03 Mei 2023,AMRT,2910,2910,3000,2860,3000,90
58,03 Mei 2023,ASII,6675,6700,6725,6550,6625,-50
347,03 Mei 2023,HRUM,1460,1460,1480,1425,1445,-15
377,03 Mei 2023,INKP,7650,7450,7450,7125,7150,-500
385,03 Mei 2023,INTP,10100,10100,10100,9825,10000,-100
488,03 Mei 2023,MAPI,1410,0,1460,1365,1455,45
707,03 Mei 2023,SIDO,795,795,810,790,805,10
821,03 Mei 2023,UNTR,26900,25025,25025,25025,25025,-1875
822,03 Mei 2023,UNVR,4400,4400,4420,4350,4400,0
4,04 Mei 2023,ACES,450,450,466,448,464,14
35,04 Mei 2023,AMRT,3000,3000,3030,2960,3020,20
58,04 Mei 2023,ASII,6625,6600,6625,6550,6600,-25
347,04 Mei 2023,HRUM,1445,1440,1470,1425,1470,25
377,04 Mei 2023,INKP,7150,7150,7250,7075,7175,25
385,04 Mei 2023,INTP,10000,10000,10075,9925,10000,0
488,04 Mei 2023,MAPI,1455,0,1485,1435,1460,5
707,04 Mei 2023,SIDO,805,805,815,800,810,5
821,04 Mei 2023,UNTR,25025,24900,24975,24500,24500,-525
822,04 Mei 2023,UNVR,4400,4400,4480,4400,4450,50
4,05 Mei 2023,ACES,464,464,478,464,472,8
35,05 Mei 2023,AMRT,3020,3010,3020,2940,2970,-50
58,05 Mei 2023,ASII,6600,6150,6150,6150,6150,-450
347,05 Mei 2023,HRUM,1470,1455,1465,1370,1380,-90
377,05 Mei 2023,INKP,7175,7175,7250,7075,7100,-75
385,05 Mei 2023,INTP,10000,10000,10000,9850,10000,0
488,05 Mei 2023,MAPI,1460,0,1480,1450,1465,5
707,05 Mei 2023,SIDO,810,810,815,795,800,-10
821,05 Mei 2023,UNTR,24500,24400,24400,23975,24150,-350
822,05 Mei 2023,UNVR,4450,4450,4490,4390,4490,40
4,08 Mei 2023,ACES,472,476,525,476,510,38
35,08 Mei 2023,AMRT,2970,2940,2990,2920,2960,-10
58,08 Mei 2023,ASII,6150,6150,6175,6050,6125,-25
348,08 Mei 2023,HRUM,1380,1375,1430,1375,1420,40
378,08 Mei 2023,INKP,7100,7100,7200,7000,7125,25
386,08 Mei 2023,INTP,10000,10025,10250,9950,10175,175
490,08 Mei 2023,MAPI,1465,0,1540,1455,1500,35
710,08 Mei 2023,SIDO,800,800,810,790,805,5
825,08 Mei 2023,UNTR,24150,24175,25200,24100,25000,850
826,08 Mei 2023,UNVR,4490,4480,4490,4430,4470,-20
4,09 Mei 2023,ACES,510,520,560,515,555,45
35,09 Mei 2023,AMRT,2960,2960,2960,2930,2950,-10
58,09 Mei 2023,ASII,6125,6125,6325,6075,6325,200
348,09 Mei 2023,HRUM,1420,1425,1440,1415,1430,10
378,09 Mei 2023,INKP,7125,7150,7325,7150,7250,125
386,09 Mei 2023,INTP,10175,10175,10450,10125,10350,175
490,09 Mei 2023,MAPI,1500,0,1630,1500,1595,95
711,09 Mei 2023,SIDO,805,805,805,795,800,-5
826,09 Mei 2023,UNTR,25000,25025,25400,25025,25275,275
827,09 Mei 2023,UNVR,4470,4470,4470,4360,4390,-80
4,10 Mei 2023,ACES,555,560,560,535,550,-5
35,10 Mei 2023,AMRT,2950,2940,2970,2880,2920,-30
58,10 Mei 2023,ASII,6325,6350,6425,6300,6325,0
348,10 Mei 2023,HRUM,1430,1430,1445,1410,1410,-20
378,10 Mei 2023,INKP,7250,7300,7375,7275,7375,125
386,10 Mei 2023,INTP,10350,10325,10400,10200,10200,-150
490,10 Mei 2023,MAPI,1595,0,1635,1565,1575,-20
711,10 Mei 2023,SIDO,800,800,805,770,775,-25
826,10 Mei 2023,UNTR,25275,25350,25500,25250,25275,0
827,10 Mei 2023,UNVR,4390,4420,4500,4400,4500,110
4,11 Mei 2023,ACES,550,550,550,525,540,-10
35,11 Mei 2023,AMRT,2920,2940,2940,2860,2880,-40
58,11 Mei 2023,ASII,6325,6350,6350,6175,6250,-75
348,11 Mei 2023,HRUM,1410,1410,1415,1375,1375,-35
378,11 Mei 2023,INKP,7375,7375,7375,7175,7200,-175
386,11 Mei 2023,INTP,10200,10200,10300,10075,10225,25
490,11 Mei 2023,MAPI,1575,0,1700,1550,1670,95
711,11 Mei 2023,SIDO,775,775,775,755,775,0
826,11 Mei 2023,UNTR,25275,25175,25175,24675,24825,-450
827,11 Mei 2023,UNVR,4500,4500,4500,4370,4430,-70
4,12 Mei 2023,ACES,540,540,550,530,535,-5
35,12 Mei 2023,AMRT,2880,2890,3000,2890,2940,60
58,12 Mei 2023,ASII,6250,6225,6275,6175,6225,-25
348,12 Mei 2023,HRUM,1375,1375,1375,1345,1350,-25
378,12 Mei 2023,INKP,7200,7225,7300,7200,7250,50
386,12 Mei 2023,INTP,10225,10225,10400,10100,10200,-25
490,12 Mei 2023,MAPI,1670,0,1710,1665,1665,-5
711,12 Mei 2023,SIDO,775,775,785,765,775,0
827,12 Mei 2023,UNTR,24825,24775,25225,24675,24800,-25
828,12 Mei 2023,UNVR,4430,4430,4430,4370,4400,-30
4,15 Mei 2023,ACES,535,535,565,535,565,30
35,15 Mei 2023,AMRT,2940,2990,3030,2930,2940,0
58,15 Mei 2023,ASII,6225,6275,6350,6175,6350,125
348,15 Mei 2023,HRUM,1350,1355,1365,1290,1295,-55
378,15 Mei 2023,INKP,7250,7250,7325,7175,7250,0
386,15 Mei 2023,INTP,10200,10200,10200,10100,10200,0
490,15 Mei 2023,MAPI,1665,0,1730,1660,1730,65
711,15 Mei 2023,SIDO,775,775,785,765,775,0
827,15 Mei 2023,UNTR,24800,24800,25000,24450,24500,-300
828,15 Mei 2023,UNVR,4400,4450,4530,4400,4500,100
4,16 Mei 2023,ACES,565,570,575,545,570,5
35,16 Mei 2023,AMRT,2940,2950,2970,2910,2940,0
58,16 Mei 2023,ASII,6350,6350,6400,6250,6275,-75
348,16 Mei 2023,HRUM,1295,1300,1305,1230,1250,-45
378,16 Mei 2023,INKP,7250,7250,7375,7250,7350,100
386,16 Mei 2023,INTP,10200,10200,10300,10150,10275,75
490,16 Mei 2023,MAPI,1730,0,1740,1675,1700,-30
711,16 Mei 2023,SIDO,775,775,780,765,770,-5
827,16 Mei 2023,UNTR,24500,24500,24675,24450,24450,-50
828,16 Mei 2023,UNVR,4500,4500,4510,4460,4510,10
4,17 Mei 2023,ACES,570,570,600,560,595,25
35,17 Mei 2023,AMRT,2940,2950,2970,2920,2930,-10
58,17 Mei 2023,ASII,6275,6350,6350,6275,6325,50
348,17 Mei 2023,HRUM,1250,1245,1290,1235,1280,30
378,17 Mei 2023,INKP,7350,7375,7450,7250,7250,-100
386,17 Mei 2023,INTP,10275,10325,10500,10250,10375,100
490,17 Mei 2023,MAPI,1700,0,1775,1695,1705,5
711,17 Mei 2023,SIDO,770,770,775,765,770,0
827,17 Mei 2023,UNTR,24450,24425,24700,24025,24025,-425
828,17 Mei 2023,UNVR,4510,4500,4510,4420,4460,-50
4,19 Mei 2023,ACES,595,595,615,575,585,-10
35,19 Mei 2023,AMRT,2930,2930,2950,2880,2900,-30
58,19 Mei 2023,ASII,6325,6400,6550,6350,6475,150
348,19 Mei 2023,HRUM,1280,1295,1295,1215,1260,-20
378,19 Mei 2023,INKP,7250,7250,7325,7175,7225,-25
386,19 Mei 2023,INTP,10375,10250,10325,10000,10200,-175
490,19 Mei 2023,MAPI,1705,0,1735,1670,1675,-30
711,19 Mei 2023,SIDO,770,770,770,760,765,-5
827,19 Mei 2023,UNTR,24025,24025,24525,23300,23300,-725
828,19 Mei 2023,UNVR,4460,4460,4500,4430,4430,-30
4,22 Mei 2023,ACES,585,585,635,580,630,45
35,22 Mei 2023,AMRT,2900,2900,2940,2820,2880,-20
58,22 Mei 2023,ASII,6475,6525,6650,6425,6600,125
348,22 Mei 2023,HRUM,1260,1260,1285,1255,1285,25
378,22 Mei 2023,INKP,7225,7175,7475,7175,7450,225
386,22 Mei 2023,INTP,10200,10200,10425,10150,10300,100
490,22 Mei 2023,MAPI,1675,0,1705,1625,1655,-20
711,22 Mei 2023,SIDO,765,765,780,760,760,-5
827,22 Mei 2023,UNTR,23300,23525,24275,23525,23875,575
828,22 Mei 2023,UNVR,4430,4430,4480,4390,4420,-10
4,23 Mei 2023,ACES,630,630,645,595,605,-25
35,23 Mei 2023,AMRT,2880,2880,2920,2830,2860,-20
58,23 Mei 2023,ASII,6600,6600,6650,6550,6600,0
348,23 Mei 2023,HRUM,1285,1285,1310,1270,1300,15
378,23 Mei 2023,INKP,7450,7450,7750,7375,7525,75
386,23 Mei 2023,INTP,10300,10275,10275,9925,9975,-325
490,23 Mei 2023,MAPI,1655,0,1790,1655,1770,115
711,23 Mei 2023,SIDO,760,765,775,760,770,10
827,23 Mei 2023,UNTR,23875,24050,24800,24050,24500,625
828,23 Mei 2023,UNVR,4420,4420,4480,4420,4450,30
4,24 Mei 2023,ACES,605,605,625,600,615,10
35,24 Mei 2023,AMRT,2860,2860,2870,2780,2810,-50
58,24 Mei 2023,ASII,6600,6575,6675,6500,6675,75
348,24 Mei 2023,HRUM,1300,1300,1305,1285,1285,-15
378,24 Mei 2023,INKP,7525,7550,7600,7425,7425,-100
386,24 Mei 2023,INTP,9975,9975,10075,9900,10050,75
490,24 Mei 2023,MAPI,1770,0,1790,1705,1760,-10
711,24 Mei 2023,SIDO,770,775,780,770,780,10
827,24 Mei 2023,UNTR,24500,24500,24675,24300,24600,100
828,24 Mei 2023,UNVR,4450,4450,4450,4390,4410,-40
4,25 Mei 2023,ACES,615,620,635,615,635,20
35,25 Mei 2023,AMRT,2810,2810,2810,2720,2720,-90
58,25 Mei 2023,ASII,6675,6700,6700,6525,6600,-75
348,25 Mei 2023,HRUM,1285,1280,1285,1250,1280,-5
378,25 Mei 2023,INKP,7425,7425,7450,7250,7250,-175
386,25 Mei 2023,INTP,10050,10050,10200,10000,10075,25
490,25 Mei 2023,MAPI,1760,0,1865,1750,1830,70
711,25 Mei 2023,SIDO,780,780,780,770,775,-5
827,25 Mei 2023,UNTR,24600,24500,24500,23500,23500,-1100
828,25 Mei 2023,UNVR,4410,4410,4450,4370,4410,0
4,26 Mei 2023,ACES,635,640,655,635,655,20
35,26 Mei 2023,AMRT,2720,2720,2760,2710,2740,20
58,26 Mei 2023,ASII,6600,6600,6600,6525,6600,0
348,26 Mei 2023,HRUM,1280,1280,1295,1260,1260,-20
378,26 Mei 2023,INKP,7250,7200,7325,7200,7275,25
386,26 Mei 2023,INTP,10075,10075,10175,10050,10050,-25
490,26 Mei 2023,MAPI,1830,0,1830,1790,1830,0
711,26 Mei 2023,SIDO,775,775,780,760,765,-10
827,26 Mei 2023,UNTR,23500,23475,23525,23000,23075,-425
828,26 Mei 2023,UNVR,4410,4410,4430,4380,4380,-30
4,29 Mei 2023,ACES,655,660,660,615,630,-25
35,29 Mei 2023,AMRT,2740,2740,2760,2680,2740,0
58,29 Mei 2023,ASII,6600,6625,6625,6475,6600,0
348,29 Mei 2023,HRUM,1260,1265,1315,1205,1305,45
378,29 Mei 2023,INKP,7275,7300,7400,7250,7325,50
386,29 Mei 2023,INTP,10050,9950,10200,9925,10200,150
490,29 Mei 2023,MAPI,1830,0,1830,1770,1825,-5
711,29 Mei 2023,SIDO,765,765,770,755,765,0
827,29 Mei 2023,UNTR,23075,23100,23400,22625,22875,-200
828,29 Mei 2023,UNVR,4380,4400,4550,4380,4550,170
4,30 Mei 2023,ACES,630,635,635,615,620,-10
35,30 Mei 2023,AMRT,2740,2710,2730,2660,2670,-70
58,30 Mei 2023,ASII,6600,6575,6600,6500,6500,-100
348,30 Mei 2023,HRUM,1305,1315,1365,1315,1360,55
378,30 Mei 2023,INKP,7325,7275,7325,7225,7275,-50
386,30 Mei 2023,INTP,10200,10175,10300,10075,10250,50
490,30 Mei 2023,MAPI,1825,0,1845,1805,1805,-20
711,30 Mei 2023,SIDO,765,765,770,760,760,-5
827,30 Mei 2023,UNTR,22875,22800,23000,22500,22500,-375
828,30 Mei 2023,UNVR,4550,4550,4600,4510,4540,-10
4,31 Mei 2023,ACES,620,625,640,600,630,10
35,31 Mei 2023,AMRT,2670,2680,2700,2640,2640,-30
58,31 Mei 2023,ASII,6500,6500,6600,6450,6450,-50
348,31 Mei 2023,HRUM,1360,1365,1410,1340,1410,50
378,31 Mei 2023,INKP,7275,7250,7275,6900,6900,-375
386,31 Mei 2023,INTP,10250,10175,10200,9900,9900,-350
490,31 Mei 2023,MAPI,1805,0,1855,1755,1775,-30
711,31 Mei 2023,SIDO,760,760,765,725,725,-35
827,31 Mei 2023,UNTR,22500,22325,22800,22200,22225,-275
828,31 Mei 2023,UNVR,4540,4540,4580,4500,4530,-10
4,05 Jun 2023,ACES,630,630,635,610,630,0
35,05 Jun 2023,AMRT,2640,2680,2810,2680,2720,80
58,05 Jun 2023,ASII,6450,6525,7000,6500,6825,375
348,05 Jun 2023,HRUM,1410,1420,1440,1375,1440,30
378,05 Jun 2023,INKP,6900,7000,7125,6950,7025,125
386,05 Jun 2023,INTP,9900,9950,9975,9825,9900,0
490,05 Jun 2023,MAPI,1775,0,1790,1730,1770,-5
711,05 Jun 2023,SIDO,725,725,740,710,720,-5
827,05 Jun 2023,UNTR,22225,22525,23475,22525,22850,625
828,05 Jun 2023,UNVR,4530,4530,4550,4460,4500,-30
4,06 Jun 2023,ACES,630,630,645,620,645,15
35,06 Jun 2023,AMRT,2720,2750,2760,2680,2680,-40
58,06 Jun 2023,ASII,6825,6800,6925,6750,6800,-25
348,06 Jun 2023,HRUM,1440,1445,1460,1425,1425,-15
378,06 Jun 2023,INKP,7025,7025,7025,6950,7000,-25
386,06 Jun 2023,INTP,9900,9850,9900,9775,9775,-125
490,06 Jun 2023,MAPI,1770,0,1815,1750,1800,30
711,06 Jun 2023,SIDO,720,720,755,720,750,30
827,06 Jun 2023,UNTR,22850,23225,23350,22875,23200,350
828,06 Jun 2023,UNVR,4500,4500,4510,4440,4460,-40
4,07 Jun 2023,ACES,645,645,705,640,700,55
35,07 Jun 2023,AMRT,2680,2690,2750,2660,2680,0
58,07 Jun 2023,ASII,6800,6800,6850,6675,6800,0
348,07 Jun 2023,HRUM,1425,1420,1425,1375,1385,-40
378,07 Jun 2023,INKP,7000,7050,7100,7000,7100,100
386,07 Jun 2023,INTP,9775,9775,9850,9600,9700,-75
490,07 Jun 2023,MAPI,1800,0,1925,1785,1880,80
711,07 Jun 2023,SIDO,750,755,755,730,735,-15
827,07 Jun 2023,UNTR,23200,23050,23125,22775,22850,-350
828,07 Jun 2023,UNVR,4460,4470,4570,4460,4570,110
4,08 Jun 2023,ACES,700,700,710,665,680,-20
35,08 Jun 2023,AMRT,2680,2660,2750,2660,2740,60
58,08 Jun 2023,ASII,6800,6725,6775,6700,6775,-25
348,08 Jun 2023,HRUM,1385,1400,1495,1400,1480,95
378,08 Jun 2023,INKP,7100,7125,7350,7050,7325,225
386,08 Jun 2023,INTP,9700,9700,9725,9550,9575,-125
490,08 Jun 2023,MAPI,1880,0,1900,1850,1875,-5
711,08 Jun 2023,SIDO,735,740,755,740,755,20
827,08 Jun 2023,UNTR,22850,23150,23325,23000,23325,475
828,08 Jun 2023,UNVR,4570,4570,4630,4540,4600,30
4,09 Jun 2023,ACES,680,680,695,670,685,5
35,09 Jun 2023,AMRT,2740,2740,2750,2680,2700,-40
58,09 Jun 2023,ASII,6775,6750,6800,6700,6800,25
348,09 Jun 2023,HRUM,1480,1500,1500,1440,1455,-25
378,09 Jun 2023,INKP,7325,7325,7475,7275,7400,75
386,09 Jun 2023,INTP,9575,9600,9675,9450,9625,50
490,09 Jun 2023,MAPI,1875,0,1940,1850,1900,25
711,09 Jun 2023,SIDO,755,755,765,740,765,10
827,09 Jun 2023,UNTR,23325,23700,23775,22825,23075,-250
828,09 Jun 2023,UNVR,4600,4580,4600,4540,4550,-50
4,12 Jun 2023,ACES,685,685,705,675,680,-5
35,12 Jun 2023,AMRT,2700,2720,2780,2700,2730,30
58,12 Jun 2023,ASII,6800,6800,6800,6675,6775,-25
348,12 Jun 2023,HRUM,1455,1450,1485,1425,1485,30
378,12 Jun 2023,INKP,7400,7400,7500,7350,7400,0
386,12 Jun 2023,INTP,9625,9625,9825,9625,9800,175
491,12 Jun 2023,MAPI,1900,0,1925,1860,1885,-15
713,12 Jun 2023,SIDO,765,765,770,745,765,0
829,12 Jun 2023,UNTR,23075,23100,23525,23075,23525,450
830,12 Jun 2023,UNVR,4550,4590,4610,4560,4610,60
4,13 Jun 2023,ACES,680,680,685,630,645,-35
35,13 Jun 2023,AMRT,2730,2760,2760,2700,2740,10
58,13 Jun 2023,ASII,6775,6775,6825,6750,6750,-25
348,13 Jun 2023,HRUM,1485,1475,1510,1450,1505,20
378,13 Jun 2023,INKP,7400,7375,7425,7275,7325,-75
386,13 Jun 2023,INTP,9800,9825,9900,9800,9800,0
491,13 Jun 2023,MAPI,1885,0,1885,1820,1850,-35
713,13 Jun 2023,SIDO,765,765,765,750,760,-5
829,13 Jun 2023,UNTR,23525,23600,23600,22925,22975,-550
830,13 Jun 2023,UNVR,4610,4610,4630,4480,4510,-100
4,14 Jun 2023,ACES,645,645,685,635,685,40
35,14 Jun 2023,AMRT,2740,2740,2750,2670,2700,-40
58,14 Jun 2023,ASII,6750,6750,6900,6750,6900,150
348,14 Jun 2023,HRUM,1505,1520,1525,1455,1470,-35
378,14 Jun 2023,INKP,7325,7325,7850,7325,7775,450
386,14 Jun 2023,INTP,9800,9800,9875,9725,9775,-25
491,14 Jun 2023,MAPI,1850,0,1850,1800,1805,-45
713,14 Jun 2023,SIDO,760,755,760,750,760,0
829,14 Jun 2023,UNTR,22975,23100,23225,22975,22975,0
830,14 Jun 2023,UNVR,4510,4500,4510,4410,4440,-70
4,15 Jun 2023,ACES,685,690,700,660,660,-25
35,15 Jun 2023,AMRT,2700,2700,2700,2640,2650,-50
58,15 Jun 2023,ASII,6900,6900,6900,6825,6875,-25
348,15 Jun 2023,HRUM,1470,1470,1485,1450,1460,-10
378,15 Jun 2023,INKP,7775,7775,8100,7700,7850,75
386,15 Jun 2023,INTP,9775,9825,9925,9775,9925,150
491,15 Jun 2023,MAPI,1805,0,1855,1810,1815,10
713,15 Jun 2023,SIDO,760,760,760,745,745,-15
829,15 Jun 2023,UNTR,22975,23150,23225,22925,23150,175
830,15 Jun 2023,UNVR,4440,4440,4520,4410,4520,80
4,16 Jun 2023,ACES,660,665,670,645,650,-10
35,16 Jun 2023,AMRT,2650,2650,2650,2530,2580,-70
58,16 Jun 2023,ASII,6875,6850,6875,6775,6850,-25
348,16 Jun 2023,HRUM,1460,1465,1480,1440,1460,0
378,16 Jun 2023,INKP,7850,7900,8100,7775,7950,100
386,16 Jun 2023,INTP,9925,9900,9900,9750,9750,-175
491,16 Jun 2023,MAPI,1815,0,1830,1765,1800,-15
713,16 Jun 2023,SIDO,745,745,750,725,735,-10
829,16 Jun 2023,UNTR,23150,23325,23550,22900,22900,-250
830,16 Jun 2023,UNVR,4520,4500,4500,4390,4390,-130
4,19 Jun 2023,ACES,650,650,660,630,635,-15
35,19 Jun 2023,AMRT,2580,2580,2630,2580,2600,20
58,19 Jun 2023,ASII,6850,6800,6875,6775,6875,25
348,19 Jun 2023,HRUM,1460,1460,1460,1400,1430,-30
378,19 Jun 2023,INKP,7950,8000,8225,8000,8175,225
386,19 Jun 2023,INTP,9750,9825,9900,9775,9875,125
491,19 Jun 2023,MAPI,1800,0,1805,1750,1750,-50
713,19 Jun 2023,SIDO,735,735,740,720,730,-5
829,19 Jun 2023,UNTR,22900,22950,23150,22725,23150,250
830,19 Jun 2023,UNVR,4390,4390,4420,4320,4380,-10
4,20 Jun 2023,ACES,635,635,645,605,605,-30
35,20 Jun 2023,AMRT,2600,2610,2610,2550,2580,-20
58,20 Jun 2023,ASII,6875,6825,6850,6775,6800,-75
348,20 Jun 2023,HRUM,1430,1430,1445,1395,1410,-20
378,20 Jun 2023,INKP,8175,8175,8200,7950,8000,-175
386,20 Jun 2023,INTP,9875,9875,9875,9750,9775,-100
491,20 Jun 2023,MAPI,1750,0,1750,1655,1695,-55
713,20 Jun 2023,SIDO,730,730,740,725,730,0
829,20 Jun 2023,UNTR,23150,23200,23225,22950,23125,-25
830,20 Jun 2023,UNVR,4380,4380,4390,4300,4300,-80
4,21 Jun 2023,ACES,605,610,700,610,690,85
35,21 Jun 2023,AMRT,2580,2560,2610,2550,2590,10
58,21 Jun 2023,ASII,6800,6775,6975,6750,6925,125
348,21 Jun 2023,HRUM,1410,1415,1435,1400,1400,-10
378,21 Jun 2023,INKP,8000,8050,8150,7950,8000,0
386,21 Jun 2023,INTP,9775,9775,9800,9625,9800,25
491,21 Jun 2023,MAPI,1695,0,1745,1680,1740,45
713,21 Jun 2023,SIDO,730,730,740,720,720,-10
829,21 Jun 2023,UNTR,23125,23175,23375,23000,23350,225
830,21 Jun 2023,UNVR,4300,4300,4370,4300,4360,60
4,22 Jun 2023,ACES,690,690,690,660,670,-20
35,22 Jun 2023,AMRT,2590,2590,2630,2590,2590,0
58,22 Jun 2023,ASII,6925,6875,6900,6775,6775,-150
348,22 Jun 2023,HRUM,1400,1400,1455,1400,1435,35
378,22 Jun 2023,INKP,8000,8000,8100,7925,7925,-75
386,22 Jun 2023,INTP,9800,9775,9850,9750,9775,-25
491,22 Jun 2023,MAPI,1740,0,1765,1685,1685,-55
714,22 Jun 2023,SIDO,720,725,735,720,725,5
830,22 Jun 2023,UNTR,23350,23500,23775,23350,23525,175
831,22 Jun 2023,UNVR,4360,4370,4370,4250,4250,-110
4,23 Jun 2023,ACES,670,670,680,660,670,0
35,23 Jun 2023,AMRT,2590,2600,2620,2560,2610,20
58,23 Jun 2023,ASII,6775,6775,6825,6700,6775,0
348,23 Jun 2023,HRUM,1435,1445,1465,1440,1445,10
378,23 Jun 2023,INKP,7925,7900,8350,7900,8275,350
386,23 Jun 2023,INTP,9775,9750,9950,9750,9800,25
491,23 Jun 2023,MAPI,1685,0,1715,1675,1705,20
714,23 Jun 2023,SIDO,725,725,740,725,735,10
830,23 Jun 2023,UNTR,23525,23525,23675,23150,23375,-150
831,23 Jun 2023,UNVR,4250,4250,4290,4210,4270,20
4,26 Jun 2023,ACES,670,670,690,670,680,10
35,26 Jun 2023,AMRT,2610,2610,2630,2570,2600,-10
58,26 Jun 2023,ASII,6775,6800,6900,6775,6800,25
348,26 Jun 2023,HRUM,1445,1450,1450,1410,1415,-30
378,26 Jun 2023,INKP,8275,8350,8625,8225,8500,225
386,26 Jun 2023,INTP,9800,9850,9875,9750,9750,-50
491,26 Jun 2023,MAPI,1705,0,1730,1690,1690,-15
714,26 Jun 2023,SIDO,735,735,740,725,730,-5
830,26 Jun 2023,UNTR,23375,23400,23425,23075,23275,-100
831,26 Jun 2023,UNVR,4270,4270,4270,4230,4230,-40
4,27 Jun 2023,ACES,680,680,685,670,675,-5
35,27 Jun 2023,AMRT,2600,2600,2620,2550,2580,-20
58,27 Jun 2023,ASII,6800,6800,6850,6775,6775,-25
348,27 Jun 2023,HRUM,1415,1415,1430,1410,1420,5
378,27 Jun 2023,INKP,8500,8600,8775,8450,8500,0
386,27 Jun 2023,INTP,9750,9800,9925,9725,9925,175
491,27 Jun 2023,MAPI,1690,0,1700,1640,1690,0
714,27 Jun 2023,SIDO,730,730,745,730,730,0
830,27 Jun 2023,UNTR,23275,23275,23325,23125,23275,0
831,27 Jun 2023,UNVR,4230,4230,4280,4230,4260,30
4,03 Jul 2023,ACES,675,675,690,670,670,-5
35,03 Jul 2023,AMRT,2580,2600,2630,2550,2590,10
58,03 Jul 2023,ASII,6775,6775,6825,6750,6825,50
348,03 Jul 2023,HRUM,1420,1425,1505,1425,1495,75
378,03 Jul 2023,INKP,8500,8475,8625,8375,8400,-100
386,03 Jul 2023,INTP,9925,9925,9925,9650,9675,-250
491,03 Jul 2023,MAPI,1690,0,1705,1660,1675,-15
714,03 Jul 2023,SIDO,730,730,740,720,725,-5
830,03 Jul 2023,UNTR,23275,23325,23375,22825,23050,-225
831,03 Jul 2023,UNVR,4260,4250,4310,4210,4310,50
4,04 Jul 2023,ACES,670,670,685,640,655,-15
35,04 Jul 2023,AMRT,2590,2590,2650,2570,2600,10
58,04 Jul 2023,ASII,6825,6825,6825,6700,6775,-50
348,04 Jul 2023,HRUM,1495,1500,1580,1500,1580,85
378,04 Jul 2023,INKP,8400,8400,8550,8375,8475,75
386,04 Jul 2023,INTP,9675,9700,9700,9550,9600,-75
491,04 Jul 2023,MAPI,1675,0,1740,1675,1715,40
714,04 Jul 2023,SIDO,725,725,730,720,725,0
830,04 Jul 2023,UNTR,23050,23150,23250,23050,23100,50
831,04 Jul 2023,UNVR,4310,4320,4340,4300,4330,20
4,05 Jul 2023,ACES,655,635,650,625,640,-15
35,05 Jul 2023,AMRT,2600,2600,2620,2580,2620,20
58,05 Jul 2023,ASII,6775,6775,6775,6700,6775,0
348,05 Jul 2023,HRUM,1580,1590,1635,1580,1590,10
378,05 Jul 2023,INKP,8475,8475,8750,8400,8725,250
386,05 Jul 2023,INTP,9600,9600,9775,9550,9725,125
491,05 Jul 2023,MAPI,1715,0,1720,1680,1700,-15
714,05 Jul 2023,SIDO,725,725,730,720,720,-5
830,05 Jul 2023,UNTR,23100,23200,23775,23150,23700,600
831,05 Jul 2023,UNVR,4330,4330,4330,4280,4310,-20
4,06 Jul 2023,ACES,640,645,665,635,655,15
35,06 Jul 2023,AMRT,2620,2630,2750,2590,2740,120
58,06 Jul 2023,ASII,6775,6775,6800,6750,6800,25
348,06 Jul 2023,HRUM,1590,1600,1645,1600,1620,30
378,06 Jul 2023,INKP,8725,8725,8850,8625,8775,50
386,06 Jul 2023,INTP,9725,9750,9950,9750,9900,175
491,06 Jul 2023,MAPI,1700,0,1815,1695,1810,110
714,06 Jul 2023,SIDO,720,725,735,720,730,10
830,06 Jul 2023,UNTR,23700,23950,24075,23825,24050,350
831,06 Jul 2023,UNVR,4310,4260,4290,4220,4250,-60
4,07 Jul 2023,ACES,655,655,745,640,720,65
36,07 Jul 2023,AMRT,2740,2740,2740,2680,2680,-60
59,07 Jul 2023,ASII,6800,6775,6825,6750,6825,25
349,07 Jul 2023,HRUM,1620,1610,1610,1575,1585,-35
379,07 Jul 2023,INKP,8775,8700,8950,8650,8850,75
387,07 Jul 2023,INTP,9900,9900,10175,9875,10125,225
492,07 Jul 2023,MAPI,1810,0,1825,1740,1760,-50
715,07 Jul 2023,SIDO,730,730,735,725,730,0
831,07 Jul 2023,UNTR,24050,23900,24000,23600,23750,-300
832,07 Jul 2023,UNVR,4250,4230,4240,4210,4240,-10
4,10 Jul 2023,ACES,720,725,735,705,710,-10
36,10 Jul 2023,AMRT,2680,2680,2730,2680,2710,30
59,10 Jul 2023,ASII,6825,6825,6825,6775,6775,-50
351,10 Jul 2023,HRUM,1585,1585,1635,1585,1605,20
381,10 Jul 2023,INKP,8850,8850,9000,8725,8975,125
389,10 Jul 2023,INTP,10125,10125,10225,10050,10100,-25
494,10 Jul 2023,MAPI,1760,0,1780,1745,1750,-10
717,10 Jul 2023,SIDO,730,730,735,730,730,0
834,10 Jul 2023,UNTR,23750,23900,24150,23875,24100,350
835,10 Jul 2023,UNVR,4240,4240,4320,4240,4250,10
4,11 Jul 2023,ACES,710,710,725,705,710,0
36,11 Jul 2023,AMRT,2710,2710,2780,2700,2770,60
59,11 Jul 2023,ASII,6775,6775,6800,6750,6800,25
351,11 Jul 2023,HRUM,1605,1615,1620,1585,1610,5
381,11 Jul 2023,INKP,8975,8975,9475,8975,9475,500
389,11 Jul 2023,INTP,10100,10125,10275,10050,10275,175
494,11 Jul 2023,MAPI,1750,0,1805,1710,1805,55
717,11 Jul 2023,SIDO,730,735,755,730,745,15
834,11 Jul 2023,UNTR,24100,24100,24475,24075,24475,375
835,11 Jul 2023,UNVR,4250,4260,4280,4240,4250,0
4,12 Jul 2023,ACES,710,715,735,715,725,15
36,12 Jul 2023,AMRT,2770,2770,2800,2720,2780,10
59,12 Jul 2023,ASII,6800,6775,6825,6750,6775,-25
351,12 Jul 2023,HRUM,1610,1610,1610,1580,1595,-15
381,12 Jul 2023,INKP,9475,9475,9650,9250,9400,-75
389,12 Jul 2023,INTP,10275,10275,10350,10150,10150,-125
494,12 Jul 2023,MAPI,1805,0,1900,1785,1860,55
717,12 Jul 2023,SIDO,745,745,755,740,745,0
834,12 Jul 2023,UNTR,24475,24475,24475,24000,24000,-475
835,12 Jul 2023,UNVR,4250,4250,4260,4200,4210,-40
4,13 Jul 2023,ACES,725,730,730,700,715,-10
36,13 Jul 2023,AMRT,2780,2780,2810,2730,2780,0
59,13 Jul 2023,ASII,6775,6775,6825,6750,6800,25
351,13 Jul 2023,HRUM,1595,1595,1610,1515,1525,-70
381,13 Jul 2023,INKP,9400,9300,9450,9000,9150,-250
389,13 Jul 2023,INTP,10150,10150,10325,10150,10250,100
494,13 Jul 2023,MAPI,1860,0,1880,1780,1785,-75
717,13 Jul 2023,SIDO,745,745,750,720,725,-20
834,13 Jul 2023,UNTR,24000,24000,24225,23975,24150,150
835,13 Jul 2023,UNVR,4210,4220,4250,4210,4250,40
4,14 Jul 2023,ACES,715,715,730,710,720,5
36,14 Jul 2023,AMRT,2780,2780,2790,2730,2770,-10
59,14 Jul 2023,ASII,6800,6775,6825,6700,6750,-50
351,14 Jul 2023,HRUM,1525,1530,1555,1515,1525,0
381,14 Jul 2023,INKP,9150,9150,9200,8875,8950,-200
389,14 Jul 2023,INTP,10250,10375,10450,10250,10350,100
494,14 Jul 2023,MAPI,1785,0,1820,1785,1800,15
717,14 Jul 2023,SIDO,725,725,730,715,720,-5
834,14 Jul 2023,UNTR,24150,24200,24275,24050,24150,0
835,14 Jul 2023,UNVR,4250,4250,4290,4230,4250,0
4,17 Jul 2023,ACES,720,720,765,720,755,35
36,17 Jul 2023,AMRT,2770,2770,2800,2760,2770,0
59,17 Jul 2023,ASII,6750,6750,6775,6675,6675,-75
351,17 Jul 2023,HRUM,1525,1530,1555,1525,1530,5
381,17 Jul 2023,INKP,8950,8975,9100,8700,8800,-150
389,17 Jul 2023,INTP,10350,10350,10450,10225,10275,-75
494,17 Jul 2023,MAPI,1800,0,1855,1800,1835,35
717,17 Jul 2023,SIDO,720,725,735,720,720,0
834,17 Jul 2023,UNTR,24150,24300,24400,24200,24225,75
835,17 Jul 2023,UNVR,4250,4260,4290,4250,4270,20
4,18 Jul 2023,ACES,755,760,780,735,750,-5
36,18 Jul 2023,AMRT,2770,2770,2770,2730,2750,-20
59,18 Jul 2023,ASII,6675,6675,6700,6475,6575,-100
351,18 Jul 2023,HRUM,1530,1530,1530,1485,1490,-40
381,18 Jul 2023,INKP,8800,8800,8975,8675,8725,-75
389,18 Jul 2023,INTP,10275,10275,10325,10100,10275,0
494,18 Jul 2023,MAPI,1835,0,1930,1835,1900,65
717,18 Jul 2023,SIDO,720,725,730,710,715,-5
834,18 Jul 2023,UNTR,24225,24250,24450,24050,24250,25
835,18 Jul 2023,UNVR,4270,4270,4300,4230,4270,0
4,20 Jul 2023,ACES,750,750,795,695,695,-55
36,20 Jul 2023,AMRT,2750,2770,2820,2750,2800,50
59,20 Jul 2023,ASII,6575,6575,6575,6450,6525,-50
351,20 Jul 2023,HRUM,1490,1500,1540,1500,1540,50
381,20 Jul 2023,INKP,8725,8800,9075,8750,8925,200
389,20 Jul 2023,INTP,10275,10300,10300,10075,10175,-100
494,20 Jul 2023,MAPI,1900,0,1995,1895,1985,85
717,20 Jul 2023,SIDO,715,715,720,685,690,-25
834,20 Jul 2023,UNTR,24250,24575,24575,24225,24375,125
835,20 Jul 2023,UNVR,4270,4260,4270,4210,4220,-50
4,21 Jul 2023,ACES,695,695,715,690,705,10
36,21 Jul 2023,AMRT,2800,2810,2880,2800,2870,70
59,21 Jul 2023,ASII,6525,6500,6525,6375,6450,-75
351,21 Jul 2023,HRUM,1540,1550,1565,1540,1545,5
381,21 Jul 2023,INKP,8925,8925,9000,8725,9000,75
389,21 Jul 2023,INTP,10175,10200,10375,10050,10350,175
494,21 Jul 2023,MAPI,1985,0,2050,1925,1930,-55
717,21 Jul 2023,SIDO,690,690,700,690,700,10
834,21 Jul 2023,UNTR,24375,24400,24500,24275,24500,125
835,21 Jul 2023,UNVR,4220,4220,4290,4220,4290,70
4,24 Jul 2023,ACES,705,710,745,710,735,30
36,24 Jul 2023,AMRT,2870,2870,2890,2810,2840,-30
59,24 Jul 2023,ASII,6450,6400,6600,6400,6550,100
351,24 Jul 2023,HRUM,1545,1545,1565,1540,1555,10
382,24 Jul 2023,INKP,9000,9050,9100,8950,8950,-50
390,24 Jul 2023,INTP,10350,10375,10425,10250,10350,0
495,24 Jul 2023,MAPI,1930,0,1965,1850,1915,-15
718,24 Jul 2023,SIDO,700,700,700,695,700,0
835,24 Jul 2023,UNTR,24500,24525,25600,24525,25400,900
836,24 Jul 2023,UNVR,4290,4290,4340,4270,4290,0
4,25 Jul 2023,ACES,735,745,780,730,750,15
36,25 Jul 2023,AMRT,2840,2840,2890,2810,2810,-30
59,25 Jul 2023,ASII,6550,6600,6625,6500,6500,-50
351,25 Jul 2023,HRUM,1555,1565,1575,1540,1555,0
382,25 Jul 2023,INKP,8950,8950,9000,8900,8950,0
390,25 Jul 2023,INTP,10350,10300,10550,10275,10450,100
496,25 Jul 2023,MAPI,1915,0,1940,1890,1910,-5
719,25 Jul 2023,SIDO,700,700,700,690,695,-5
836,25 Jul 2023,UNTR,25400,25500,25800,25400,25400,0
837,25 Jul 2023,UNVR,4290,4190,4190,4020,4050,-240
4,26 Jul 2023,ACES,750,755,765,735,740,-10
36,26 Jul 2023,AMRT,2810,2810,2830,2760,2830,20
59,26 Jul 2023,ASII,6500,6575,6625,6500,6600,100
351,26 Jul 2023,HRUM,1555,1575,1710,1575,1705,150
382,26 Jul 2023,INKP,8950,8950,8950,8800,8850,-100
390,26 Jul 2023,INTP,10450,10500,10500,10325,10325,-125
496,26 Jul 2023,MAPI,1910,0,1970,1920,1925,15
719,26 Jul 2023,SIDO,695,695,700,680,685,-10
836,26 Jul 2023,UNTR,25400,25525,26575,25525,26400,1000
837,26 Jul 2023,UNVR,4050,4050,4070,3950,3970,-80
4,27 Jul 2023,ACES,740,745,755,735,755,15
36,27 Jul 2023,AMRT,2830,2790,2820,2690,2750,-80
59,27 Jul 2023,ASII,6600,6600,6600,6500,6525,-75
351,27 Jul 2023,HRUM,1705,1705,1705,1650,1655,-50
382,27 Jul 2023,INKP,8850,8850,9050,8825,8925,75
390,27 Jul 2023,INTP,10325,10350,10375,10175,10200,-125
496,27 Jul 2023,MAPI,1925,0,2020,1920,2000,75
719,27 Jul 2023,SIDO,685,685,685,650,650,-35
836,27 Jul 2023,UNTR,26400,26425,26750,26100,26375,-25
837,27 Jul 2023,UNVR,3970,3970,4000,3840,3840,-130
4,28 Jul 2023,ACES,755,760,765,735,735,-20
36,28 Jul 2023,AMRT,2750,2740,2750,2640,2730,-20
59,28 Jul 2023,ASII,6525,6500,6625,6475,6625,100
351,28 Jul 2023,HRUM,1655,1655,1670,1610,1670,15
382,28 Jul 2023,INKP,8925,8925,8975,8850,8875,-50
390,28 Jul 2023,INTP,10200,10200,10400,10200,10400,200
496,28 Jul 2023,MAPI,2000,0,2030,1970,2020,20
719,28 Jul 2023,SIDO,650,650,650,635,640,-10
836,28 Jul 2023,UNTR,26375,26400,26650,26025,26650,275
837,28 Jul 2023,UNVR,3840,3850,3900,3810,3870,30
4,31 Jul 2023,ACES,735,735,745,715,720,-15
36,31 Jul 2023,AMRT,2730,2730,2740,2650,2700,-30
59,31 Jul 2023,ASII,6625,6750,6950,6725,6850,225
351,31 Jul 2023,HRUM,1670,1675,1695,1640,1660,-10
382,31 Jul 2023,INKP,8875,8900,9250,8825,9150,275
390,31 Jul 2023,INTP,10400,10400,10525,10275,10425,25
496,31 Jul 2023,MAPI,2020,0,2050,1975,1980,-40
720,31 Jul 2023,SIDO,640,640,660,635,640,0
837,31 Jul 2023,UNTR,26650,27450,27650,27075,27525,875
838,31 Jul 2023,UNVR,3870,3870,3890,3830,3850,-20
4,01 Agt 2023,ACES,720,715,730,675,675,-45
36,01 Agt 2023,AMRT,2700,2750,2860,2730,2860,160
59,01 Agt 2023,ASII,6850,6875,6900,6800,6875,25
351,01 Agt 2023,HRUM,1660,1660,1690,1640,1685,25
382,01 Agt 2023,INKP,9150,9100,9350,9000,9300,150
390,01 Agt 2023,INTP,10425,10500,10525,10275,10425,0
496,01 Agt 2023,MAPI,1980,1990,2030,1960,2030,50
720,01 Agt 2023,SIDO,640,640,655,640,640,0
837,01 Agt 2023,UNTR,27525,27625,27700,27150,27525,0
838,01 Agt 2023,UNVR,3850,3830,3850,3770,3770,-80
4,02 Agt 2023,ACES,675,675,700,655,665,-10
36,02 Agt 2023,AMRT,2860,2830,2900,2810,2880,20
59,02 Agt 2023,ASII,6875,6825,6850,6775,6850,-25
352,02 Agt 2023,HRUM,1685,1685,1690,1625,1630,-55
383,02 Agt 2023,INKP,9300,9200,9350,9050,9075,-225
391,02 Agt 2023,INTP,10425,10425,10575,10275,10575,150
497,02 Agt 2023,MAPI,2030,2030,2030,1970,1980,-50
721,02 Agt 2023,SIDO,640,640,645,610,615,-25
838,02 Agt 2023,UNTR,27525,27500,27500,26500,26725,-800
839,02 Agt 2023,UNVR,3770,3770,3800,3680,3690,-80
4,03 Agt 2023,ACES,665,670,695,670,690,25
36,03 Agt 2023,AMRT,2880,2900,2940,2840,2880,0
59,03 Agt 2023,ASII,6850,6800,6900,6775,6825,-25
352,03 Agt 2023,HRUM,1630,1630,1655,1620,1640,10
383,03 Agt 2023,INKP,9075,9075,9400,9075,9400,325
391,03 Agt 2023,INTP,10575,10600,11500,10575,11100,525
497,03 Agt 2023,MAPI,1980,2010,2010,1925,1930,-50
721,03 Agt 2023,SIDO,615,615,650,615,640,25
838,03 Agt 2023,UNTR,26725,26725,27375,26725,27150,425
839,03 Agt 2023,UNVR,3690,3690,3830,3670,3770,80
4,04 Agt 2023,ACES,690,695,700,680,680,-10
36,04 Agt 2023,AMRT,2880,2870,2870,2770,2820,-60
59,04 Agt 2023,ASII,6825,6825,6850,6750,6800,-25
352,04 Agt 2023,HRUM,1640,1640,1665,1600,1605,-35
383,04 Agt 2023,INKP,9400,9400,9400,9250,9275,-125
391,04 Agt 2023,INTP,11100,11125,11275,11075,11100,0
497,04 Agt 2023,MAPI,1930,1935,1975,1925,1945,15
721,04 Agt 2023,SIDO,640,640,655,635,640,0
838,04 Agt 2023,UNTR,27150,27250,27725,27250,27325,175
839,04 Agt 2023,UNVR,3770,3780,3810,3730,3740,-30
4,07 Agt 2023,ACES,680,690,735,690,730,50
36,07 Agt 2023,AMRT,2820,2890,2890,2770,2780,-40
59,07 Agt 2023,ASII,6800,6825,6900,6750,6875,75
354,07 Agt 2023,HRUM,1605,1605,1650,1605,1630,25
385,07 Agt 2023,INKP,9275,9275,9750,9275,9625,350
393,07 Agt 2023,INTP,11100,11100,11225,10825,10825,-275
499,07 Agt 2023,MAPI,1945,1950,1970,1930,1935,-10
723,07 Agt 2023,SIDO,640,645,655,640,650,10
840,07 Agt 2023,UNTR,27325,27525,27675,27300,27425,100
841,07 Agt 2023,UNVR,3740,3740,3770,3720,3720,-20
4,08 Agt 2023,ACES,730,730,740,715,720,-10
36,08 Agt 2023,AMRT,2780,2760,2830,2760,2780,0
59,08 Agt 2023,ASII,6875,6850,6900,6825,6850,-25
357,08 Agt 2023,HRUM,1630,1645,1660,1630,1640,10
388,08 Agt 2023,INKP,9625,9625,9725,9550,9550,-75
396,08 Agt 2023,INTP,10825,10800,11100,10625,10725,-100
502,08 Agt 2023,MAPI,1935,1935,1955,1920,1935,0
727,08 Agt 2023,SIDO,650,650,660,650,655,5
844,08 Agt 2023,UNTR,27425,27525,27700,27500,27525,100
845,08 Agt 2023,UNVR,3720,3730,3790,3730,3750,30
4,09 Agt 2023,ACES,720,720,725,705,715,-5
36,09 Agt 2023,AMRT,2780,2790,2870,2770,2850,70
59,09 Agt 2023,ASII,6850,6850,6875,6825,6875,25
357,09 Agt 2023,HRUM,1640,1650,1650,1620,1620,-20
389,09 Agt 2023,INKP,9550,9550,9750,9550,9750,200
397,09 Agt 2023,INTP,10725,10950,11050,10750,10975,250
504,09 Agt 2023,MAPI,1935,1945,1970,1930,1945,10
730,09 Agt 2023,SIDO,655,655,655,640,640,-15
847,09 Agt 2023,UNTR,27525,27575,27850,27575,27750,225
848,09 Agt 2023,UNVR,3750,3750,3770,3720,3720,-30
4,10 Agt 2023,ACES,715,715,720,690,700,-15
36,10 Agt 2023,AMRT,2850,2850,2860,2780,2780,-70
59,10 Agt 2023,ASII,6875,6850,6875,6750,6750,-125
357,10 Agt 2023,HRUM,1620,1625,1645,1610,1635,15
389,10 Agt 2023,INKP,9750,9800,9875,9725,9800,50
397,10 Agt 2023,INTP,10975,10900,11025,10850,11000,25
504,10 Agt 2023,MAPI,1945,1945,1990,1930,1970,25
731,10 Agt 2023,SIDO,640,640,650,640,640,0
848,10 Agt 2023,UNTR,27750,27850,27975,27600,27600,-150
849,10 Agt 2023,UNVR,3720,3720,3730,3680,3680,-40
4,11 Agt 2023,ACES,700,700,700,685,700,0
36,11 Agt 2023,AMRT,2780,2800,2870,2780,2830,50
59,11 Agt 2023,ASII,6750,6750,6775,6650,6750,0
357,11 Agt 2023,HRUM,1635,1635,1645,1605,1610,-25
389,11 Agt 2023,INKP,9800,9825,9825,9600,9700,-100
397,11 Agt 2023,INTP,11000,10900,11150,10900,11025,25
504,11 Agt 2023,MAPI,1970,1970,2030,1970,2030,60
731,11 Agt 2023,SIDO,640,640,650,640,640,0
848,11 Agt 2023,UNTR,27600,27600,27625,26800,27100,-500
849,11 Agt 2023,UNVR,3680,3680,3720,3680,3700,20
4,14 Agt 2023,ACES,700,700,700,690,690,-10
36,14 Agt 2023,AMRT,2830,2850,2910,2820,2890,60
59,14 Agt 2023,ASII,6750,6700,6800,6700,6800,50
357,14 Agt 2023,HRUM,1610,1610,1620,1565,1570,-40
389,14 Agt 2023,INKP,9700,9750,10000,9750,9950,250
397,14 Agt 2023,INTP,11025,11050,11275,10900,11275,250
504,14 Agt 2023,MAPI,2030,2030,2070,2000,2020,-10
731,14 Agt 2023,SIDO,640,640,650,640,645,5
848,14 Agt 2023,UNTR,27100,27200,27450,26850,27450,350
849,14 Agt 2023,UNVR,3700,3700,3730,3630,3730,30
4,15 Agt 2023,ACES,690,695,730,690,720,30
36,15 Agt 2023,AMRT,2890,2890,2940,2890,2910,20
59,15 Agt 2023,ASII,6800,6725,6775,6675,6725,-75
357,15 Agt 2023,HRUM,1570,1570,1590,1550,1580,10
389,15 Agt 2023,INKP,9950,9925,10125,9900,10075,125
397,15 Agt 2023,INTP,11275,11275,11325,11125,11225,-50
504,15 Agt 2023,MAPI,2020,2020,2020,1985,1995,-25
731,15 Agt 2023,SIDO,645,645,655,640,645,0
848,15 Agt 2023,UNTR,27450,27500,27500,27150,27375,-75
849,15 Agt 2023,UNVR,3730,3750,3750,3690,3730,0
4,16 Agt 2023,ACES,720,720,730,710,715,-5
36,16 Agt 2023,AMRT,2910,2910,3030,2910,2940,30
59,16 Agt 2023,ASII,6725,6675,6750,6650,6750,25
357,16 Agt 2023,HRUM,1580,1580,1590,1575,1585,5
389,16 Agt 2023,INKP,10075,10025,10025,9625,9750,-325
397,16 Agt 2023,INTP,11225,11200,11250,11000,11250,25
504,16 Agt 2023,MAPI,1995,1995,1995,1925,1940,-55
731,16 Agt 2023,SIDO,645,645,650,640,640,-5
848,16 Agt 2023,UNTR,27375,27375,27500,27175,27500,125
849,16 Agt 2023,UNVR,3730,3730,3730,3680,3730,0
4,18 Agt 2023,ACES,715,715,730,710,710,-5
36,18 Agt 2023,AMRT,2940,2980,3010,2880,2900,-40
59,18 Agt 2023,ASII,6750,6675,6700,6500,6525,-225
357,18 Agt 2023,HRUM,1585,1580,1585,1560,1560,-25
389,18 Agt 2023,INKP,9750,9725,9725,9250,9375,-375
397,18 Agt 2023,INTP,11250,11225,11225,11000,11200,-50
504,18 Agt 2023,MAPI,1940,1945,1975,1875,1910,-30
731,18 Agt 2023,SIDO,640,640,655,640,650,10
848,18 Agt 2023,UNTR,27500,27325,27375,26800,26800,-700
849,18 Agt 2023,UNVR,3730,3680,3720,3680,3690,-40
4,21 Agt 2023,ACES,710,710,745,710,730,20
36,21 Agt 2023,AMRT,2900,2920,3020,2920,2990,90
59,21 Agt 2023,ASII,6525,6525,6550,6425,6475,-50
357,21 Agt 2023,HRUM,1560,1565,1615,1565,1580,20
389,21 Agt 2023,INKP,9375,9375,9425,9000,9075,-300
397,21 Agt 2023,INTP,11200,11150,11150,10975,11000,-200
504,21 Agt 2023,MAPI,1910,1910,1910,1860,1885,-25
731,21 Agt 2023,SIDO,650,650,655,645,645,-5
848,21 Agt 2023,UNTR,26800,26800,27300,26800,27075,275
849,21 Agt 2023,UNVR,3690,3700,3730,3690,3710,20
4,22 Agt 2023,ACES,730,750,765,735,750,20
36,22 Agt 2023,AMRT,2990,2940,2980,2910,2910,-80
59,22 Agt 2023,ASII,6475,6450,6600,6450,6550,75
357,22 Agt 2023,HRUM,1580,1585,1655,1585,1640,60
389,22 Agt 2023,INKP,9075,9125,9500,9125,9450,375
397,22 Agt 2023,INTP,11000,11000,11075,11000,11025,25
504,22 Agt 2023,MAPI,1885,1895,1975,1895,1970,85
731,22 Agt 2023,SIDO,645,645,655,645,650,5
848,22 Agt 2023,UNTR,27075,27225,27650,27150,27600,525
849,22 Agt 2023,UNVR,3710,3710,3720,3700,3710,0
4,23 Agt 2023,ACES,750,750,760,730,755,5
36,23 Agt 2023,AMRT,2910,2910,3000,2910,2930,20
59,23 Agt 2023,ASII,6550,6550,6600,6525,6550,0
357,23 Agt 2023,HRUM,1640,1650,1665,1635,1635,-5
389,23 Agt 2023,INKP,9450,9450,9650,9325,9325,-125
397,23 Agt 2023,INTP,11025,11000,11125,11000,11075,50
504,23 Agt 2023,MAPI,1970,1970,1995,1935,1995,25
731,23 Agt 2023,SIDO,650,650,655,645,650,0
848,23 Agt 2023,UNTR,27600,27850,28150,27800,27875,275
849,23 Agt 2023,UNVR,3710,3710,3780,3700,3750,40
4,24 Agt 2023,ACES,755,760,770,755,760,5
36,24 Agt 2023,AMRT,2930,2930,2970,2890,2890,-40
59,24 Agt 2023,ASII,6550,6550,6600,6475,6475,-75
357,24 Agt 2023,HRUM,1635,1635,1635,1610,1610,-25
389,24 Agt 2023,INKP,9325,9325,9475,9325,9400,75
397,24 Agt 2023,INTP,11075,11100,11375,11100,11150,75
504,24 Agt 2023,MAPI,1995,1995,2040,1955,1955,-40
731,24 Agt 2023,SIDO,650,650,655,635,635,-15
848,24 Agt 2023,UNTR,27875,27775,27775,26700,26700,-1175
849,24 Agt 2023,UNVR,3750,3750,3760,3720,3720,-30
4,25 Agt 2023,ACES,760,765,765,745,750,-10
36,25 Agt 2023,AMRT,2890,2900,2950,2880,2890,0
59,25 Agt 2023,ASII,6475,6475,6500,6400,6450,-25
357,25 Agt 2023,HRUM,1610,1600,1610,1570,1600,-10
389,25 Agt 2023,INKP,9400,9400,9475,9250,9300,-100
397,25 Agt 2023,INTP,11150,11200,11300,11100,11300,150
504,25 Agt 2023,MAPI,1955,1965,1995,1920,1970,15
731,25 Agt 2023,SIDO,635,635,645,635,640,5
848,25 Agt 2023,UNTR,26700,26700,26725,25975,26050,-650
849,25 Agt 2023,UNVR,3720,3720,3760,3700,3760,40
4,28 Agt 2023,ACES,750,755,775,750,760,10
36,28 Agt 2023,AMRT,2890,2900,2930,2870,2870,-20
59,28 Agt 2023,ASII,6450,6500,6500,6400,6425,-25
357,28 Agt 2023,HRUM,1600,1600,1630,1595,1615,15
389,28 Agt 2023,INKP,9300,9300,9500,9300,9475,175
397,28 Agt 2023,INTP,11300,11275,11350,11150,11150,-150
504,28 Agt 2023,MAPI,1970,1975,2020,1945,2010,40
732,28 Agt 2023,SIDO,640,640,645,635,640,0
849,28 Agt 2023,UNTR,26050,26125,26600,26125,26400,350
850,28 Agt 2023,UNVR,3760,3790,3800,3760,3780,20
4,29 Agt 2023,ACES,760,765,770,750,755,-5
36,29 Agt 2023,AMRT,2870,2910,2930,2860,2900,30
59,29 Agt 2023,ASII,6425,6450,6450,6375,6400,-25
357,29 Agt 2023,HRUM,1615,1625,1635,1600,1600,-15
389,29 Agt 2023,INKP,9475,9475,9700,9425,9500,25
397,29 Agt 2023,INTP,11150,11150,11275,11125,11125,-25
504,29 Agt 2023,MAPI,2010,2010,2020,1955,1960,-50
732,29 Agt 2023,SIDO,640,640,645,630,635,-5
849,29 Agt 2023,UNTR,26400,26500,26600,26300,26350,-50
850,29 Agt 2023,UNVR,3780,3780,3800,3760,3760,-20
4,30 Agt 2023,ACES,755,760,765,750,755,0
36,30 Agt 2023,AMRT,2900,2900,2920,2860,2900,0
59,30 Agt 2023,ASII,6400,6450,6525,6400,6450,50
357,30 Agt 2023,HRUM,1600,1605,1610,1575,1585,-15
389,30 Agt 2023,INKP,9500,9525,9675,9350,9350,-150
397,30 Agt 2023,INTP,11125,11150,11200,10900,10900,-225
504,30 Agt 2023,MAPI,1960,1965,1985,1950,1960,0
732,30 Agt 2023,SIDO,635,635,635,620,620,-15
849,30 Agt 2023,UNTR,26350,26350,26400,26150,26150,-200
850,30 Agt 2023,UNVR,3760,3790,3790,3740,3740,-20
4,31 Agt 2023,ACES,755,755,755,730,730,-25
36,31 Agt 2023,AMRT,2900,2900,2920,2870,2900,0
59,31 Agt 2023,ASII,6450,6450,6475,6400,6450,0
357,31 Agt 2023,HRUM,1585,1585,1590,1560,1560,-25
389,31 Agt 2023,INKP,9350,9400,9425,9025,9100,-250
397,31 Agt 2023,INTP,10900,10875,10875,10600,10700,-200
504,31 Agt 2023,MAPI,1960,1965,1975,1935,1935,-25
732,31 Agt 2023,SIDO,620,625,625,615,620,0
849,31 Agt 2023,UNTR,26150,26150,26250,26000,26000,-150
850,31 Agt 2023,UNVR,3740,3740,3760,3670,3670,-70
4,01 Sep 2023,ACES,730,730,740,710,740,10
36,01 Sep 2023,AMRT,2900,2900,2910,2820,2880,-20
59,01 Sep 2023,ASII,6450,6475,6575,6475,6550,100
357,01 Sep 2023,HRUM,1560,1560,1585,1560,1575,15
389,01 Sep 2023,INKP,9100,9200,9300,9125,9175,75
397,01 Sep 2023,INTP,10700,10700,10700,10450,10600,-100
504,01 Sep 2023,MAPI,1935,1940,1985,1940,1975,40
732,01 Sep 2023,SIDO,620,620,625,610,615,-5
849,01 Sep 2023,UNTR,26000,26000,26425,26000,26350,350
850,01 Sep 2023,UNVR,3670,3670,3720,3630,3660,-10
4,04 Sep 2023,ACES,740,740,750,730,740,0
36,04 Sep 2023,AMRT,2880,2890,2910,2840,2850,-30
59,04 Sep 2023,ASII,6550,6575,6600,6525,6600,50
357,04 Sep 2023,HRUM,1575,1585,1640,1580,1620,45
389,04 Sep 2023,INKP,9175,9200,9300,9075,9250,75
397,04 Sep 2023,INTP,10600,10600,10800,10500,10600,0
504,04 Sep 2023,MAPI,1975,1975,1985,1950,1980,5
732,04 Sep 2023,SIDO,615,620,630,615,615,0
849,04 Sep 2023,UNTR,26350,26425,26875,26425,26825,475
850,04 Sep 2023,UNVR,3660,3670,3690,3660,3660,0
4,05 Sep 2023,ACES,740,740,740,730,730,-10
36,05 Sep 2023,AMRT,2850,2850,2860,2820,2840,-10
59,05 Sep 2023,ASII,6600,6600,6650,6550,6600,0
357,05 Sep 2023,HRUM,1620,1620,1635,1605,1605,-15
389,05 Sep 2023,INKP,9250,9250,9450,9200,9250,0
397,05 Sep 2023,INTP,10600,0,10775,10575,10700,100
504,05 Sep 2023,MAPI,1980,1990,1995,1950,1960,-20
732,05 Sep 2023,SIDO,615,615,620,610,615,0
849,05 Sep 2023,UNTR,26825,26850,27350,26850,27200,375
850,05 Sep 2023,UNVR,3660,3660,3670,3600,3620,-40
4,06 Sep 2023,ACES,730,730,750,715,725,-5
36,06 Sep 2023,AMRT,2840,2840,2870,2770,2810,-30
59,06 Sep 2023,ASII,6600,6575,6625,6525,6525,-75
357,06 Sep 2023,HRUM,1605,1625,1700,1620,1695,90
389,06 Sep 2023,INKP,9250,9300,9300,9150,9175,-75
397,06 Sep 2023,INTP,10700,10725,10975,10700,10775,75
504,06 Sep 2023,MAPI,1960,1955,1955,1865,1900,-60
732,06 Sep 2023,SIDO,615,615,625,615,620,5
849,06 Sep 2023,UNTR,27200,27400,27525,27350,27400,200
850,06 Sep 2023,UNVR,3620,3620,3680,3600,3650,30
4,07 Sep 2023,ACES,725,725,735,720,720,-5
36,07 Sep 2023,AMRT,2810,2810,2900,2810,2900,90
59,07 Sep 2023,ASII,6525,6475,6500,6350,6400,-125
358,07 Sep 2023,HRUM,1695,1685,1730,1660,1670,-25
390,07 Sep 2023,INKP,9175,9175,9600,9075,9475,300
398,07 Sep 2023,INTP,10775,10775,10775,10550,10700,-75
505,07 Sep 2023,MAPI,1900,1900,1905,1815,1840,-60
733,07 Sep 2023,SIDO,620,620,625,615,620,0
850,07 Sep 2023,UNTR,27400,27400,27425,26950,27150,-250
851,07 Sep 2023,UNVR,3650,3660,3670,3600,3630,-20
4,08 Sep 2023,ACES,720,725,730,715,720,0
36,08 Sep 2023,AMRT,2900,2900,2920,2820,2870,-30
59,08 Sep 2023,ASII,6400,6450,6450,6350,6400,0
358,08 Sep 2023,HRUM,1670,1670,1705,1655,1665,-5
390,08 Sep 2023,INKP,9475,9525,9550,9325,9450,-25
398,08 Sep 2023,INTP,10700,10750,10825,10675,10825,125
505,08 Sep 2023,MAPI,1840,1815,1870,1790,1840,0
733,08 Sep 2023,SIDO,620,620,620,600,600,-20
850,08 Sep 2023,UNTR,27150,27125,27475,26975,27300,150
851,08 Sep 2023,UNVR,3630,3630,3630,3570,3610,-20
4,11 Sep 2023,ACES,720,730,755,720,755,35
37,11 Sep 2023,AMRT,2870,2880,2950,2880,2950,80
60,11 Sep 2023,ASII,6400,6400,6425,6300,6375,-25
359,11 Sep 2023,HRUM,1665,1665,1730,1610,1695,30
391,11 Sep 2023,INKP,9450,9500,10200,9425,10200,750
399,11 Sep 2023,INTP,10825,10825,11050,10775,11025,200
506,11 Sep 2023,MAPI,1840,1850,1900,1830,1885,45
734,11 Sep 2023,SIDO,600,600,615,600,605,5
851,11 Sep 2023,UNTR,27300,27325,27350,26850,26900,-400
852,11 Sep 2023,UNVR,3610,3610,3650,3580,3650,40
4,12 Sep 2023,ACES,755,760,760,735,750,-5
37,12 Sep 2023,AMRT,2950,2960,2990,2920,2980,30
60,12 Sep 2023,ASII,6375,6375,6375,6300,6300,-75
359,12 Sep 2023,HRUM,1695,1715,1765,1715,1735,40
391,12 Sep 2023,INKP,10200,10225,10850,10025,10200,0
399,12 Sep 2023,INTP,11025,11075,11075,10775,10825,-200
506,12 Sep 2023,MAPI,1885,1895,1900,1820,1850,-35
734,12 Sep 2023,SIDO,605,605,615,605,610,5
851,12 Sep 2023,UNTR,26900,26950,27250,26925,27075,175
852,12 Sep 2023,UNVR,3650,3650,3660,3610,3620,-30
4,13 Sep 2023,ACES,750,750,760,745,745,-5
37,13 Sep 2023,AMRT,2980,3000,3000,2930,2960,-20
60,13 Sep 2023,ASII,6300,6325,6325,6225,6300,0
359,13 Sep 2023,HRUM,1735,1735,1770,1730,1760,25
391,13 Sep 2023,INKP,10200,10200,10625,10050,10575,375
399,13 Sep 2023,INTP,10825,10850,11000,10850,11000,175
506,13 Sep 2023,MAPI,1850,1850,1870,1830,1845,-5
734,13 Sep 2023,SIDO,610,610,610,600,605,-5
851,13 Sep 2023,UNTR,27075,27150,27275,27075,27175,100
852,13 Sep 2023,UNVR,3620,3630,3630,3570,3590,-30
4,14 Sep 2023,ACES,745,745,750,735,735,-10
37,14 Sep 2023,AMRT,2960,2950,2960,2840,2840,-120
60,14 Sep 2023,ASII,6300,6325,6375,6250,6325,25
359,14 Sep 2023,HRUM,1760,1775,1845,1770,1800,40
391,14 Sep 2023,INKP,10575,10575,10850,10500,10500,-75
399,14 Sep 2023,INTP,11000,11025,11025,10875,10900,-100
506,14 Sep 2023,MAPI,1845,1845,1860,1815,1825,-20
734,14 Sep 2023,SIDO,605,605,610,600,605,0
851,14 Sep 2023,UNTR,27175,27325,27600,27325,27400,225
852,14 Sep 2023,UNVR,3590,3580,3610,3560,3560,-30
4,15 Sep 2023,ACES,735,735,745,725,730,-5
37,15 Sep 2023,AMRT,2840,2840,2920,2840,2900,60
60,15 Sep 2023,ASII,6325,6250,6325,6200,6300,-25
359,15 Sep 2023,HRUM,1800,1800,1830,1775,1810,10
391,15 Sep 2023,INKP,10500,10500,10625,10400,10575,75
399,15 Sep 2023,INTP,10900,10975,10975,10750,10750,-150
506,15 Sep 2023,MAPI,1825,1835,1840,1800,1820,-5
734,15 Sep 2023,SIDO,605,605,610,590,590,-15
851,15 Sep 2023,UNTR,27400,27400,28425,27250,28425,1025
852,15 Sep 2023,UNVR,3560,3550,3570,3500,3500,-60
4,18 Sep 2023,ACES,730,735,795,730,795,65
37,18 Sep 2023,AMRT,2900,2880,2910,2840,2900,0
60,18 Sep 2023,ASII,6300,6275,6325,6250,6300,0
359,18 Sep 2023,HRUM,1810,1810,1820,1755,1780,-30
391,18 Sep 2023,INKP,10575,10600,10750,10225,10500,-75
399,18 Sep 2023,INTP,10750,10700,10750,10250,10250,-500
506,18 Sep 2023,MAPI,1820,1820,1820,1775,1795,-25
734,18 Sep 2023,SIDO,590,590,600,590,595,5
851,18 Sep 2023,UNTR,28425,28375,28600,28100,28100,-325
852,18 Sep 2023,UNVR,3500,3500,3520,3460,3470,-30
4,19 Sep 2023,ACES,795,800,815,775,775,-20
37,19 Sep 2023,AMRT,2900,2910,2910,2860,2900,0
60,19 Sep 2023,ASII,6300,6300,6375,6275,6350,50
359,19 Sep 2023,HRUM,1780,1785,1860,1755,1845,65
391,19 Sep 2023,INKP,10500,10500,11200,10475,11150,650
399,19 Sep 2023,INTP,10250,10250,10625,10175,10350,100
506,19 Sep 2023,MAPI,1795,1795,1835,1790,1800,5
734,19 Sep 2023,SIDO,595,590,595,585,590,-5
851,19 Sep 2023,UNTR,28100,28150,28450,28025,28325,225
852,19 Sep 2023,UNVR,3470,3490,3630,3480,3580,110
4,20 Sep 2023,ACES,775,775,810,770,790,15
37,20 Sep 2023,AMRT,2900,2900,2920,2860,2900,0
60,20 Sep 2023,ASII,6350,6350,6400,6300,6300,-50
359,20 Sep 2023,HRUM,1845,1860,1865,1805,1810,-35
391,20 Sep 2023,INKP,11150,11175,11375,10850,10925,-225
399,20 Sep 2023,INTP,10350,10325,10325,10100,10125,-225
506,20 Sep 2023,MAPI,1800,1800,1845,1790,1825,25
734,20 Sep 2023,SIDO,590,590,590,580,585,-5
851,20 Sep 2023,UNTR,28325,28400,28775,28400,28500,175
852,20 Sep 2023,UNVR,3580,3580,3670,3570,3630,50
4,21 Sep 2023,ACES,790,800,810,780,800,10
37,21 Sep 2023,AMRT,2900,2900,2930,2860,2880,-20
60,21 Sep 2023,ASII,6300,6300,6325,6200,6200,-100
359,21 Sep 2023,HRUM,1810,1810,1825,1780,1790,-20
391,21 Sep 2023,INKP,10925,10900,11100,10600,10925,0
399,21 Sep 2023,INTP,10125,10075,10300,10050,10250,125
506,21 Sep 2023,MAPI,1825,1825,1930,1805,1895,70
734,21 Sep 2023,SIDO,585,585,595,580,590,5
851,21 Sep 2023,UNTR,28500,28475,28475,28250,28325,-175
852,21 Sep 2023,UNVR,3630,3630,3780,3580,3770,140
4,22 Sep 2023,ACES,800,795,800,785,790,-10
37,22 Sep 2023,AMRT,2880,2880,2920,2880,2900,20
60,22 Sep 2023,ASII,6200,6200,6275,6175,6200,0
359,22 Sep 2023,HRUM,1790,1780,1830,1775,1820,30
391,22 Sep 2023,INKP,10925,10925,11625,10900,11500,575
399,22 Sep 2023,INTP,10250,10250,10300,10075,10100,-150
506,22 Sep 2023,MAPI,1895,1910,1915,1845,1875,-20
734,22 Sep 2023,SIDO,590,590,610,585,600,10
851,22 Sep 2023,UNTR,28325,28250,28525,28175,28350,25
852,22 Sep 2023,UNVR,3770,3770,3890,3750,3850,80
4,25 Sep 2023,ACES,790,795,800,780,790,0
37,25 Sep 2023,AMRT,2900,2910,2970,2900,2910,10
60,25 Sep 2023,ASII,6200,6225,6275,6200,6250,50
359,25 Sep 2023,HRUM,1820,1820,1870,1820,1820,0
391,25 Sep 2023,INKP,11500,11500,11725,11375,11550,50
399,25 Sep 2023,INTP,10100,10100,10200,10000,10025,-75
506,25 Sep 2023,MAPI,1875,1875,1880,1815,1815,-60
734,25 Sep 2023,SIDO,600,600,610,595,595,-5
851,25 Sep 2023,UNTR,28350,28350,28375,28150,28250,-100
852,25 Sep 2023,UNVR,3850,3860,3890,3790,3820,-30
4,26 Sep 2023,ACES,790,790,795,730,760,-30
37,26 Sep 2023,AMRT,2910,2930,2980,2930,2960,50
60,26 Sep 2023,ASII,6250,6225,6300,6200,6200,-50
359,26 Sep 2023,HRUM,1820,1825,1835,1715,1735,-85
391,26 Sep 2023,INKP,11550,11550,11850,11325,11450,-100
399,26 Sep 2023,INTP,10025,10075,10125,9725,9800,-225
506,26 Sep 2023,MAPI,1815,1820,1865,1820,1850,35
734,26 Sep 2023,SIDO,595,600,600,590,590,-5
851,26 Sep 2023,UNTR,28250,28275,28400,27625,27750,-500
852,26 Sep 2023,UNVR,3820,3800,3820,3770,3820,0
4,27 Sep 2023,ACES,760,760,765,745,755,-5
37,27 Sep 2023,AMRT,2960,2960,2980,2910,2930,-30
60,27 Sep 2023,ASII,6200,6200,6250,6125,6150,-50
359,27 Sep 2023,HRUM,1735,1745,1890,1745,1870,135
391,27 Sep 2023,INKP,11450,11475,11500,11075,11350,-100
399,27 Sep 2023,INTP,9800,9800,10075,9775,10075,275
506,27 Sep 2023,MAPI,1850,1870,1880,1745,1775,-75
734,27 Sep 2023,SIDO,590,590,595,580,585,-5
851,27 Sep 2023,UNTR,27750,27700,28300,27475,28300,550
852,27 Sep 2023,UNVR,3820,3820,3820,3720,3770,-50
4,29 Sep 2023,ACES,755,755,765,745,750,-5
37,29 Sep 2023,AMRT,2930,2950,2980,2910,2960,30
60,29 Sep 2023,ASII,6150,6250,6275,6200,6225,75
359,29 Sep 2023,HRUM,1870,1885,1945,1875,1885,15
391,29 Sep 2023,INKP,11350,11375,11450,10800,11100,-250
399,29 Sep 2023,INTP,10075,10100,10125,9925,9950,-125
506,29 Sep 2023,MAPI,1775,1780,1850,1780,1820,45
734,29 Sep 2023,SIDO,585,585,595,580,590,5
851,29 Sep 2023,UNTR,28300,28400,28475,28100,28250,-50
852,29 Sep 2023,UNVR,3770,3770,3780,3690,3740,-30
4,02 Okt 2023,ACES,750,755,790,755,785,35
37,02 Okt 2023,AMRT,2960,2960,2970,2930,2950,-10
60,02 Okt 2023,ASII,6225,6275,6350,6250,6275,50
359,02 Okt 2023,HRUM,1885,1895,1920,1815,1820,-65
391,02 Okt 2023,INKP,11100,11100,11250,10775,10875,-225
399,02 Okt 2023,INTP,9950,10025,10150,9975,10100,150
506,02 Okt 2023,MAPI,1820,1820,1885,1820,1870,50
734,02 Okt 2023,SIDO,590,590,590,580,585,-5
851,02 Okt 2023,UNTR,28250,28225,28350,27850,27925,-325
852,02 Okt 2023,UNVR,3740,3740,3780,3700,3700,-40
4,03 Okt 2023,ACES,785,785,790,770,775,-10
37,03 Okt 2023,AMRT,2950,2950,2980,2900,2950,0
60,03 Okt 2023,ASII,6275,6275,6300,6200,6200,-75
359,03 Okt 2023,HRUM,1820,1820,1825,1735,1735,-85
391,03 Okt 2023,INKP,10875,10875,11125,10600,10625,-250
399,03 Okt 2023,INTP,10100,10150,10175,10025,10100,0
506,03 Okt 2023,MAPI,1870,1875,1950,1875,1950,80
734,03 Okt 2023,SIDO,585,585,590,585,585,0
851,03 Okt 2023,UNTR,27925,27925,27925,27000,27000,-925
852,03 Okt 2023,UNVR,3700,3700,3700,3590,3590,-110
4,04 Okt 2023,ACES,775,775,775,750,750,-25
37,04 Okt 2023,AMRT,2950,2950,2970,2870,2870,-80
60,04 Okt 2023,ASII,6200,6175,6200,6050,6075,-125
359,04 Okt 2023,HRUM,1735,1725,1725,1635,1695,-40
391,04 Okt 2023,INKP,10625,10600,10600,9900,10100,-525
399,04 Okt 2023,INTP,10100,10050,10050,9825,10025,-75
506,04 Okt 2023,MAPI,1950,1950,1950,1900,1930,-20
734,04 Okt 2023,SIDO,585,585,590,560,560,-25
851,04 Okt 2023,UNTR,27000,26675,26675,26275,26575,-425
852,04 Okt 2023,UNVR,3590,3590,3610,3540,3580,-10
4,05 Okt 2023,ACES,750,750,780,745,760,10
37,05 Okt 2023,AMRT,2870,2900,2930,2890,2900,30
60,05 Okt 2023,ASII,6075,6125,6175,6025,6025,-50
359,05 Okt 2023,HRUM,1695,1685,1735,1625,1635,-60
391,05 Okt 2023,INKP,10100,10100,10600,10025,10200,100
399,05 Okt 2023,INTP,10025,10050,10175,9950,10125,100
506,05 Okt 2023,MAPI,1930,1930,1950,1910,1915,-15
734,05 Okt 2023,SIDO,560,565,615,565,605,45
851,05 Okt 2023,UNTR,26575,26575,26575,26150,26150,-425
852,05 Okt 2023,UNVR,3580,3610,3680,3580,3660,80
4,06 Okt 2023,ACES,760,760,770,755,765,5
37,06 Okt 2023,AMRT,2900,2920,2950,2720,2730,-170
60,06 Okt 2023,ASII,6025,6050,6150,6050,6075,50
359,06 Okt 2023,HRUM,1635,1630,1670,1610,1660,25
391,06 Okt 2023,INKP,10200,10275,10450,10175,10350,150
399,06 Okt 2023,INTP,10125,10125,10125,9975,10025,-100
508,06 Okt 2023,MAPI,1915,1920,1995,1920,1990,75
736,06 Okt 2023,SIDO,605,605,610,580,595,-10
853,06 Okt 2023,UNTR,26150,26175,26525,26175,26400,250
854,06 Okt 2023,UNVR,3660,3680,3840,3670,3800,140
4,09 Okt 2023,ACES,765,765,770,760,765,0
37,09 Okt 2023,AMRT,2730,2750,2830,2750,2820,90
60,09 Okt 2023,ASII,6075,6150,6225,6100,6125,50
360,09 Okt 2023,HRUM,1660,1685,1705,1660,1680,20
392,09 Okt 2023,INKP,10350,10250,10575,10150,10250,-100
400,09 Okt 2023,INTP,10025,9975,10050,9850,10000,-25
509,09 Okt 2023,MAPI,1990,1995,1995,1935,1960,-30
738,09 Okt 2023,SIDO,595,595,605,590,590,-5
855,09 Okt 2023,UNTR,26400,26600,26875,26600,26700,300
856,09 Okt 2023,UNVR,3800,3800,3800,3700,3720,-80
4,10 Okt 2023,ACES,765,770,790,770,780,15
37,10 Okt 2023,AMRT,2820,2820,2920,2820,2900,80
60,10 Okt 2023,ASII,6125,6175,6175,6050,6050,-75
360,10 Okt 2023,HRUM,1680,1710,1725,1670,1670,-10
392,10 Okt 2023,INKP,10250,10300,10725,10300,10600,350
400,10 Okt 2023,INTP,10000,10050,10175,10050,10100,100
509,10 Okt 2023,MAPI,1960,1970,2000,1945,1990,30
738,10 Okt 2023,SIDO,590,595,600,585,590,0
856,10 Okt 2023,UNTR,26700,26875,26950,26725,26875,175
857,10 Okt 2023,UNVR,3720,3720,3750,3670,3670,-50
4,11 Okt 2023,ACES,780,785,790,775,780,0
37,11 Okt 2023,AMRT,2900,2910,2940,2860,2880,-20
60,11 Okt 2023,ASII,6050,6075,6125,6050,6050,0
360,11 Okt 2023,HRUM,1670,1680,1695,1655,1675,5
392,11 Okt 2023,INKP,10600,10650,10850,10525,10675,75
400,11 Okt 2023,INTP,10100,10125,10150,9950,9950,-150
511,11 Okt 2023,MAPI,1990,1995,2020,1970,1980,-10
740,11 Okt 2023,SIDO,590,590,595,580,585,-5
858,11 Okt 2023,UNTR,26875,26300,26375,26250,26275,-600
859,11 Okt 2023,UNVR,3670,3670,3710,3610,3610,-60
4,12 Okt 2023,ACES,780,780,810,780,805,25
37,12 Okt 2023,AMRT,2880,2860,2900,2810,2850,-30
60,12 Okt 2023,ASII,6050,6000,6025,5950,5950,-100
360,12 Okt 2023,HRUM,1675,1675,1675,1615,1620,-55
392,12 Okt 2023,INKP,10675,10725,10925,10425,10725,50
400,12 Okt 2023,INTP,9950,9975,10125,9975,10050,100
511,12 Okt 2023,MAPI,1980,1990,1990,1930,1975,-5
740,12 Okt 2023,SIDO,585,585,600,585,590,5
858,12 Okt 2023,UNTR,26275,26275,26275,25850,25875,-400
859,12 Okt 2023,UNVR,3610,3620,3670,3610,3630,20
4,13 Okt 2023,ACES,805,805,830,785,785,-20
37,13 Okt 2023,AMRT,2850,2850,2850,2750,2810,-40
60,13 Okt 2023,ASII,5950,6000,6025,5950,5975,25
360,13 Okt 2023,HRUM,1620,1630,1695,1630,1670,50
392,13 Okt 2023,INKP,10725,10750,10775,10375,10525,-200
400,13 Okt 2023,INTP,10050,10050,10200,9975,10000,-50
511,13 Okt 2023,MAPI,1975,1975,1990,1950,1965,-10
740,13 Okt 2023,SIDO,590,590,595,575,580,-10
858,13 Okt 2023,UNTR,25875,26000,26325,26000,26075,200
859,13 Okt 2023,UNVR,3630,3610,3660,3610,3650,20
4,16 Okt 2023,ACES,785,785,810,775,805,20
37,16 Okt 2023,AMRT,2810,2820,2870,2800,2800,-10
60,16 Okt 2023,ASII,5975,5925,5975,5825,5850,-125
360,16 Okt 2023,HRUM,1670,1680,1720,1680,1705,35
392,16 Okt 2023,INKP,10525,10525,10525,10175,10350,-175
400,16 Okt 2023,INTP,10000,10000,10150,9975,10075,75
511,16 Okt 2023,MAPI,1965,1950,1960,1880,1890,-75
740,16 Okt 2023,SIDO,580,580,590,570,575,-5
858,16 Okt 2023,UNTR,26075,26375,26450,26200,26450,375
859,16 Okt 2023,UNVR,3650,3660,3670,3620,3650,0
4,17 Okt 2023,ACES,805,805,815,785,800,-5
37,17 Okt 2023,AMRT,2800,2810,2870,2790,2790,-10
60,17 Okt 2023,ASII,5850,5875,5925,5850,5850,0
360,17 Okt 2023,HRUM,1705,1705,1715,1680,1700,-5
392,17 Okt 2023,INKP,10350,10375,10675,10275,10325,-25
400,17 Okt 2023,INTP,10075,10100,10350,10100,10300,225
511,17 Okt 2023,MAPI,1890,1890,1915,1855,1855,-35
740,17 Okt 2023,SIDO,575,575,585,575,580,5
858,17 Okt 2023,UNTR,26450,26450,26475,26250,26375,-75
859,17 Okt 2023,UNVR,3650,3650,3840,3630,3830,180
4,18 Okt 2023,ACES,800,800,805,785,800,0
37,18 Okt 2023,AMRT,2790,2830,2840,2780,2810,20
60,18 Okt 2023,ASII,5850,5850,6000,5825,5825,-25
360,18 Okt 2023,HRUM,1700,1695,1725,1660,1725,25
392,18 Okt 2023,INKP,10325,10350,10725,10225,10625,300
400,18 Okt 2023,INTP,10300,10300,10300,9900,9900,-400
511,18 Okt 2023,MAPI,1855,1865,1895,1810,1895,40
740,18 Okt 2023,SIDO,580,580,585,575,580,0
858,18 Okt 2023,UNTR,26375,26275,26425,26100,26300,-75
859,18 Okt 2023,UNVR,3830,3830,3840,3760,3820,-10
4,19 Okt 2023,ACES,800,800,810,765,790,-10
37,19 Okt 2023,AMRT,2810,2820,2840,2800,2810,0
60,19 Okt 2023,ASII,5825,5825,5850,5700,5725,-100
360,19 Okt 2023,HRUM,1725,1725,1780,1720,1760,35
392,19 Okt 2023,INKP,10625,10600,10600,10300,10450,-175
400,19 Okt 2023,INTP,9900,9900,10000,9800,9875,-25
511,19 Okt 2023,MAPI,1895,1880,1880,1795,1855,-40
740,19 Okt 2023,SIDO,580,580,580,570,570,-10
858,19 Okt 2023,UNTR,26300,26400,26400,26000,26025,-275
859,19 Okt 2023,UNVR,3820,3800,3850,3770,3810,-10
4,20 Okt 2023,ACES,790,790,805,780,795,5
37,20 Okt 2023,AMRT,2810,2810,2900,2750,2800,-10
60,20 Okt 2023,ASII,5725,5675,5750,5650,5700,-25
360,20 Okt 2023,HRUM,1760,1760,1775,1705,1760,0
392,20 Okt 2023,INKP,10450,10425,10450,10100,10275,-175
400,20 Okt 2023,INTP,9875,9825,9875,9700,9825,-50
511,20 Okt 2023,MAPI,1855,1855,1915,1835,1905,50
740,20 Okt 2023,SIDO,570,570,575,560,575,5
858,20 Okt 2023,UNTR,26025,26000,26050,25800,25825,-200
859,20 Okt 2023,UNVR,3810,3810,3880,3730,3860,50
4,23 Okt 2023,ACES,795,810,845,805,825,30
37,23 Okt 2023,AMRT,2800,2800,2820,2750,2760,-40
60,23 Okt 2023,ASII,5700,5725,5750,5600,5600,-100
360,23 Okt 2023,HRUM,1760,1760,1785,1700,1720,-40
392,23 Okt 2023,INKP,10275,10275,10275,9650,9775,-500
400,23 Okt 2023,INTP,9825,9825,9825,9525,9650,-175
511,23 Okt 2023,MAPI,1905,1915,1930,1875,1920,15
740,23 Okt 2023,SIDO,575,575,575,565,570,-5
858,23 Okt 2023,UNTR,25825,25825,25850,25000,25000,-825
859,23 Okt 2023,UNVR,3860,3860,3860,3760,3840,-20
4,24 Okt 2023,ACES,825,825,865,815,855,30
37,24 Okt 2023,AMRT,2760,2760,2830,2760,2820,60
60,24 Okt 2023,ASII,5600,5600,5850,5600,5800,200
360,24 Okt 2023,HRUM,1720,1720,1755,1710,1735,15
392,24 Okt 2023,INKP,9775,9700,10000,9675,9800,25
400,24 Okt 2023,INTP,9650,9650,9825,9650,9675,25
511,24 Okt 2023,MAPI,1920,1920,1965,1880,1950,30
740,24 Okt 2023,SIDO,570,575,590,570,590,20
858,24 Okt 2023,UNTR,25000,25000,25425,24850,25250,250
859,24 Okt 2023,UNVR,3840,3830,4000,3790,3990,150
4,25 Okt 2023,ACES,855,855,890,855,875,20
37,25 Okt 2023,AMRT,2820,2830,2920,2820,2920,100
60,25 Okt 2023,ASII,5800,5825,5925,5775,5775,-25
360,25 Okt 2023,HRUM,1735,1745,1780,1730,1760,25
392,25 Okt 2023,INKP,9800,9875,9875,9300,9400,-400
400,25 Okt 2023,INTP,9675,9700,9800,9650,9650,-25
511,25 Okt 2023,MAPI,1950,1950,1970,1935,1955,5
740,25 Okt 2023,SIDO,590,590,600,590,590,0
858,25 Okt 2023,UNTR,25250,25700,26800,25700,26325,1075
859,25 Okt 2023,UNVR,3990,4000,4100,4000,4080,90
4,26 Okt 2023,ACES,875,875,880,825,870,-5
37,26 Okt 2023,AMRT,2920,2910,2910,2760,2850,-70
60,26 Okt 2023,ASII,5775,5775,5800,5675,5725,-50
360,26 Okt 2023,HRUM,1760,1760,1765,1715,1725,-35
392,26 Okt 2023,INKP,9400,9400,9750,9275,9500,100
400,26 Okt 2023,INTP,9650,9700,9700,9175,9350,-300
511,26 Okt 2023,MAPI,1955,1950,1950,1830,1850,-105
740,26 Okt 2023,SIDO,590,590,590,575,575,-15
858,26 Okt 2023,UNTR,26325,26200,26500,26000,26175,-150
859,26 Okt 2023,UNVR,4080,4050,4050,3960,3980,-100
4,27 Okt 2023,ACES,870,870,875,840,845,-25
37,27 Okt 2023,AMRT,2850,2850,2900,2820,2820,-30
60,27 Okt 2023,ASII,5725,5750,5775,5725,5725,0
360,27 Okt 2023,HRUM,1725,1730,1750,1730,1735,10
392,27 Okt 2023,INKP,9500,9600,10125,9550,10000,500
400,27 Okt 2023,INTP,9350,9375,9450,9125,9250,-100
511,27 Okt 2023,MAPI,1850,1855,1865,1780,1825,-25
740,27 Okt 2023,SIDO,575,575,585,565,575,0
858,27 Okt 2023,UNTR,26175,26175,26250,25525,25525,-650
859,27 Okt 2023,UNVR,3980,3980,4070,3950,3980,0
4,30 Okt 2023,ACES,845,845,860,795,830,-15
37,30 Okt 2023,AMRT,2820,2820,2900,2820,2890,70
60,30 Okt 2023,ASII,5725,5750,5825,5675,5800,75
360,30 Okt 2023,HRUM,1735,1735,1760,1595,1600,-135
392,30 Okt 2023,INKP,10000,10000,10100,9100,9300,-700
400,30 Okt 2023,INTP,9250,9250,9275,9150,9225,-25
511,30 Okt 2023,MAPI,1825,1820,1820,1750,1755,-70
740,30 Okt 2023,SIDO,575,575,580,510,515,-60
858,30 Okt 2023,UNTR,25525,25525,25525,24300,24400,-1125
859,30 Okt 2023,UNVR,3980,3970,3970,3720,3790,-190
4,31 Okt 2023,ACES,830,830,835,785,800,-30
37,31 Okt 2023,AMRT,2890,2890,2910,2830,2890,0
60,31 Okt 2023,ASII,5800,5850,5900,5775,5775,-25
360,31 Okt 2023,HRUM,1600,1600,1625,1565,1615,15
392,31 Okt 2023,INKP,9300,9300,9600,9200,9600,300
400,31 Okt 2023,INTP,9225,9225,9325,9025,9275,50
511,31 Okt 2023,MAPI,1755,1755,1755,1660,1735,-20
740,31 Okt 2023,SIDO,515,515,520,505,510,-5
859,31 Okt 2023,UNTR,24400,24425,25300,24425,25125,725
860,31 Okt 2023,UNVR,3790,3790,3820,3620,3620,-170
4,01 Nov 2023,ACES,800,810,820,780,795,-5
37,01 Nov 2023,AMRT,2890,2900,2940,2850,2850,-40
60,01 Nov 2023,ASII,5775,5900,6000,5800,5800,25
360,01 Nov 2023,HRUM,1615,1600,1600,1505,1510,-105
392,01 Nov 2023,INKP,9600,9100,9200,8200,8225,-1375
400,01 Nov 2023,INTP,9275,9500,9500,9100,9100,-175
511,01 Nov 2023,MAPI,1735,1725,1725,1580,1605,-130
740,01 Nov 2023,SIDO,510,505,505,484,486,-24
859,01 Nov 2023,UNTR,25125,25100,25100,24100,24100,-1025
860,01 Nov 2023,UNVR,3620,3600,3650,3550,3580,-40
4,02 Nov 2023,ACES,795,805,820,795,795,0
37,02 Nov 2023,AMRT,2850,2860,2880,2840,2850,0
60,02 Nov 2023,ASII,5800,5850,5900,5800,5800,0
360,02 Nov 2023,HRUM,1510,1510,1560,1510,1525,15
392,02 Nov 2023,INKP,8225,8400,8700,8300,8575,350
400,02 Nov 2023,INTP,9100,9150,9475,9150,9325,225
511,02 Nov 2023,MAPI,1605,1650,1745,1605,1710,105
740,02 Nov 2023,SIDO,486,486,505,486,492,6
859,02 Nov 2023,UNTR,24100,24125,24350,23725,23725,-375
860,02 Nov 2023,UNVR,3580,3600,3670,3570,3590,10
4,03 Nov 2023,ACES,795,800,825,795,820,25
37,03 Nov 2023,AMRT,2850,2850,2900,2850,2900,50
60,03 Nov 2023,ASII,5800,5850,5925,5825,5900,100
360,03 Nov 2023,HRUM,1525,1540,1560,1510,1515,-10
392,03 Nov 2023,INKP,8575,8725,8725,8325,8475,-100
400,03 Nov 2023,INTP,9325,9375,9500,9375,9375,50
511,03 Nov 2023,MAPI,1710,1710,1720,1640,1670,-40
740,03 Nov 2023,SIDO,492,494,500,478,496,4
859,03 Nov 2023,UNTR,23725,23800,24050,23775,23775,50
860,03 Nov 2023,UNVR,3590,3590,3610,3520,3550,-40
4,06 Nov 2023,ACES,820,830,870,820,860,40
37,06 Nov 2023,AMRT,2900,2900,2900,2790,2810,-90
60,06 Nov 2023,ASII,5900,5925,5950,5900,5925,25
360,06 Nov 2023,HRUM,1515,1505,1545,1495,1515,0
392,06 Nov 2023,INKP,8475,8475,8700,8475,8700,225
400,06 Nov 2023,INTP,9375,9575,9950,9450,9800,425
511,06 Nov 2023,MAPI,1670,1700,1705,1615,1685,15
740,06 Nov 2023,SIDO,496,496,505,496,500,4
859,06 Nov 2023,UNTR,23775,23825,23850,23550,23750,-25
860,06 Nov 2023,UNVR,3550,3550,3630,3550,3620,70
4,07 Nov 2023,ACES,860,860,860,825,830,-30
37,07 Nov 2023,AMRT,2810,2820,2890,2820,2890,80
60,07 Nov 2023,ASII,5925,5925,5950,5775,5825,-100
360,07 Nov 2023,HRUM,1515,1515,1515,1460,1470,-45
392,07 Nov 2023,INKP,8700,8700,8700,8350,8500,-200
400,07 Nov 2023,INTP,9800,9850,10200,9700,9825,25
511,07 Nov 2023,MAPI,1685,1685,1685,1560,1600,-85
740,07 Nov 2023,SIDO,500,505,505,496,496,-4
859,07 Nov 2023,UNTR,23750,23775,24075,23225,23375,-375
860,07 Nov 2023,UNVR,3620,3620,3620,3550,3570,-50
4,08 Nov 2023,ACES,830,840,845,820,830,0
37,08 Nov 2023,AMRT,2890,2890,2900,2850,2900,10
60,08 Nov 2023,ASII,5825,5800,5825,5675,5725,-100
360,08 Nov 2023,HRUM,1470,1470,1490,1455,1465,-5
393,08 Nov 2023,INKP,8500,8475,8500,8300,8400,-100
401,08 Nov 2023,INTP,9825,9825,9825,9550,9700,-125
512,08 Nov 2023,MAPI,1600,1600,1670,1580,1655,55
743,08 Nov 2023,SIDO,496,496,498,484,486,-10
862,08 Nov 2023,UNTR,23375,23375,23400,22700,22800,-575
863,08 Nov 2023,UNVR,3570,3560,3600,3560,3600,30
4,09 Nov 2023,ACES,830,830,840,820,825,-5
37,09 Nov 2023,AMRT,2900,2900,2970,2850,2900,0
60,09 Nov 2023,ASII,5725,5775,5825,5725,5750,25
360,09 Nov 2023,HRUM,1465,1480,1510,1465,1475,10
393,09 Nov 2023,INKP,8400,8425,8650,8300,8575,175
401,09 Nov 2023,INTP,9700,9700,9750,9600,9600,-100
512,09 Nov 2023,MAPI,1655,1655,1670,1610,1665,10
743,09 Nov 2023,SIDO,486,488,494,486,494,8
862,09 Nov 2023,UNTR,22800,23000,23125,22875,22875,75
863,09 Nov 2023,UNVR,3600,3600,3600,3580,3600,0
4,10 Nov 2023,ACES,825,820,830,800,805,-20
37,10 Nov 2023,AMRT,2900,2910,2910,2880,2900,0
60,10 Nov 2023,ASII,5750,5725,5775,5725,5775,25
360,10 Nov 2023,HRUM,1475,1475,1475,1455,1460,-15
393,10 Nov 2023,INKP,8575,8600,8650,8350,8475,-100
401,10 Nov 2023,INTP,9600,9600,9600,9350,9400,-200
512,10 Nov 2023,MAPI,1665,1650,1710,1645,1685,20
743,10 Nov 2023,SIDO,494,494,498,494,496,2
862,10 Nov 2023,UNTR,22875,22900,23175,22900,23100,225
863,10 Nov 2023,UNVR,3600,3600,3600,3550,3590,-10
4,13 Nov 2023,ACES,805,815,830,810,825,20
37,13 Nov 2023,AMRT,2900,2910,2920,2890,2910,10
60,13 Nov 2023,ASII,5775,5825,5825,5650,5650,-125
360,13 Nov 2023,HRUM,1460,1455,1460,1430,1445,-15
393,13 Nov 2023,INKP,8475,8575,8800,8450,8750,275
401,13 Nov 2023,INTP,9400,9475,9475,9375,9425,25
512,13 Nov 2023,MAPI,1685,1685,1685,1600,1610,-75
743,13 Nov 2023,SIDO,496,498,500,496,500,4
862,13 Nov 2023,UNTR,23100,23100,23500,23100,23250,150
863,13 Nov 2023,UNVR,3590,3590,3590,3510,3530,-60
4,14 Nov 2023,ACES,825,830,840,810,810,-15
37,14 Nov 2023,AMRT,2910,2920,2920,2830,2880,-30
60,14 Nov 2023,ASII,5650,5675,5725,5650,5675,25
360,14 Nov 2023,HRUM,1445,1445,1470,1435,1470,25
393,14 Nov 2023,INKP,8750,8800,8900,8625,8625,-125
401,14 Nov 2023,INTP,9425,9425,9475,9325,9425,0
512,14 Nov 2023,MAPI,1610,1600,1645,1550,1590,-20
743,14 Nov 2023,SIDO,500,500,500,492,498,-2
862,14 Nov 2023,UNTR,23250,23300,23475,23225,23250,0
863,14 Nov 2023,UNVR,3530,3510,3520,3470,3480,-50
4,15 Nov 2023,ACES,810,825,835,820,835,25
37,15 Nov 2023,AMRT,2880,2940,2940,2860,2900,20
60,15 Nov 2023,ASII,5675,5750,5850,5700,5750,75
360,15 Nov 2023,HRUM,1470,1470,1485,1450,1450,-20
393,15 Nov 2023,INKP,8625,8575,8625,8450,8475,-150
401,15 Nov 2023,INTP,9425,9475,9475,9350,9425,0
512,15 Nov 2023,MAPI,1590,1615,1710,1605,1685,95
743,15 Nov 2023,SIDO,498,500,505,496,498,0
862,15 Nov 2023,UNTR,23250,23300,23900,23300,23400,150
863,15 Nov 2023,UNVR,3480,3500,3530,3410,3430,-50
4,16 Nov 2023,ACES,835,840,840,820,830,-5
37,16 Nov 2023,AMRT,2900,2900,2920,2860,2900,0
60,16 Nov 2023,ASII,5750,5750,5825,5725,5825,75
360,16 Nov 2023,HRUM,1450,1455,1465,1435,1440,-10
393,16 Nov 2023,INKP,8475,8500,8675,8400,8675,200
401,16 Nov 2023,INTP,9425,9425,9425,9325,9400,-25
512,16 Nov 2023,MAPI,1685,1695,1695,1635,1640,-45
743,16 Nov 2023,SIDO,498,498,500,498,498,0
862,16 Nov 2023,UNTR,23400,23425,23600,23050,23450,50
863,16 Nov 2023,UNVR,3430,3440,3460,3420,3460,30
4,17 Nov 2023,ACES,830,830,830,815,815,-15
37,17 Nov 2023,AMRT,2900,2900,2910,2870,2890,-10
60,17 Nov 2023,ASII,5825,5800,5825,5700,5700,-125
360,17 Nov 2023,HRUM,1440,1430,1445,1405,1410,-30
393,17 Nov 2023,INKP,8675,8650,8675,8500,8500,-175
401,17 Nov 2023,INTP,9400,9400,9500,9375,9450,50
512,17 Nov 2023,MAPI,1640,1640,1665,1615,1660,20
743,17 Nov 2023,SIDO,498,500,500,494,498,0
862,17 Nov 2023,UNTR,23450,23450,23450,22800,22875,-575
863,17 Nov 2023,UNVR,3460,3470,3470,3420,3470,10
4,20 Nov 2023,ACES,815,820,835,815,830,15
37,20 Nov 2023,AMRT,2890,2910,2940,2890,2900,10
60,20 Nov 2023,ASII,5700,5725,5850,5700,5800,100
360,20 Nov 2023,HRUM,1410,1415,1440,1410,1415,5
393,20 Nov 2023,INKP,8500,8475,8600,8475,8500,0
401,20 Nov 2023,INTP,9450,9450,9625,9400,9550,100
512,20 Nov 2023,MAPI,1660,1660,1675,1630,1650,-10
743,20 Nov 2023,SIDO,498,500,505,498,505,7
862,20 Nov 2023,UNTR,22875,22900,23000,22750,22950,75
863,20 Nov 2023,UNVR,3470,3470,3470,3420,3460,-10
4,21 Nov 2023,ACES,830,830,855,820,820,-10
37,21 Nov 2023,AMRT,2900,2910,2930,2830,2900,0
60,21 Nov 2023,ASII,5800,5800,5850,5750,5775,-25
360,21 Nov 2023,HRUM,1415,1415,1425,1405,1420,5
393,21 Nov 2023,INKP,8500,8550,8700,8525,8650,150
401,21 Nov 2023,INTP,9550,9600,9600,9300,9350,-200
512,21 Nov 2023,MAPI,1650,1650,1665,1635,1645,-5
743,21 Nov 2023,SIDO,505,500,505,498,500,-5
862,21 Nov 2023,UNTR,22950,22950,22950,22700,22775,-175
863,21 Nov 2023,UNVR,3460,3460,3490,3430,3480,20
4,22 Nov 2023,ACES,820,825,830,815,815,-5
37,22 Nov 2023,AMRT,2900,2900,2940,2860,2880,-20
60,22 Nov 2023,ASII,5775,5775,5775,5650,5675,-100
360,22 Nov 2023,HRUM,1420,1420,1440,1410,1435,15
393,22 Nov 2023,INKP,8650,8625,8650,8475,8550,-100
401,22 Nov 2023,INTP,9350,9375,9400,9225,9250,-100
512,22 Nov 2023,MAPI,1645,1655,1680,1620,1675,30
743,22 Nov 2023,SIDO,500,500,500,496,498,-2
862,22 Nov 2023,UNTR,22775,22775,22775,22275,22325,-450
863,22 Nov 2023,UNVR,3480,3480,3520,3450,3500,20
4,23 Nov 2023,ACES,815,820,825,805,810,-5
37,23 Nov 2023,AMRT,2880,2900,2920,2880,2890,10
60,23 Nov 2023,ASII,5675,5675,5725,5675,5700,25
360,23 Nov 2023,HRUM,1435,1430,1435,1405,1415,-20
393,23 Nov 2023,INKP,8550,8550,8550,8300,8450,-100
401,23 Nov 2023,INTP,9250,9225,9400,9225,9250,0
512,23 Nov 2023,MAPI,1675,1675,1760,1665,1745,70
743,23 Nov 2023,SIDO,498,498,500,498,498,0
862,23 Nov 2023,UNTR,22325,22500,22575,22325,22525,200
863,23 Nov 2023,UNVR,3500,3510,3580,3500,3540,40
4,24 Nov 2023,ACES,810,815,820,760,815,5
37,24 Nov 2023,AMRT,2890,2890,2910,2860,2870,-20
60,24 Nov 2023,ASII,5700,5700,5750,5700,5725,25
360,24 Nov 2023,HRUM,1415,1415,1460,1405,1440,25
393,24 Nov 2023,INKP,8450,8450,8450,8350,8450,0
401,24 Nov 2023,INTP,9250,9250,9325,9200,9275,25
512,24 Nov 2023,MAPI,1745,1740,1800,1740,1785,40
743,24 Nov 2023,SIDO,498,498,500,498,498,0
862,24 Nov 2023,UNTR,22525,22575,22650,22475,22625,100
863,24 Nov 2023,UNVR,3540,3550,3580,3520,3530,-10
4,27 Nov 2023,ACES,815,815,815,795,800,-15
37,27 Nov 2023,AMRT,2870,2900,2900,2840,2860,-10
60,27 Nov 2023,ASII,5725,5725,5750,5600,5625,-100
360,27 Nov 2023,HRUM,1440,1445,1475,1435,1445,5
393,27 Nov 2023,INKP,8450,8425,8425,8325,8350,-100
401,27 Nov 2023,INTP,9275,9300,9425,9250,9250,-25
512,27 Nov 2023,MAPI,1785,1800,1815,1765,1780,-5
743,27 Nov 2023,SIDO,498,500,505,498,500,2
862,27 Nov 2023,UNTR,22625,22625,22875,22450,22450,-175
863,27 Nov 2023,UNVR,3530,3530,3550,3500,3520,-10
4,28 Nov 2023,ACES,800,805,810,770,775,-25
37,28 Nov 2023,AMRT,2860,2860,2900,2850,2870,10
60,28 Nov 2023,ASII,5625,5675,5675,5550,5550,-75
360,28 Nov 2023,HRUM,1445,1450,1470,1435,1455,10
393,28 Nov 2023,INKP,8350,8350,8525,8350,8450,100
401,28 Nov 2023,INTP,9250,9300,9375,9250,9275,25
512,28 Nov 2023,MAPI,1780,1780,1795,1720,1735,-45
743,28 Nov 2023,SIDO,500,500,505,496,498,-2
862,28 Nov 2023,UNTR,22450,22500,22725,22325,22500,50
863,28 Nov 2023,UNVR,3520,3520,3640,3520,3600,80
4,29 Nov 2023,ACES,775,780,785,750,770,-5
37,29 Nov 2023,AMRT,2870,2870,2900,2800,2810,-60
60,29 Nov 2023,ASII,5550,5600,5650,5525,5525,-25
360,29 Nov 2023,HRUM,1455,1425,1470,1420,1435,-20
393,29 Nov 2023,INKP,8450,8525,8875,8525,8800,350
401,29 Nov 2023,INTP,9275,9375,9425,9300,9400,125
512,29 Nov 2023,MAPI,1735,1735,1740,1710,1730,-5
743,29 Nov 2023,SIDO,498,500,500,496,498,0
862,29 Nov 2023,UNTR,22500,22600,22600,22300,22450,-50
863,29 Nov 2023,UNVR,3600,3600,3640,3560,3630,30
4,30 Nov 2023,ACES,770,770,775,740,755,-15
37,30 Nov 2023,AMRT,2810,2830,2930,2790,2870,60
60,30 Nov 2023,ASII,5525,5575,5575,5400,5400,-125
361,30 Nov 2023,HRUM,1435,1435,1445,1380,1385,-50
394,30 Nov 2023,INKP,8800,8850,8900,8625,8775,-25
402,30 Nov 2023,INTP,9400,9325,10200,9275,10200,800
513,30 Nov 2023,MAPI,1730,1740,1765,1695,1745,15
744,30 Nov 2023,SIDO,498,500,505,498,500,2
863,30 Nov 2023,UNTR,22450,22450,22500,21900,21900,-550
864,30 Nov 2023,UNVR,3630,3630,3650,3570,3650,20
4,01 Des 2023,ACES,755,760,760,730,735,-20
37,01 Des 2023,AMRT,2870,2900,2900,2850,2900,30
60,01 Des 2023,ASII,5400,5450,5750,5450,5750,350
361,01 Des 2023,HRUM,1385,1385,1405,1385,1400,15
394,01 Des 2023,INKP,8775,8575,8750,8450,8475,-300
402,01 Des 2023,INTP,10200,9600,9750,9375,9550,-650
513,01 Des 2023,MAPI,1745,1720,1745,1700,1740,-5
744,01 Des 2023,SIDO,500,500,500,496,498,-2
863,01 Des 2023,UNTR,21900,22025,22350,22000,22150,250
864,01 Des 2023,UNVR,3650,3600,3700,3590,3630,-20
4,04 Des 2023,ACES,735,730,750,720,720,-15
37,04 Des 2023,AMRT,2900,2900,2910,2870,2870,-30
60,04 Des 2023,ASII,5750,5750,5825,5725,5750,0
361,04 Des 2023,HRUM,1400,1405,1415,1360,1365,-35
394,04 Des 2023,INKP,8475,8575,8575,8350,8425,-50
402,04 Des 2023,INTP,9550,9475,9500,9350,9350,-200
513,04 Des 2023,MAPI,1740,1730,1735,1640,1670,-70
744,04 Des 2023,SIDO,498,500,545,496,530,32
863,04 Des 2023,UNTR,22150,22200,22675,22200,22425,275
864,04 Des 2023,UNVR,3630,3640,3670,3550,3630,0
4,05 Des 2023,ACES,720,720,730,690,710,-10
37,05 Des 2023,AMRT,2870,2880,2900,2860,2870,0
60,05 Des 2023,ASII,5750,5775,5800,5675,5725,-25
361,05 Des 2023,HRUM,1365,1365,1370,1315,1320,-45
394,05 Des 2023,INKP,8425,8475,8625,8425,8575,150
402,05 Des 2023,INTP,9350,9375,9475,9275,9475,125
513,05 Des 2023,MAPI,1670,1655,1680,1625,1670,0
744,05 Des 2023,SIDO,530,535,575,530,560,30
863,05 Des 2023,UNTR,22425,22425,22450,22025,22050,-375
864,05 Des 2023,UNVR,3630,3590,3620,3570,3620,-10
4,06 Des 2023,ACES,710,715,730,705,730,20
37,06 Des 2023,AMRT,2870,2880,2910,2860,2890,20
60,06 Des 2023,ASII,5725,5700,5825,5700,5725,0
361,06 Des 2023,HRUM,1320,1335,1335,1265,1270,-50
394,06 Des 2023,INKP,8575,8575,8650,8400,8400,-175
402,06 Des 2023,INTP,9475,9425,9550,9425,9500,25
513,06 Des 2023,MAPI,1670,1670,1690,1635,1640,-30
744,06 Des 2023,SIDO,560,560,575,560,570,10
863,06 Des 2023,UNTR,22050,22050,22150,21600,21625,-425
864,06 Des 2023,UNVR,3620,3620,3630,3500,3510,-110
4,07 Des 2023,ACES,730,730,730,670,695,-35
37,07 Des 2023,AMRT,2890,2870,2900,2870,2900,10
60,07 Des 2023,ASII,5725,5750,5750,5600,5675,-50
361,07 Des 2023,HRUM,1270,1285,1300,1240,1265,-5
394,07 Des 2023,INKP,8400,8500,8500,8250,8300,-100
402,07 Des 2023,INTP,9500,9500,9600,9400,9525,25
513,07 Des 2023,MAPI,1640,1640,1650,1605,1640,0
744,07 Des 2023,SIDO,570,570,570,540,550,-20
864,07 Des 2023,UNTR,21625,21675,21850,21425,21700,75
865,07 Des 2023,UNVR,3510,3510,3570,3500,3570,60
4,08 Des 2023,ACES,695,695,710,690,695,0
37,08 Des 2023,AMRT,2900,2890,2890,2770,2850,-50
60,08 Des 2023,ASII,5675,5675,5700,5625,5675,0
361,08 Des 2023,HRUM,1265,1285,1345,1280,1330,65
394,08 Des 2023,INKP,8300,8350,8475,8075,8150,-150
402,08 Des 2023,INTP,9525,9550,9550,9350,9375,-150
513,08 Des 2023,MAPI,1640,1645,1680,1635,1660,20
744,08 Des 2023,SIDO,550,555,555,535,540,-10
864,08 Des 2023,UNTR,21700,21800,22350,21725,22300,600
865,08 Des 2023,UNVR,3570,3570,3570,3490,3510,-60
4,11 Des 2023,ACES,695,700,700,685,690,-5
37,11 Des 2023,AMRT,2850,2850,2850,2720,2800,-50
60,11 Des 2023,ASII,5675,5650,5675,5525,5600,-75
361,11 Des 2023,HRUM,1330,1350,1385,1330,1330,0
394,11 Des 2023,INKP,8150,8200,8200,7800,7800,-350
402,11 Des 2023,INTP,9375,9400,9450,9325,9425,50
513,11 Des 2023,MAPI,1660,1650,1650,1595,1630,-30
744,11 Des 2023,SIDO,540,540,555,530,530,-10
864,11 Des 2023,UNTR,22300,22425,22450,21825,21825,-475
865,11 Des 2023,UNVR,3510,3500,3510,3470,3500,-10
4,12 Des 2023,ACES,690,690,710,685,685,-5
37,12 Des 2023,AMRT,2800,2800,2870,2770,2850,50
60,12 Des 2023,ASII,5600,5675,5675,5550,5575,-25
361,12 Des 2023,HRUM,1330,1335,1345,1290,1310,-20
394,12 Des 2023,INKP,7800,7825,8150,7775,8075,275
402,12 Des 2023,INTP,9425,9425,9550,9325,9400,-25
513,12 Des 2023,MAPI,1630,1630,1630,1560,1615,-15
744,12 Des 2023,SIDO,530,530,540,520,530,0
864,12 Des 2023,UNTR,21825,22000,22025,21850,21850,25
865,12 Des 2023,UNVR,3500,3500,3510,3420,3430,-70
4,13 Des 2023,ACES,685,690,690,665,680,-5
37,13 Des 2023,AMRT,2850,2850,2880,2810,2880,30
60,13 Des 2023,ASII,5575,5550,5600,5525,5525,-50
361,13 Des 2023,HRUM,1310,1300,1300,1265,1280,-30
394,13 Des 2023,INKP,8075,8075,8100,7925,8000,-75
402,13 Des 2023,INTP,9400,9375,9375,9175,9300,-100
513,13 Des 2023,MAPI,1615,1625,1655,1600,1620,5
744,13 Des 2023,SIDO,530,530,565,525,550,20
864,13 Des 2023,UNTR,21850,21700,21725,20925,20925,-925
865,13 Des 2023,UNVR,3430,3430,3460,3400,3450,20
4,14 Des 2023,ACES,680,685,700,680,680,0
37,14 Des 2023,AMRT,2880,2890,2910,2840,2900,20
60,14 Des 2023,ASII,5525,5600,5650,5575,5625,100
361,14 Des 2023,HRUM,1280,1295,1335,1285,1320,40
394,14 Des 2023,INKP,8000,8025,8050,7850,7850,-150
402,14 Des 2023,INTP,9300,9300,9375,9275,9300,0
513,14 Des 2023,MAPI,1620,1645,1725,1640,1720,100
744,14 Des 2023,SIDO,550,550,565,550,555,5
864,14 Des 2023,UNTR,20925,21075,21675,21000,21450,525
865,14 Des 2023,UNVR,3450,3450,3450,3400,3400,-50
4,15 Des 2023,ACES,680,685,690,675,685,5
37,15 Des 2023,AMRT,2900,2860,2880,2770,2800,-100
60,15 Des 2023,ASII,5625,5625,5700,5600,5650,25
361,15 Des 2023,HRUM,1320,1335,1355,1320,1330,10
394,15 Des 2023,INKP,7850,7850,8075,7850,7975,125
402,15 Des 2023,INTP,9300,9300,9425,9275,9300,0
513,15 Des 2023,MAPI,1720,1710,1720,1655,1675,-45
744,15 Des 2023,SIDO,555,560,560,540,545,-10
864,15 Des 2023,UNTR,21450,21500,21950,21275,21275,-175
865,15 Des 2023,UNVR,3400,3400,3500,3330,3500,100
4,18 Des 2023,ACES,685,695,740,690,715,30
37,18 Des 2023,AMRT,2800,2750,2750,2530,2730,-70
60,18 Des 2023,ASII,5650,5650,5650,5550,5600,-50
361,18 Des 2023,HRUM,1330,1340,1360,1300,1305,-25
394,18 Des 2023,INKP,7975,7975,8150,7975,8025,50
402,18 Des 2023,INTP,9300,9250,9350,9250,9300,0
513,18 Des 2023,MAPI,1675,1680,1685,1645,1675,0
744,18 Des 2023,SIDO,545,550,550,540,545,0
864,18 Des 2023,UNTR,21275,21425,21850,21375,21800,525
865,18 Des 2023,UNVR,3500,3480,3480,3380,3410,-90
4,19 Des 2023,ACES,715,720,750,705,740,25
37,19 Des 2023,AMRT,2730,2730,2820,2700,2820,90
60,19 Des 2023,ASII,5600,5625,5650,5600,5625,25
361,19 Des 2023,HRUM,1305,1305,1315,1290,1305,0
394,19 Des 2023,INKP,8025,8100,8100,7900,7925,-100
402,19 Des 2023,INTP,9300,9300,9375,9200,9200,-100
513,19 Des 2023,MAPI,1675,1675,1710,1665,1700,25
744,19 Des 2023,SIDO,545,545,560,545,555,10
864,19 Des 2023,UNTR,21800,21750,21825,21450,21825,25
865,19 Des 2023,UNVR,3410,3410,3440,3380,3430,20
4,20 Des 2023,ACES,740,740,750,720,720,-20
37,20 Des 2023,AMRT,2820,2820,2830,2800,2820,0
60,20 Des 2023,ASII,5625,5650,5700,5625,5625,0
361,20 Des 2023,HRUM,1305,1315,1340,1305,1315,10
394,20 Des 2023,INKP,7925,7925,8575,7925,8400,475
402,20 Des 2023,INTP,9200,9250,9325,9150,9150,-50
513,20 Des 2023,MAPI,1700,1720,1740,1695,1715,15
744,20 Des 2023,SIDO,555,555,560,540,545,-10
864,20 Des 2023,UNTR,21825,21875,22250,21800,21800,-25
865,20 Des 2023,UNVR,3430,3430,3520,3420,3460,30
4,21 Des 2023,ACES,720,725,730,715,725,5
37,21 Des 2023,AMRT,2820,2820,2880,2820,2880,60
60,21 Des 2023,ASII,5625,5600,5600,5475,5550,-75
361,21 Des 2023,HRUM,1315,1305,1325,1290,1310,-5
394,21 Des 2023,INKP,8400,8400,8450,8275,8325,-75
402,21 Des 2023,INTP,9150,9175,9250,9125,9150,0
513,21 Des 2023,MAPI,1715,1715,1720,1690,1715,0
744,21 Des 2023,SIDO,545,545,550,530,535,-10
864,21 Des 2023,UNTR,21800,21800,22075,21775,22000,200
865,21 Des 2023,UNVR,3460,3470,3480,3440,3470,10
4,22 Des 2023,ACES,725,730,735,715,720,-5
37,22 Des 2023,AMRT,2880,2870,2880,2820,2870,-10
60,22 Des 2023,ASII,5550,5550,5600,5500,5550,0
361,22 Des 2023,HRUM,1310,1310,1320,1295,1305,-5
394,22 Des 2023,INKP,8325,8325,8475,8300,8350,25
402,22 Des 2023,INTP,9150,9200,9325,9175,9275,125
513,22 Des 2023,MAPI,1715,1720,1785,1720,1765,50
744,22 Des 2023,SIDO,535,535,545,535,540,5
864,22 Des 2023,UNTR,22000,22050,22150,21850,22025,25
865,22 Des 2023,UNVR,3470,3470,3490,3440,3470,0
4,27 Des 2023,ACES,720,720,740,715,725,5
37,27 Des 2023,AMRT,2870,2870,2900,2850,2870,0
60,27 Des 2023,ASII,5550,5550,5575,5500,5550,0
361,27 Des 2023,HRUM,1305,1305,1360,1295,1350,45
394,27 Des 2023,INKP,8350,8350,8400,8225,8250,-100
402,27 Des 2023,INTP,9275,9300,9375,9225,9275,0
513,27 Des 2023,MAPI,1765,1765,1780,1740,1750,-15
744,27 Des 2023,SIDO,540,540,545,525,525,-15
864,27 Des 2023,UNTR,22025,22025,22625,21975,22425,400
865,27 Des 2023,UNVR,3470,3470,3520,3450,3470,0
4,28 Des 2023,ACES,725,730,735,705,715,-10
37,28 Des 2023,AMRT,2870,2890,2930,2870,2910,40
60,28 Des 2023,ASII,5550,5575,5600,5550,5600,50
361,28 Des 2023,HRUM,1350,1370,1380,1335,1345,-5
394,28 Des 2023,INKP,8250,8300,8450,8275,8375,125
402,28 Des 2023,INTP,9275,9325,9475,9300,9400,125
513,28 Des 2023,MAPI,1750,1750,1775,1745,1765,15
744,28 Des 2023,SIDO,525,530,535,525,530,5
864,28 Des 2023,UNTR,22425,22525,22775,22450,22700,275
865,28 Des 2023,UNVR,3470,3500,3570,3500,3540,70
4,29 Des 2023,ACES,715,715,720,705,720,5
37,29 Des 2023,AMRT,2910,2910,2950,2870,2930,20
60,29 Des 2023,ASII,5600,5600,5675,5575,5650,50
361,29 Des 2023,HRUM,1345,1345,1350,1325,1335,-10
394,29 Des 2023,INKP,8375,8375,8425,8300,8325,-50
402,29 Des 2023,INTP,9400,9425,9450,9325,9400,0
513,29 Des 2023,MAPI,1765,1765,1830,1765,1790,25
744,29 Des 2023,SIDO,530,530,530,520,525,-5
864,29 Des 2023,UNTR,22700,22700,22750,22500,22625,-75
865,29 Des 2023,UNVR,3540,3540,3550,3500,3530,-10
4,03 Jan 2022,ACES,1280,1285,1385,1285,1380,100
33,03 Jan 2022,AMRT,1215,0,1245,1200,1230,15
54,03 Jan 2022,ASII,5700,5675,5750,5625,5725,25
310,03 Jan 2022,HRUM,10325,0,10650,9900,10500,175
339,03 Jan 2022,INKP,7825,7825,8250,7825,8100,275
347,03 Jan 2022,INTP,12100,12000,12050,11650,11700,-400
440,03 Jan 2022,MAPI,710,0,730,700,700,-10
630,03 Jan 2022,SIDO,865,0,875,865,870,5
736,03 Jan 2022,UNTR,22150,21900,22125,21750,21825,-325
737,03 Jan 2022,UNVR,4110,4120,4340,4120,4230,120
4,04 Jan 2022,ACES,1380,1380,1380,1345,1365,-15
33,04 Jan 2022,AMRT,1230,0,1245,1185,1195,-35
54,04 Jan 2022,ASII,5725,5750,5875,5725,5775,50
310,04 Jan 2022,HRUM,10500,0,10700,10275,10500,0
339,04 Jan 2022,INKP,8100,8125,8250,8050,8075,-25
347,04 Jan 2022,INTP,11700,11700,11850,11450,11475,-225
440,04 Jan 2022,MAPI,700,0,785,700,775,75
630,04 Jan 2022,SIDO,870,0,910,865,900,30
736,04 Jan 2022,UNTR,21825,21850,22125,21800,21925,100
737,04 Jan 2022,UNVR,4230,4250,4310,4230,4250,20
4,05 Jan 2022,ACES,1365,1365,1395,1350,1385,20
33,05 Jan 2022,AMRT,1195,0,1210,1180,1200,5
54,05 Jan 2022,ASII,5775,5725,5775,5550,5575,-200
310,05 Jan 2022,HRUM,10500,0,10975,10275,10300,-200
339,05 Jan 2022,INKP,8075,8100,8400,8100,8125,50
347,05 Jan 2022,INTP,11475,11475,11575,11275,11300,-175
440,05 Jan 2022,MAPI,775,0,785,750,780,5
630,05 Jan 2022,SIDO,900,0,915,900,910,10
736,05 Jan 2022,UNTR,21925,21925,22450,21725,21950,25
737,05 Jan 2022,UNVR,4250,4260,4270,4180,4210,-40
4,06 Jan 2022,ACES,1385,1380,1385,1335,1360,-25
33,06 Jan 2022,AMRT,1200,0,1200,1135,1155,-45
54,06 Jan 2022,ASII,5575,5600,5675,5575,5675,100
310,06 Jan 2022,HRUM,10300,0,10425,9600,10000,-300
339,06 Jan 2022,INKP,8125,8100,8350,7925,8300,175
347,06 Jan 2022,INTP,11300,11275,11300,10975,11150,-150
440,06 Jan 2022,MAPI,780,0,785,740,765,-15
630,06 Jan 2022,SIDO,910,0,930,910,925,15
736,06 Jan 2022,UNTR,21950,21850,21950,21450,21725,-225
737,06 Jan 2022,UNVR,4210,4210,4240,4180,4230,20
4,07 Jan 2022,ACES,1360,1370,1390,1350,1380,20
33,07 Jan 2022,AMRT,1155,0,1170,1145,1155,0
54,07 Jan 2022,ASII,5675,5725,5750,5650,5700,25
310,07 Jan 2022,HRUM,10000,0,10700,10025,10625,625
339,07 Jan 2022,INKP,8300,8350,8550,8200,8500,200
347,07 Jan 2022,INTP,11150,11150,11200,10950,10950,-200
440,07 Jan 2022,MAPI,765,0,775,750,765,0
630,07 Jan 2022,SIDO,925,0,970,925,950,25
736,07 Jan 2022,UNTR,21725,21900,22375,21750,22175,450
737,07 Jan 2022,UNVR,4230,4230,4240,4200,4220,-10
4,10 Jan 2022,ACES,1380,1380,1390,1365,1385,5
33,10 Jan 2022,AMRT,1155,0,1165,1130,1130,-25
54,10 Jan 2022,ASII,5700,5675,5725,5650,5650,-50
310,10 Jan 2022,HRUM,10625,0,10875,10400,10750,125
339,10 Jan 2022,INKP,8500,8575,8600,8400,8500,0
347,10 Jan 2022,INTP,10950,10950,11100,10925,10925,-25
440,10 Jan 2022,MAPI,765,0,770,750,760,-5
631,10 Jan 2022,SIDO,950,0,975,945,970,20
737,10 Jan 2022,UNTR,22175,22300,22300,21800,21800,-375
738,10 Jan 2022,UNVR,4220,4220,4290,4200,4250,30
4,11 Jan 2022,ACES,1385,1385,1390,1315,1315,-70
33,11 Jan 2022,AMRT,1130,0,1140,1075,1095,-35
54,11 Jan 2022,ASII,5650,5700,5700,5650,5700,50
310,11 Jan 2022,HRUM,10750,0,11500,10675,10900,150
339,11 Jan 2022,INKP,8500,8500,8500,8250,8275,-225
347,11 Jan 2022,INTP,10925,10950,11050,10825,10925,0
440,11 Jan 2022,MAPI,760,0,775,745,755,-5
631,11 Jan 2022,SIDO,970,0,985,940,955,-15
737,11 Jan 2022,UNTR,21800,22050,22175,21750,21750,-50
738,11 Jan 2022,UNVR,4250,4260,4270,4150,4180,-70
4,12 Jan 2022,ACES,1315,1330,1360,1300,1325,10
33,12 Jan 2022,AMRT,1095,0,1105,1090,1095,0
54,12 Jan 2022,ASII,5700,5725,5725,5650,5725,25
310,12 Jan 2022,HRUM,10900,0,11675,11000,11600,700
339,12 Jan 2022,INKP,8275,8375,8475,8275,8425,150
347,12 Jan 2022,INTP,10925,10950,11050,10850,11000,75
440,12 Jan 2022,MAPI,755,0,765,740,745,-10
631,12 Jan 2022,SIDO,955,0,960,940,950,-5
737,12 Jan 2022,UNTR,21750,22000,22275,21750,22100,350
738,12 Jan 2022,UNVR,4180,4200,4340,4180,4330,150
4,13 Jan 2022,ACES,1325,1325,1370,1325,1355,30
33,13 Jan 2022,AMRT,1095,0,1105,1090,1095,0
54,13 Jan 2022,ASII,5725,5725,5775,5675,5775,50
310,13 Jan 2022,HRUM,11600,0,11850,10850,10900,-700
339,13 Jan 2022,INKP,8425,8475,8525,8325,8475,50
347,13 Jan 2022,INTP,11000,11000,11100,10975,11075,75
440,13 Jan 2022,MAPI,745,0,750,740,745,0
631,13 Jan 2022,SIDO,950,0,960,935,935,-15
737,13 Jan 2022,UNTR,22100,22075,22675,21925,22675,575
738,13 Jan 2022,UNVR,4330,4330,4340,4240,4270,-60
4,14 Jan 2022,ACES,1355,1355,1370,1345,1370,15
33,14 Jan 2022,AMRT,1095,0,1100,1085,1090,-5
54,14 Jan 2022,ASII,5775,5775,5800,5700,5725,-50
310,14 Jan 2022,HRUM,10900,0,11075,10725,11000,100
339,14 Jan 2022,INKP,8475,8475,8500,8325,8425,-50
347,14 Jan 2022,INTP,11075,11075,11075,10975,11075,0
440,14 Jan 2022,MAPI,745,0,790,735,790,45
631,14 Jan 2022,SIDO,935,0,960,935,935,0
737,14 Jan 2022,UNTR,22675,22575,23550,22475,23525,850
738,14 Jan 2022,UNVR,4270,4280,4280,4210,4220,-50
4,17 Jan 2022,ACES,1370,1370,1375,1345,1350,-20
33,17 Jan 2022,AMRT,1090,0,1110,1085,1095,5
54,17 Jan 2022,ASII,5725,5775,5775,5650,5675,-50
310,17 Jan 2022,HRUM,11000,0,11325,10650,10900,-100
339,17 Jan 2022,INKP,8425,8450,8475,8250,8325,-100
347,17 Jan 2022,INTP,11075,11075,11075,10825,10875,-200
440,17 Jan 2022,MAPI,790,0,800,760,765,-25
631,17 Jan 2022,SIDO,935,0,950,935,945,10
737,17 Jan 2022,UNTR,23525,23550,23900,23425,23500,-25
738,17 Jan 2022,UNVR,4220,4240,4240,4140,4150,-70
4,18 Jan 2022,ACES,1350,1350,1370,1335,1345,-5
33,18 Jan 2022,AMRT,1095,0,1105,1085,1095,0
54,18 Jan 2022,ASII,5675,5675,5725,5575,5650,-25
310,18 Jan 2022,HRUM,10900,0,11100,10250,10500,-400
339,18 Jan 2022,INKP,8325,8325,8350,7850,7975,-350
347,18 Jan 2022,INTP,10875,10875,11000,10700,10875,0
440,18 Jan 2022,MAPI,765,0,780,750,765,0
631,18 Jan 2022,SIDO,945,0,955,935,950,5
737,18 Jan 2022,UNTR,23500,23500,23700,23050,23650,150
738,18 Jan 2022,UNVR,4150,4160,4230,4070,4110,-40
4,19 Jan 2022,ACES,1345,1345,1350,1310,1340,-5
33,19 Jan 2022,AMRT,1095,0,1120,1095,1120,25
54,19 Jan 2022,ASII,5650,5650,5675,5575,5600,-50
310,19 Jan 2022,HRUM,10500,0,11050,10400,10875,375
339,19 Jan 2022,INKP,7975,7950,7950,7475,7500,-475
347,19 Jan 2022,INTP,10875,10875,11000,10650,10675,-200
440,19 Jan 2022,MAPI,765,0,775,725,750,-15
631,19 Jan 2022,SIDO,950,0,965,945,950,0
737,19 Jan 2022,UNTR,23650,23650,23700,23250,23250,-400
738,19 Jan 2022,UNVR,4110,4110,4110,4080,4100,-10
4,20 Jan 2022,ACES,1340,1340,1340,1300,1300,-40
33,20 Jan 2022,AMRT,1120,0,1130,1090,1100,-20
54,20 Jan 2022,ASII,5600,5600,5625,5500,5525,-75
310,20 Jan 2022,HRUM,10875,0,11200,10900,11125,250
339,20 Jan 2022,INKP,7500,7550,7650,7500,7575,75
347,20 Jan 2022,INTP,10675,10675,10900,10600,10750,75
440,20 Jan 2022,MAPI,750,0,760,745,750,0
631,20 Jan 2022,SIDO,950,0,955,940,940,-10
737,20 Jan 2022,UNTR,23250,23100,23475,22675,22850,-400
738,20 Jan 2022,UNVR,4100,4100,4120,4070,4100,0
4,21 Jan 2022,ACES,1300,1290,1300,1270,1275,-25
33,21 Jan 2022,AMRT,1100,0,1110,1085,1095,-5
54,21 Jan 2022,ASII,5525,5525,5625,5500,5600,75
310,21 Jan 2022,HRUM,11125,0,11200,10875,10975,-150
339,21 Jan 2022,INKP,7575,7575,7900,7400,7900,325
347,21 Jan 2022,INTP,10750,10625,10850,10625,10775,25
440,21 Jan 2022,MAPI,750,0,765,735,750,0
631,21 Jan 2022,SIDO,940,0,945,935,935,-5
737,21 Jan 2022,UNTR,22850,22850,23500,22725,23500,650
738,21 Jan 2022,UNVR,4100,4090,4150,4080,4150,50
4,24 Jan 2022,ACES,1275,1280,1295,1270,1270,-5
33,24 Jan 2022,AMRT,1095,0,1105,1035,1055,-40
54,24 Jan 2022,ASII,5600,5600,5625,5525,5525,-75
310,24 Jan 2022,HRUM,10975,0,11100,10475,10700,-275
339,24 Jan 2022,INKP,7900,7875,7875,7675,7700,-200
347,24 Jan 2022,INTP,10775,10750,11125,10750,11125,350
440,24 Jan 2022,MAPI,750,0,755,725,750,0
631,24 Jan 2022,SIDO,935,0,945,930,935,0
737,24 Jan 2022,UNTR,23500,23650,23650,23225,23400,-100
738,24 Jan 2022,UNVR,4150,4130,4140,4080,4080,-70
4,25 Jan 2022,ACES,1270,1270,1285,1250,1250,-20
33,25 Jan 2022,AMRT,1055,0,1075,1020,1020,-35
54,25 Jan 2022,ASII,5525,5500,5500,5375,5450,-75
311,25 Jan 2022,HRUM,10700,0,10725,10075,10250,-450
340,25 Jan 2022,INKP,7700,7650,7725,7500,7650,-50
348,25 Jan 2022,INTP,11125,11000,11025,10800,10950,-175
441,25 Jan 2022,MAPI,750,0,760,725,735,-15
632,25 Jan 2022,SIDO,935,0,940,925,940,5
738,25 Jan 2022,UNTR,23400,23400,23450,23000,23150,-250
739,25 Jan 2022,UNVR,4080,4100,4110,4010,4060,-20
4,26 Jan 2022,ACES,1250,1250,1255,1190,1200,-50
33,26 Jan 2022,AMRT,1020,0,1185,1050,1155,135
54,26 Jan 2022,ASII,5450,5500,5500,5425,5450,0
311,26 Jan 2022,HRUM,10250,0,10800,10125,10675,425
340,26 Jan 2022,INKP,7650,7700,7725,7550,7625,-25
348,26 Jan 2022,INTP,10950,10950,11050,10850,11050,100
441,26 Jan 2022,MAPI,735,0,755,735,755,20
633,26 Jan 2022,SIDO,940,0,950,930,940,0
739,26 Jan 2022,UNTR,23150,23175,23425,22750,22775,-375
740,26 Jan 2022,UNVR,4060,4060,4130,4050,4130,70
4,27 Jan 2022,ACES,1200,1210,1255,1200,1255,55
33,27 Jan 2022,AMRT,1155,0,1230,1115,1215,60
54,27 Jan 2022,ASII,5450,5425,5525,5400,5475,25
311,27 Jan 2022,HRUM,10675,0,11075,10600,10925,250
340,27 Jan 2022,INKP,7625,7650,7650,7475,7525,-100
348,27 Jan 2022,INTP,11050,11050,11050,10850,10900,-150
441,27 Jan 2022,MAPI,755,0,755,730,735,-20
633,27 Jan 2022,SIDO,940,0,945,920,925,-15
739,27 Jan 2022,UNTR,22775,22725,23275,22525,23250,475
740,27 Jan 2022,UNVR,4130,4120,4120,4050,4060,-70
4,28 Jan 2022,ACES,1255,1260,1270,1245,1260,5
33,28 Jan 2022,AMRT,1215,0,1240,1150,1205,-10
54,28 Jan 2022,ASII,5475,5475,5525,5450,5475,0
312,28 Jan 2022,HRUM,10925,0,11200,10625,10925,0
341,28 Jan 2022,INKP,7525,7575,7600,7500,7500,-25
349,28 Jan 2022,INTP,10900,10825,11025,10750,10950,50
442,28 Jan 2022,MAPI,735,0,750,730,750,15
634,28 Jan 2022,SIDO,925,0,940,915,925,0
740,28 Jan 2022,UNTR,23250,23250,23350,23100,23250,0
741,28 Jan 2022,UNVR,4060,4060,4090,4030,4050,-10
4,31 Jan 2022,ACES,1260,1260,1265,1220,1235,-25
33,31 Jan 2022,AMRT,1205,0,1210,1160,1165,-40
54,31 Jan 2022,ASII,5475,5475,5550,5450,5475,0
312,31 Jan 2022,HRUM,10925,0,11175,10475,10625,-300
341,31 Jan 2022,INKP,7500,7575,7725,7525,7600,100
349,31 Jan 2022,INTP,10950,10975,11025,10800,10950,0
442,31 Jan 2022,MAPI,750,0,805,725,780,30
634,31 Jan 2022,SIDO,925,0,940,925,930,5
740,31 Jan 2022,UNTR,23250,23475,23500,23125,23125,-125
741,31 Jan 2022,UNVR,4050,4060,4080,4000,4030,-20
4,02 Feb 2022,ACES,1235,0,1290,1235,1270,35
33,02 Feb 2022,AMRT,1165,1160,1270,1155,1265,100
54,02 Feb 2022,ASII,5475,5500,5525,5425,5500,25
312,02 Feb 2022,HRUM,10625,10650,10850,10500,10650,25
341,02 Feb 2022,INKP,7600,7600,7825,7600,7700,100
349,02 Feb 2022,INTP,10950,10950,11100,10925,11000,50
442,02 Feb 2022,MAPI,780,0,810,765,805,25
634,02 Feb 2022,SIDO,930,0,940,930,940,10
740,02 Feb 2022,UNTR,23125,23075,23075,22650,22925,-200
741,02 Feb 2022,UNVR,4030,4030,4060,4010,4050,20
4,03 Feb 2022,ACES,1270,0,1275,1255,1255,-15
33,03 Feb 2022,AMRT,1265,1265,1270,1215,1250,-15
54,03 Feb 2022,ASII,5500,5500,5550,5450,5500,0
312,03 Feb 2022,HRUM,10650,10650,10675,10275,10400,-250
341,03 Feb 2022,INKP,7700,7700,7725,7525,7525,-175
349,03 Feb 2022,INTP,11000,11000,11025,10725,10900,-100
442,03 Feb 2022,MAPI,805,0,820,770,790,-15
634,03 Feb 2022,SIDO,940,0,940,930,935,-5
740,03 Feb 2022,UNTR,22925,22725,22925,22250,22825,-100
741,03 Feb 2022,UNVR,4050,4050,4050,4000,4010,-40
4,04 Feb 2022,ACES,1255,0,1300,1260,1285,30
33,04 Feb 2022,AMRT,1250,1250,1280,1215,1230,-20
54,04 Feb 2022,ASII,5500,5525,5525,5475,5500,0
312,04 Feb 2022,HRUM,10400,10400,10550,10375,10450,50
341,04 Feb 2022,INKP,7525,7525,7675,7475,7525,0
349,04 Feb 2022,INTP,10900,10900,11200,10825,10875,-25
442,04 Feb 2022,MAPI,790,0,785,755,760,-30
634,04 Feb 2022,SIDO,935,0,940,920,920,-15
740,04 Feb 2022,UNTR,22825,22825,22825,22375,22500,-325
741,04 Feb 2022,UNVR,4010,4020,4040,3990,4020,10
4,07 Feb 2022,ACES,1285,0,1305,1270,1275,-10
33,07 Feb 2022,AMRT,1230,1240,1265,1230,1245,15
54,07 Feb 2022,ASII,5500,5500,5525,5450,5475,-25
312,07 Feb 2022,HRUM,10450,10500,10625,10125,10150,-300
341,07 Feb 2022,INKP,7525,7525,7850,7500,7800,275
349,07 Feb 2022,INTP,10875,10900,11175,10850,11175,300
442,07 Feb 2022,MAPI,760,0,760,735,740,-20
634,07 Feb 2022,SIDO,920,0,940,920,925,5
740,07 Feb 2022,UNTR,22500,22550,22950,22425,22600,100
741,07 Feb 2022,UNVR,4020,4020,4050,4000,4000,-20
4,08 Feb 2022,ACES,1275,0,1285,1245,1245,-30
33,08 Feb 2022,AMRT,1245,1250,1275,1215,1225,-20
54,08 Feb 2022,ASII,5475,5525,5700,5500,5550,75
313,08 Feb 2022,HRUM,10150,10250,10525,10000,10475,325
342,08 Feb 2022,INKP,7800,7800,7875,7600,7600,-200
350,08 Feb 2022,INTP,11175,11175,11225,10825,10850,-325
443,08 Feb 2022,MAPI,740,0,755,730,740,0
635,08 Feb 2022,SIDO,925,0,1000,915,925,0
741,08 Feb 2022,UNTR,22600,22700,23225,22100,22175,-425
742,08 Feb 2022,UNVR,4000,4000,4080,4000,4000,0
4,09 Feb 2022,ACES,1245,0,1250,1215,1220,-25
33,09 Feb 2022,AMRT,1225,1240,1295,1230,1270,45
54,09 Feb 2022,ASII,5550,5550,5650,5475,5550,0
313,09 Feb 2022,HRUM,10475,10475,10550,10175,10225,-250
342,09 Feb 2022,INKP,7600,7200,7575,7175,7550,-50
350,09 Feb 2022,INTP,10850,11000,11000,10800,10875,25
443,09 Feb 2022,MAPI,740,0,790,740,785,45
636,09 Feb 2022,SIDO,925,0,940,925,935,10
742,09 Feb 2022,UNTR,22175,22425,22950,22400,22675,500
743,09 Feb 2022,UNVR,4000,4000,4020,3960,3960,-40
4,10 Feb 2022,ACES,1220,0,1240,1210,1230,10
33,10 Feb 2022,AMRT,1270,1275,1320,1270,1275,5
54,10 Feb 2022,ASII,5550,5575,5625,5450,5450,-100
313,10 Feb 2022,HRUM,10225,10325,10400,9750,10025,-200
342,10 Feb 2022,INKP,7550,7550,7700,7550,7600,50
350,10 Feb 2022,INTP,10875,10875,11100,10850,10850,-25
443,10 Feb 2022,MAPI,785,0,820,775,795,10
636,10 Feb 2022,SIDO,935,0,950,925,935,0
742,10 Feb 2022,UNTR,22675,22700,23200,22650,22800,125
743,10 Feb 2022,UNVR,3960,3960,4040,3960,3980,20
4,11 Feb 2022,ACES,1230,0,1240,1220,1220,-10
33,11 Feb 2022,AMRT,1275,1275,1290,1230,1235,-40
54,11 Feb 2022,ASII,5450,5450,5475,5400,5450,0
313,11 Feb 2022,HRUM,10025,10025,10050,9850,9950,-75
342,11 Feb 2022,INKP,7600,7600,7700,7500,7700,100
350,11 Feb 2022,INTP,10850,10850,10950,10750,10925,75
443,11 Feb 2022,MAPI,795,0,805,780,785,-10
636,11 Feb 2022,SIDO,935,0,945,930,945,10
742,11 Feb 2022,UNTR,22800,22775,23050,22600,23050,250
743,11 Feb 2022,UNVR,3980,3950,3960,3880,3900,-80
4,14 Feb 2022,ACES,1220,0,1230,1210,1210,-10
33,14 Feb 2022,AMRT,1235,1235,1240,1195,1225,-10
54,14 Feb 2022,ASII,5450,5400,5425,5250,5300,-150
313,14 Feb 2022,HRUM,9950,9900,10250,9750,10175,225
342,14 Feb 2022,INKP,7700,7675,7675,7500,7575,-125
350,14 Feb 2022,INTP,10925,10875,10900,10650,10775,-150
443,14 Feb 2022,MAPI,785,0,795,740,750,-35
636,14 Feb 2022,SIDO,945,0,960,930,955,10
742,14 Feb 2022,UNTR,23050,23050,23625,23000,23450,400
743,14 Feb 2022,UNVR,3900,3900,3910,3850,3850,-50
4,15 Feb 2022,ACES,1210,0,1255,1215,1245,35
33,15 Feb 2022,AMRT,1225,1220,1260,1210,1215,-10
54,15 Feb 2022,ASII,5300,5300,5525,5300,5500,200
313,15 Feb 2022,HRUM,10175,10250,10575,10225,10500,325
342,15 Feb 2022,INKP,7575,7575,7625,7525,7600,25
350,15 Feb 2022,INTP,10775,10775,10900,10750,10875,100
443,15 Feb 2022,MAPI,750,0,785,725,780,30
636,15 Feb 2022,SIDO,955,0,960,940,945,-10
742,15 Feb 2022,UNTR,23450,23500,24200,23500,24175,725
743,15 Feb 2022,UNVR,3850,3860,3880,3850,3870,20
4,16 Feb 2022,ACES,1245,0,1255,1235,1245,0
33,16 Feb 2022,AMRT,1215,1225,1230,1185,1190,-25
54,16 Feb 2022,ASII,5500,5550,5600,5475,5475,-25
313,16 Feb 2022,HRUM,10500,10700,10850,10625,10700,200
342,16 Feb 2022,INKP,7600,7650,7800,7625,7750,150
350,16 Feb 2022,INTP,10875,10825,11050,10825,10975,100
443,16 Feb 2022,MAPI,780,0,825,780,805,25
636,16 Feb 2022,SIDO,945,0,955,945,945,0
742,16 Feb 2022,UNTR,24175,24175,24225,23800,23800,-375
743,16 Feb 2022,UNVR,3870,3880,3920,3870,3870,0
4,17 Feb 2022,ACES,1245,0,1255,1215,1225,-20
33,17 Feb 2022,AMRT,1190,1190,1210,1155,1165,-25
54,17 Feb 2022,ASII,5475,5500,5525,5425,5475,0
313,17 Feb 2022,HRUM,10700,10850,10850,10225,10600,-100
342,17 Feb 2022,INKP,7750,7800,7825,7625,7650,-100
350,17 Feb 2022,INTP,10975,10975,11200,10925,11125,150
443,17 Feb 2022,MAPI,805,0,820,790,800,-5
636,17 Feb 2022,SIDO,945,0,960,945,955,10
742,17 Feb 2022,UNTR,23800,23850,24025,23500,23725,-75
743,17 Feb 2022,UNVR,3870,3880,3910,3820,3830,-40
4,18 Feb 2022,ACES,1225,0,1260,1215,1245,20
33,18 Feb 2022,AMRT,1165,1160,1215,1155,1200,35
54,18 Feb 2022,ASII,5475,5450,5625,5425,5600,125
313,18 Feb 2022,HRUM,10600,10600,10750,10475,10650,50
342,18 Feb 2022,INKP,7650,7600,8025,7600,7925,275
350,18 Feb 2022,INTP,11125,11100,11150,10925,10925,-200
443,18 Feb 2022,MAPI,800,0,845,790,840,40
636,18 Feb 2022,SIDO,955,0,980,955,955,0
742,18 Feb 2022,UNTR,23725,23675,24075,23650,23925,200
743,18 Feb 2022,UNVR,3830,3840,3900,3840,3850,20
4,21 Feb 2022,ACES,1245,0,1245,1205,1205,-40
33,21 Feb 2022,AMRT,1200,1200,1200,1155,1160,-40
54,21 Feb 2022,ASII,5600,5625,5650,5550,5575,-25
313,21 Feb 2022,HRUM,10650,10775,11275,10750,11200,550
342,21 Feb 2022,INKP,7925,7925,7975,7725,7875,-50
350,21 Feb 2022,INTP,10925,10925,11200,10900,11200,275
443,21 Feb 2022,MAPI,840,0,850,800,815,-25
636,21 Feb 2022,SIDO,955,0,970,950,955,0
742,21 Feb 2022,UNTR,23925,23975,24050,23400,23500,-425
743,21 Feb 2022,UNVR,3850,3850,3900,3850,3850,0
4,22 Feb 2022,ACES,1205,0,1215,1160,1165,-40
33,22 Feb 2022,AMRT,1160,1155,1180,1130,1150,-10
54,22 Feb 2022,ASII,5575,5525,5575,5450,5575,0
313,22 Feb 2022,HRUM,11200,11325,11800,11200,11325,125
342,22 Feb 2022,INKP,7875,7825,7875,7700,7850,-25
350,22 Feb 2022,INTP,11200,11200,11200,10925,11150,-50
443,22 Feb 2022,MAPI,815,0,815,780,800,-15
636,22 Feb 2022,SIDO,955,0,965,950,955,0
742,22 Feb 2022,UNTR,23500,23500,23650,22900,23475,-25
743,22 Feb 2022,UNVR,3850,3850,3870,3800,3810,-40
4,23 Feb 2022,ACES,1165,0,1170,1115,1120,-45
34,23 Feb 2022,AMRT,1150,1150,1170,1130,1130,-20
55,23 Feb 2022,ASII,5575,5575,5650,5525,5650,75
314,23 Feb 2022,HRUM,11325,11600,11750,11350,11675,350
343,23 Feb 2022,INKP,7850,7825,8275,7800,8250,400
351,23 Feb 2022,INTP,11150,11125,11125,10950,11000,-150
444,23 Feb 2022,MAPI,800,0,805,790,800,0
637,23 Feb 2022,SIDO,955,0,975,945,950,-5
743,23 Feb 2022,UNTR,23475,23500,24000,23200,24000,525
744,23 Feb 2022,UNVR,3810,3810,3860,3800,3820,10
4,24 Feb 2022,ACES,1120,0,1120,1060,1060,-60
34,24 Feb 2022,AMRT,1130,1125,1140,1100,1115,-15
55,24 Feb 2022,ASII,5650,5625,5775,5525,5700,50
314,24 Feb 2022,HRUM,11675,11800,12475,11500,12400,725
343,24 Feb 2022,INKP,8250,8200,8425,7800,7975,-275
351,24 Feb 2022,INTP,11000,10950,11075,10425,10475,-525
444,24 Feb 2022,MAPI,800,0,800,760,790,-10
637,24 Feb 2022,SIDO,950,0,970,945,955,5
743,24 Feb 2022,UNTR,24000,24000,25550,23950,25200,1200
744,24 Feb 2022,UNVR,3820,3810,3840,3670,3690,-130
4,25 Feb 2022,ACES,1060,0,1090,1055,1070,10
34,25 Feb 2022,AMRT,1115,1100,1130,1085,1090,-25
55,25 Feb 2022,ASII,5700,5700,5800,5650,5800,100
314,25 Feb 2022,HRUM,12400,12600,12750,12050,12275,-125
343,25 Feb 2022,INKP,7975,7975,8175,7950,8075,100
351,25 Feb 2022,INTP,10475,10500,11175,10500,10950,475
444,25 Feb 2022,MAPI,790,0,810,780,785,-5
637,25 Feb 2022,SIDO,955,0,975,945,975,20
743,25 Feb 2022,UNTR,25200,25400,25750,24600,24900,-300
744,25 Feb 2022,UNVR,3690,3700,3750,3680,3680,-10
4,01 Mar 2022,ACES,1070,0,1110,1070,1110,40
34,01 Mar 2022,AMRT,1090,1100,1115,1085,1090,0
55,01 Mar 2022,ASII,5800,5800,5950,5700,5700,-100
314,01 Mar 2022,HRUM,12275,12400,12575,11750,11800,-475
343,01 Mar 2022,INKP,8075,8075,8200,7825,7850,-225
351,01 Mar 2022,INTP,10950,11175,11400,10500,10525,-425
444,01 Mar 2022,MAPI,785,0,820,780,820,35
637,01 Mar 2022,SIDO,975,0,980,965,970,-5
743,01 Mar 2022,UNTR,24900,25050,25150,24650,24850,-50
744,01 Mar 2022,UNVR,3680,3690,3730,3670,3680,0
4,02 Mar 2022,ACES,1110,0,1110,1060,1060,-50
34,02 Mar 2022,AMRT,1090,1085,1090,1075,1090,0
55,02 Mar 2022,ASII,5700,5650,5700,5500,5525,-175
314,02 Mar 2022,HRUM,11800,12150,12200,11300,11600,-200
343,02 Mar 2022,INKP,7850,7875,7975,7675,7750,-100
351,02 Mar 2022,INTP,10525,10525,10575,10200,10200,-325
444,02 Mar 2022,MAPI,820,0,820,795,805,-15
637,02 Mar 2022,SIDO,970,0,980,965,965,-5
743,02 Mar 2022,UNTR,24850,25200,26250,25175,25525,675
744,02 Mar 2022,UNVR,3680,3680,3810,3650,3660,-20
4,04 Mar 2022,ACES,1060,0,1070,1015,1025,-35
34,04 Mar 2022,AMRT,1090,1100,1110,1080,1085,-5
55,04 Mar 2022,ASII,5525,5575,5675,5525,5625,100
314,04 Mar 2022,HRUM,11600,12000,12675,12000,12600,1000
343,04 Mar 2022,INKP,7750,7750,7800,7525,7675,-75
351,04 Mar 2022,INTP,10200,10100,10275,10000,10200,0
444,04 Mar 2022,MAPI,805,0,820,795,815,10
637,04 Mar 2022,SIDO,965,0,980,950,970,5
743,04 Mar 2022,UNTR,25525,26225,27125,25750,27075,1550
744,04 Mar 2022,UNVR,3660,3660,3670,3520,3520,-140
4,07 Mar 2022,ACES,1025,0,1035,955,960,-65
34,07 Mar 2022,AMRT,1085,1080,1150,1055,1145,60
55,07 Mar 2022,ASII,5625,5600,5825,5550,5800,175
314,07 Mar 2022,HRUM,12600,13050,13900,13050,13750,1150
343,07 Mar 2022,INKP,7675,7775,8500,7750,8450,775
351,07 Mar 2022,INTP,10200,10150,10375,10000,10200,0
444,07 Mar 2022,MAPI,815,0,830,790,800,-15
637,07 Mar 2022,SIDO,970,0,985,955,965,-5
743,07 Mar 2022,UNTR,27075,27100,27650,27100,27350,275
744,07 Mar 2022,UNVR,3520,3500,3510,3400,3430,-90
4,08 Mar 2022,ACES,960,0,1015,935,995,35
34,08 Mar 2022,AMRT,1145,1145,1155,1065,1070,-75
55,08 Mar 2022,ASII,5800,6000,6550,5975,6250,450
314,08 Mar 2022,HRUM,13750,14300,14750,12800,12800,-950
343,08 Mar 2022,INKP,8450,8550,8750,8025,8025,-425
351,08 Mar 2022,INTP,10200,10200,10225,10000,10000,-200
444,08 Mar 2022,MAPI,800,0,820,790,800,0
637,08 Mar 2022,SIDO,965,0,980,950,950,-15
743,08 Mar 2022,UNTR,27350,27400,27750,25700,25700,-1650
744,08 Mar 2022,UNVR,3430,3420,3520,3360,3360,-70
4,09 Mar 2022,ACES,995,0,1050,995,1045,50
34,09 Mar 2022,AMRT,1070,1070,1080,1020,1055,-15
55,09 Mar 2022,ASII,6250,6500,6500,6225,6300,50
314,09 Mar 2022,HRUM,12800,11925,12000,11925,11925,-875
343,09 Mar 2022,INKP,8025,8025,8325,8025,8125,100
351,09 Mar 2022,INTP,10000,10000,10150,9925,10050,50
444,09 Mar 2022,MAPI,800,0,835,790,805,5
637,09 Mar 2022,SIDO,950,0,960,935,935,-15
744,09 Mar 2022,UNTR,25700,25950,26800,25950,26400,700
745,09 Mar 2022,UNVR,3360,3370,3450,3370,3400,40
4,10 Mar 2022,ACES,1045,0,1115,1045,1110,65
34,10 Mar 2022,AMRT,1055,1070,1170,1065,1170,115
55,10 Mar 2022,ASII,6300,6300,6300,6150,6250,-50
314,10 Mar 2022,HRUM,11925,11300,11675,11100,11400,-525
343,10 Mar 2022,INKP,8125,8200,8350,8050,8200,75
351,10 Mar 2022,INTP,10050,10200,10725,10150,10700,650
444,10 Mar 2022,MAPI,805,0,870,810,855,50
638,10 Mar 2022,SIDO,935,0,970,940,970,35
746,10 Mar 2022,UNTR,26400,26400,26400,24950,25950,-450
747,10 Mar 2022,UNVR,3400,3450,3460,3370,3430,30
4,11 Mar 2022,ACES,1110,0,1110,1060,1095,-15
34,11 Mar 2022,AMRT,1170,1155,1200,1135,1195,25
55,11 Mar 2022,ASII,6250,6175,6300,6125,6275,25
314,11 Mar 2022,HRUM,11400,11400,11775,11100,11125,-275
343,11 Mar 2022,INKP,8200,8250,8300,8100,8225,25
351,11 Mar 2022,INTP,10700,10700,10700,10500,10675,-25
444,11 Mar 2022,MAPI,855,0,870,840,855,0
638,11 Mar 2022,SIDO,970,0,1000,965,1000,30
746,11 Mar 2022,UNTR,25950,25625,26900,25600,26700,750
747,11 Mar 2022,UNVR,3430,3420,3420,3370,3370,-60
4,14 Mar 2022,ACES,1095,0,1105,1075,1100,5
34,14 Mar 2022,AMRT,1195,1200,1280,1195,1280,85
55,14 Mar 2022,ASII,6275,6350,6425,6300,6375,100
314,14 Mar 2022,HRUM,11125,11150,11525,10350,10400,-725
343,14 Mar 2022,INKP,8225,8250,8425,8100,8225,0
351,14 Mar 2022,INTP,10675,10650,10775,10525,10675,0
444,14 Mar 2022,MAPI,855,0,880,840,855,0
638,14 Mar 2022,SIDO,1000,0,1035,1000,1020,20
746,14 Mar 2022,UNTR,26700,26700,26700,24850,24850,-1850
747,14 Mar 2022,UNVR,3370,3380,3410,3370,3380,10
4,15 Mar 2022,ACES,1100,0,1125,1035,1060,-40
34,15 Mar 2022,AMRT,1280,1280,1335,1265,1295,15
55,15 Mar 2022,ASII,6375,6425,6450,6275,6300,-75
314,15 Mar 2022,HRUM,10400,10500,10850,10150,10600,200
343,15 Mar 2022,INKP,8225,8225,8250,7800,7825,-400
351,15 Mar 2022,INTP,10675,10675,10800,10575,10650,-25
444,15 Mar 2022,MAPI,855,0,880,815,820,-35
638,15 Mar 2022,SIDO,1020,0,1035,1020,1030,10
746,15 Mar 2022,UNTR,24850,24850,25175,24400,24475,-375
747,15 Mar 2022,UNVR,3380,3400,3440,3280,3280,-100
4,16 Mar 2022,ACES,1060,0,1070,1015,1045,-15
34,16 Mar 2022,AMRT,1295,1295,1340,1290,1305,10
55,16 Mar 2022,ASII,6300,6325,6400,6300,6400,100
314,16 Mar 2022,HRUM,10600,10800,11000,10400,10975,375
343,16 Mar 2022,INKP,7825,7825,7950,7750,7800,-25
351,16 Mar 2022,INTP,10650,10650,10750,10550,10675,25
444,16 Mar 2022,MAPI,820,0,830,795,805,-15
638,16 Mar 2022,SIDO,1030,0,1070,1030,1040,10
746,16 Mar 2022,UNTR,24475,24475,25275,24475,25000,525
747,16 Mar 2022,UNVR,3280,3290,3540,3280,3450,170
4,17 Mar 2022,ACES,1045,0,1070,1030,1060,15
34,17 Mar 2022,AMRT,1305,1315,1380,1315,1345,40
55,17 Mar 2022,ASII,6400,6400,6475,6350,6425,25
314,17 Mar 2022,HRUM,10975,11050,11075,10500,10500,-475
343,17 Mar 2022,INKP,7800,7850,7975,7825,7875,75
351,17 Mar 2022,INTP,10675,10675,10900,10675,10800,125
444,17 Mar 2022,MAPI,805,0,850,805,835,30
638,17 Mar 2022,SIDO,1040,0,1070,1040,1050,10
746,17 Mar 2022,UNTR,25000,25225,25725,25125,25250,250
747,17 Mar 2022,UNVR,3450,3490,3520,3380,3420,-30
4,18 Mar 2022,ACES,1060,0,1070,1000,1000,-60
34,18 Mar 2022,AMRT,1345,1350,1400,1325,1360,15
55,18 Mar 2022,ASII,6425,6450,6450,6325,6400,-25
314,18 Mar 2022,HRUM,10500,10725,10900,10500,10500,0
343,18 Mar 2022,INKP,7875,7900,8000,7775,8000,125
351,18 Mar 2022,INTP,10800,10850,10975,10525,10975,175
444,18 Mar 2022,MAPI,835,0,835,805,815,-20
638,18 Mar 2022,SIDO,1050,0,1060,1030,1040,-10
746,18 Mar 2022,UNTR,25250,25475,25600,25100,25425,175
747,18 Mar 2022,UNVR,3420,3430,3440,3340,3360,-60
4,21 Mar 2022,ACES,1000,0,1025,1000,1005,5
34,21 Mar 2022,AMRT,1360,1360,1420,1360,1390,30
55,21 Mar 2022,ASII,6400,6450,6600,6450,6600,200
315,21 Mar 2022,HRUM,10500,10700,10950,10350,10900,400
344,21 Mar 2022,INKP,8000,7975,8000,7800,7925,-75
352,21 Mar 2022,INTP,10975,10875,10875,10500,10625,-350
445,21 Mar 2022,MAPI,815,0,825,800,815,0
639,21 Mar 2022,SIDO,1040,0,1050,1020,1020,-20
747,21 Mar 2022,UNTR,25425,25475,25700,24925,25350,-75
748,21 Mar 2022,UNVR,3360,3360,3470,3330,3460,100
4,22 Mar 2022,ACES,1005,0,1020,995,995,-10
34,22 Mar 2022,AMRT,1390,1390,1410,1365,1400,10
55,22 Mar 2022,ASII,6600,6600,6600,6500,6575,-25
315,22 Mar 2022,HRUM,10900,10950,11325,10850,11300,400
344,22 Mar 2022,INKP,7925,7925,8000,7875,8000,75
352,22 Mar 2022,INTP,10625,10625,10850,10625,10850,225
445,22 Mar 2022,MAPI,815,0,825,805,815,0
639,22 Mar 2022,SIDO,1020,0,1040,1020,1040,20
747,22 Mar 2022,UNTR,25350,25350,25700,25225,25550,200
748,22 Mar 2022,UNVR,3460,3460,3500,3440,3490,30
4,23 Mar 2022,ACES,995,0,1010,970,990,-5
34,23 Mar 2022,AMRT,1400,1400,1430,1365,1395,-5
55,23 Mar 2022,ASII,6575,6575,6575,6450,6475,-100
315,23 Mar 2022,HRUM,11300,11500,11500,10925,11100,-200
344,23 Mar 2022,INKP,8000,8000,8200,8000,8075,75
352,23 Mar 2022,INTP,10850,10825,10900,10750,10900,50
445,23 Mar 2022,MAPI,815,0,820,795,805,-10
639,23 Mar 2022,SIDO,1040,0,1050,1025,1045,5
747,23 Mar 2022,UNTR,25550,25600,25850,25550,25725,175
748,23 Mar 2022,UNVR,3490,3500,3510,3410,3410,-80
4,24 Mar 2022,ACES,990,0,1010,985,995,5
34,24 Mar 2022,AMRT,1395,1400,1430,1375,1420,25
55,24 Mar 2022,ASII,6475,6425,6575,6425,6575,100
315,24 Mar 2022,HRUM,11100,11350,11525,11150,11400,300
344,24 Mar 2022,INKP,8075,8075,8200,8000,8075,0
352,24 Mar 2022,INTP,10900,10750,10975,10725,10975,75
445,24 Mar 2022,MAPI,805,0,860,805,860,55
639,24 Mar 2022,SIDO,1045,0,1050,1030,1030,-15
747,24 Mar 2022,UNTR,25725,26225,27250,26200,26600,875
748,24 Mar 2022,UNVR,3410,3400,3420,3360,3380,-30
4,25 Mar 2022,ACES,995,0,1025,995,1005,10
34,25 Mar 2022,AMRT,1420,1420,1425,1355,1390,-30
55,25 Mar 2022,ASII,6575,6550,6575,6375,6400,-175
315,25 Mar 2022,HRUM,11400,11625,11850,11225,11800,400
344,25 Mar 2022,INKP,8075,8175,8175,7900,7975,-100
352,25 Mar 2022,INTP,10975,10925,10975,10625,10975,0
445,25 Mar 2022,MAPI,860,0,870,840,845,-15
639,25 Mar 2022,SIDO,1030,0,1040,1025,1035,5
747,25 Mar 2022,UNTR,26600,26600,26950,26200,26325,-275
748,25 Mar 2022,UNVR,3380,3390,3420,3380,3400,20
4,28 Mar 2022,ACES,1005,0,1015,1000,1015,10
34,28 Mar 2022,AMRT,1390,1415,1425,1350,1400,10
55,28 Mar 2022,ASII,6400,6400,6775,6400,6700,300
315,28 Mar 2022,HRUM,11800,11900,11925,11400,11400,-400
344,28 Mar 2022,INKP,7975,8025,8050,7950,8025,50
352,28 Mar 2022,INTP,10975,10925,11050,10750,10875,-100
445,28 Mar 2022,MAPI,845,0,870,825,835,-10
639,28 Mar 2022,SIDO,1035,0,1035,1010,1020,-15
747,28 Mar 2022,UNTR,26325,26325,26950,26325,26600,275
748,28 Mar 2022,UNVR,3400,3400,3490,3370,3460,60
4,29 Mar 2022,ACES,1015,0,1035,1015,1025,10
34,29 Mar 2022,AMRT,1400,1395,1470,1395,1420,20
55,29 Mar 2022,ASII,6700,6600,6700,6550,6550,-150
315,29 Mar 2022,HRUM,11400,11400,11600,10825,10975,-425
344,29 Mar 2022,INKP,8025,8050,8075,7925,7925,-100
352,29 Mar 2022,INTP,10875,10950,10950,10750,10750,-125
445,29 Mar 2022,MAPI,835,0,860,835,840,5
639,29 Mar 2022,SIDO,1020,0,1020,995,1000,-20
747,29 Mar 2022,UNTR,26600,26300,26425,26025,26025,-575
748,29 Mar 2022,UNVR,3460,3480,3560,3480,3480,20
4,30 Mar 2022,ACES,1025,0,1060,1020,1025,0
34,30 Mar 2022,AMRT,1420,1420,1480,1395,1460,40
55,30 Mar 2022,ASII,6550,6550,6650,6500,6650,100
315,30 Mar 2022,HRUM,10975,11025,11025,10525,10600,-375
344,30 Mar 2022,INKP,7925,7925,8000,7825,7850,-75
352,30 Mar 2022,INTP,10750,10850,10975,10775,10925,175
445,30 Mar 2022,MAPI,840,0,865,845,860,20
639,30 Mar 2022,SIDO,1000,0,1015,985,995,-5
747,30 Mar 2022,UNTR,26025,26000,26250,25600,25875,-150
748,30 Mar 2022,UNVR,3480,3500,3740,3500,3720,240
4,31 Mar 2022,ACES,1025,0,1035,1005,1025,0
34,31 Mar 2022,AMRT,1460,1480,1530,1470,1520,60
55,31 Mar 2022,ASII,6650,6675,6675,6575,6575,-75
315,31 Mar 2022,HRUM,10600,10800,10800,10425,10700,100
344,31 Mar 2022,INKP,7850,7950,7950,7800,7900,50
352,31 Mar 2022,INTP,10925,10950,10950,10700,10775,-150
445,31 Mar 2022,MAPI,860,0,880,850,880,20
639,31 Mar 2022,SIDO,995,0,1025,990,1020,25
747,31 Mar 2022,UNTR,25875,25875,26000,25550,25550,-325
748,31 Mar 2022,UNVR,3720,3730,3760,3650,3660,-60
4,01 Apr 2022,ACES,1025,0,1095,1025,1075,50
34,01 Apr 2022,AMRT,1520,1515,1520,1455,1485,-35
55,01 Apr 2022,ASII,6575,6775,6775,6625,6700,125
315,01 Apr 2022,HRUM,10700,10800,10900,10475,10550,-150
344,01 Apr 2022,INKP,7900,7900,7975,7825,7975,75
352,01 Apr 2022,INTP,10775,10825,10825,10625,10725,-50
445,01 Apr 2022,MAPI,880,0,880,825,840,-40
639,01 Apr 2022,SIDO,1020,0,1025,950,955,-65
747,01 Apr 2022,UNTR,25550,25775,26425,25475,25925,375
748,01 Apr 2022,UNVR,3660,3660,3690,3600,3620,-40
4,04 Apr 2022,ACES,1075,0,1120,1075,1110,35
34,04 Apr 2022,AMRT,1485,1495,1550,1490,1530,45
55,04 Apr 2022,ASII,6700,6775,6825,6675,6825,125
315,04 Apr 2022,HRUM,10550,10700,11750,10575,11700,1150
344,04 Apr 2022,INKP,7975,7975,7975,7875,7950,-25
352,04 Apr 2022,INTP,10725,10750,10875,10575,10875,150
445,04 Apr 2022,MAPI,840,0,850,830,840,0
639,04 Apr 2022,SIDO,955,0,970,940,965,10
747,04 Apr 2022,UNTR,25925,26200,26775,26050,26775,850
748,04 Apr 2022,UNVR,3620,3630,3660,3540,3570,-50
4,05 Apr 2022,ACES,1110,0,1110,1070,1075,-35
34,05 Apr 2022,AMRT,1530,1530,1580,1510,1575,45
55,05 Apr 2022,ASII,6825,6825,6900,6725,6900,75
315,05 Apr 2022,HRUM,11700,11900,12150,11500,12025,325
344,05 Apr 2022,INKP,7950,8025,8175,8025,8100,150
352,05 Apr 2022,INTP,10875,10825,10875,10650,10850,-25
445,05 Apr 2022,MAPI,840,0,865,840,855,15
639,05 Apr 2022,SIDO,965,0,975,955,960,-5
747,05 Apr 2022,UNTR,26775,26800,27200,26550,27200,425
748,05 Apr 2022,UNVR,3570,3570,3690,3570,3680,110
4,06 Apr 2022,ACES,1075,0,1090,1065,1075,0
34,06 Apr 2022,AMRT,1575,1595,1755,1580,1705,130
55,06 Apr 2022,ASII,6900,6825,7000,6800,7000,100
315,06 Apr 2022,HRUM,12025,12100,12625,12050,12475,450
344,06 Apr 2022,INKP,8100,8150,8250,8000,8000,-100
352,06 Apr 2022,INTP,10850,10700,10800,10500,10500,-350
445,06 Apr 2022,MAPI,855,0,855,825,855,0
639,06 Apr 2022,SIDO,960,0,975,940,940,-20
747,06 Apr 2022,UNTR,27200,27250,27475,27200,27450,250
748,06 Apr 2022,UNVR,3680,3680,3680,3560,3600,-80
4,07 Apr 2022,ACES,1075,0,1110,1070,1095,20
34,07 Apr 2022,AMRT,1705,1750,1750,1590,1615,-90
55,07 Apr 2022,ASII,7000,6950,7000,6850,6900,-100
315,07 Apr 2022,HRUM,12475,12550,12850,12150,12400,-75
344,07 Apr 2022,INKP,8000,8000,8050,7875,7875,-125
352,07 Apr 2022,INTP,10500,10525,10675,10400,10450,-50
445,07 Apr 2022,MAPI,855,0,850,815,845,-10
639,07 Apr 2022,SIDO,940,0,950,930,940,0
747,07 Apr 2022,UNTR,27450,27475,27775,27150,27150,-300
748,07 Apr 2022,UNVR,3600,3600,3640,3550,3570,-30
4,08 Apr 2022,ACES,1095,0,1115,1080,1085,-10
34,08 Apr 2022,AMRT,1615,1615,1730,1615,1695,80
55,08 Apr 2022,ASII,6900,7000,7075,6900,7000,100
315,08 Apr 2022,HRUM,12400,12550,13425,12475,12900,500
344,08 Apr 2022,INKP,7875,7875,7975,7850,7925,50
352,08 Apr 2022,INTP,10450,10450,10575,10400,10450,0
445,08 Apr 2022,MAPI,845,0,850,830,845,0
640,08 Apr 2022,SIDO,940,0,940,920,935,-5
748,08 Apr 2022,UNTR,27150,27350,29000,27350,28600,1450
749,08 Apr 2022,UNVR,3570,3590,3600,3520,3540,-30
4,11 Apr 2022,ACES,1085,0,1100,1050,1065,-20
34,11 Apr 2022,AMRT,1695,1695,1700,1630,1675,-20
55,11 Apr 2022,ASII,7000,6975,7000,6750,6850,-150
316,11 Apr 2022,HRUM,12900,12900,13350,12675,12700,-200
345,11 Apr 2022,INKP,7925,7925,7975,7750,7775,-150
353,11 Apr 2022,INTP,10450,10400,10450,10125,10125,-325
446,11 Apr 2022,MAPI,845,0,880,840,875,30
641,11 Apr 2022,SIDO,935,0,940,900,905,-30
749,11 Apr 2022,UNTR,28600,28700,29125,28225,28450,-150
750,11 Apr 2022,UNVR,3540,3570,3570,3450,3460,-80
4,12 Apr 2022,ACES,1065,0,1175,1060,1160,95
34,12 Apr 2022,AMRT,1675,1680,1775,1680,1755,80
55,12 Apr 2022,ASII,6850,6875,6950,6825,6950,100
316,12 Apr 2022,HRUM,12700,12625,13350,12250,13200,500
345,12 Apr 2022,INKP,7775,7775,7850,7625,7800,25
353,12 Apr 2022,INTP,10125,10125,10250,9975,10225,100
446,12 Apr 2022,MAPI,875,0,915,875,910,35
641,12 Apr 2022,SIDO,905,0,935,900,905,0
750,12 Apr 2022,UNTR,28450,28450,28675,27800,27950,-500
751,12 Apr 2022,UNVR,3460,3460,3520,3410,3520,60
4,13 Apr 2022,ACES,1160,0,1175,1130,1170,10
34,13 Apr 2022,AMRT,1755,1760,1760,1690,1700,-55
55,13 Apr 2022,ASII,6950,6950,7000,6875,6975,25
316,13 Apr 2022,HRUM,13200,13500,13950,13375,13550,350
345,13 Apr 2022,INKP,7800,7800,7800,7650,7700,-100
353,13 Apr 2022,INTP,10225,10200,10200,9975,10175,-50
446,13 Apr 2022,MAPI,910,0,935,875,890,-20
641,13 Apr 2022,SIDO,905,0,925,905,905,0
750,13 Apr 2022,UNTR,27950,28500,29300,28300,29275,1325
751,13 Apr 2022,UNVR,3520,3520,3520,3410,3440,-80
4,14 Apr 2022,ACES,1170,0,1185,1125,1145,-25
34,14 Apr 2022,AMRT,1700,1700,1730,1685,1720,20
55,14 Apr 2022,ASII,6975,6975,7050,6875,6875,-100
316,14 Apr 2022,HRUM,13550,13625,13700,13450,13600,50
345,14 Apr 2022,INKP,7700,7700,7725,7600,7625,-75
353,14 Apr 2022,INTP,10175,10075,10175,10000,10050,-125
446,14 Apr 2022,MAPI,890,0,910,880,890,0
641,14 Apr 2022,SIDO,905,0,925,905,910,5
750,14 Apr 2022,UNTR,29275,29500,30000,29300,29800,525
751,14 Apr 2022,UNVR,3440,3430,3460,3400,3400,-40
4,18 Apr 2022,ACES,1145,0,1155,1125,1145,0
34,18 Apr 2022,AMRT,1720,1720,1730,1700,1705,-15
55,18 Apr 2022,ASII,6875,6900,7050,6900,7000,125
316,18 Apr 2022,HRUM,13600,13725,14125,13675,14075,475
345,18 Apr 2022,INKP,7625,7650,7700,7525,7600,-25
353,18 Apr 2022,INTP,10050,10075,10250,10000,10025,-25
446,18 Apr 2022,MAPI,890,0,930,885,890,0
641,18 Apr 2022,SIDO,910,0,920,910,915,5
750,18 Apr 2022,UNTR,29800,29800,30000,29400,30000,200
751,18 Apr 2022,UNVR,3400,3400,3440,3370,3390,-10
4,19 Apr 2022,ACES,1145,0,1150,1070,1075,-70
34,19 Apr 2022,AMRT,1705,1705,1715,1690,1690,-15
55,19 Apr 2022,ASII,7000,7050,7050,6800,6900,-100
316,19 Apr 2022,HRUM,14075,14075,14200,13675,13750,-325
345,19 Apr 2022,INKP,7600,7600,7700,7550,7600,0
353,19 Apr 2022,INTP,10025,10025,10350,10025,10275,250
446,19 Apr 2022,MAPI,890,0,910,880,905,15
641,19 Apr 2022,SIDO,915,0,930,910,930,15
750,19 Apr 2022,UNTR,30000,30025,30300,29425,29600,-400
751,19 Apr 2022,UNVR,3390,3390,3410,3350,3350,-40
4,20 Apr 2022,ACES,1075,0,1120,1070,1095,20
34,20 Apr 2022,AMRT,1690,1695,1760,1695,1740,50
55,20 Apr 2022,ASII,6900,6900,6975,6825,6900,0
316,20 Apr 2022,HRUM,13750,14000,14300,13650,13850,100
345,20 Apr 2022,INKP,7600,7625,7675,7550,7600,0
353,20 Apr 2022,INTP,10275,10300,10375,10125,10225,-50
446,20 Apr 2022,MAPI,905,0,925,885,885,-20
642,20 Apr 2022,SIDO,930,0,940,925,940,10
751,20 Apr 2022,UNTR,29600,29100,29100,28300,28350,-1250
752,20 Apr 2022,UNVR,3350,3390,3510,3370,3470,120
4,21 Apr 2022,ACES,1095,0,1100,1070,1075,-20
34,21 Apr 2022,AMRT,1740,1735,1740,1645,1705,-35
55,21 Apr 2022,ASII,6900,6925,7100,6900,7000,100
316,21 Apr 2022,HRUM,13850,13900,13900,12900,12900,-950
345,21 Apr 2022,INKP,7600,7650,7800,7575,7600,0
353,21 Apr 2022,INTP,10225,10225,10350,10100,10150,-75
446,21 Apr 2022,MAPI,885,0,920,885,920,35
642,21 Apr 2022,SIDO,940,0,950,930,930,-10
751,21 Apr 2022,UNTR,28350,28350,29150,28050,28125,-225
752,21 Apr 2022,UNVR,3470,3470,3500,3400,3400,-70
4,22 Apr 2022,ACES,1075,0,1075,1035,1065,-10
34,22 Apr 2022,AMRT,1705,1705,1730,1700,1710,5
55,22 Apr 2022,ASII,7000,6975,7100,6875,7050,50
316,22 Apr 2022,HRUM,12900,12800,12925,12375,12575,-325
345,22 Apr 2022,INKP,7600,7600,7675,7525,7550,-50
353,22 Apr 2022,INTP,10150,10150,10175,10025,10150,0
446,22 Apr 2022,MAPI,920,0,930,905,920,0
642,22 Apr 2022,SIDO,930,0,940,925,935,5
751,22 Apr 2022,UNTR,28125,28125,28700,27825,28300,175
752,22 Apr 2022,UNVR,3400,3400,3440,3370,3430,30
4,25 Apr 2022,ACES,1065,0,1070,1045,1050,-15
34,25 Apr 2022,AMRT,1710,1690,1740,1650,1695,-15
55,25 Apr 2022,ASII,7050,7050,7150,6875,7075,25
316,25 Apr 2022,HRUM,12575,12425,12450,11925,11925,-650
346,25 Apr 2022,INKP,7550,7525,7575,7450,7500,-50
354,25 Apr 2022,INTP,10150,10100,10275,10025,10125,-25
447,25 Apr 2022,MAPI,920,0,940,895,920,0
643,25 Apr 2022,SIDO,935,0,940,915,920,-15
752,25 Apr 2022,UNTR,28300,28200,28200,27325,27625,-675
753,25 Apr 2022,UNVR,3430,3420,3720,3400,3690,260
4,26 Apr 2022,ACES,1050,0,1055,1020,1040,-10
34,26 Apr 2022,AMRT,1695,1695,1745,1675,1685,-10
55,26 Apr 2022,ASII,7075,7100,7200,7000,7200,125
316,26 Apr 2022,HRUM,11925,11925,12150,11100,11100,-825
346,26 Apr 2022,INKP,7500,7500,7550,7350,7400,-100
354,26 Apr 2022,INTP,10125,10125,10575,10125,10475,350
447,26 Apr 2022,MAPI,920,0,935,910,920,0
643,26 Apr 2022,SIDO,920,0,940,910,940,20
752,26 Apr 2022,UNTR,27625,27650,28750,27650,28750,1125
753,26 Apr 2022,UNVR,3690,3720,3930,3690,3890,200
4,27 Apr 2022,ACES,1040,0,1045,1020,1030,-10
34,27 Apr 2022,AMRT,1685,1685,1715,1675,1705,20
55,27 Apr 2022,ASII,7200,7175,7200,7050,7125,-75
316,27 Apr 2022,HRUM,11100,11100,11625,10600,11500,400
346,27 Apr 2022,INKP,7400,7400,7525,7350,7425,25
354,27 Apr 2022,INTP,10475,10475,10550,10325,10425,-50
447,27 Apr 2022,MAPI,920,0,930,900,920,0
643,27 Apr 2022,SIDO,940,0,950,930,940,0
752,27 Apr 2022,UNTR,28750,28850,29100,28750,28900,150
753,27 Apr 2022,UNVR,3890,3890,3900,3770,3810,-80
4,28 Apr 2022,ACES,1030,0,1055,1025,1045,15
34,28 Apr 2022,AMRT,1705,1715,1725,1700,1710,5
55,28 Apr 2022,ASII,7125,7250,7700,7225,7575,450
316,28 Apr 2022,HRUM,11500,11725,11850,11275,11525,25
346,28 Apr 2022,INKP,7425,7425,7625,7425,7575,150
354,28 Apr 2022,INTP,10425,10500,10675,10400,10475,50
447,28 Apr 2022,MAPI,920,0,915,895,900,-20
643,28 Apr 2022,SIDO,940,0,945,935,940,0
752,28 Apr 2022,UNTR,28900,30000,30800,29825,30275,1375
753,28 Apr 2022,UNVR,3810,3830,3920,3770,3890,80
4,09 Mei 2022,ACES,1045,0,1045,985,990,-55
34,09 Mei 2022,AMRT,1710,1680,1740,1625,1670,-40
55,09 Mei 2022,ASII,7575,7425,7425,7050,7050,-525
316,09 Mei 2022,HRUM,11525,11750,11775,10725,11000,-525
346,09 Mei 2022,INKP,7575,7450,7475,7225,7325,-250
354,09 Mei 2022,INTP,10475,10450,10450,9850,10000,-475
447,09 Mei 2022,MAPI,900,0,910,865,905,5
643,09 Mei 2022,SIDO,940,0,950,920,940,0
752,09 Mei 2022,UNTR,30275,31775,31875,28825,29225,-1050
753,09 Mei 2022,UNVR,3890,4000,4140,3890,4010,120
4,10 Mei 2022,ACES,990,0,1025,955,995,5
34,10 Mei 2022,AMRT,1670,1670,1670,1555,1555,-115
55,10 Mei 2022,ASII,7050,6650,7000,6625,7000,-50
316,10 Mei 2022,HRUM,11000,10500,10550,10250,10250,-750
346,10 Mei 2022,INKP,7325,7300,7550,7125,7500,175
354,10 Mei 2022,INTP,10000,10000,10150,9800,10025,25
447,10 Mei 2022,MAPI,905,0,915,845,905,0
643,10 Mei 2022,SIDO,940,0,945,910,935,-5
752,10 Mei 2022,UNTR,29225,28750,29925,28025,29625,400
753,10 Mei 2022,UNVR,4010,4010,4400,3990,4380,370
4,11 Mei 2022,ACES,995,0,1035,1000,1025,30
34,11 Mei 2022,AMRT,1555,1545,1615,1450,1615,60
55,11 Mei 2022,ASII,7000,7025,7225,6900,6900,-100
316,11 Mei 2022,HRUM,10250,10375,10775,10150,10350,100
346,11 Mei 2022,INKP,7500,7500,7650,7425,7600,100
354,11 Mei 2022,INTP,10025,10075,10600,10075,10500,475
447,11 Mei 2022,MAPI,905,0,930,875,925,20
643,11 Mei 2022,SIDO,935,0,940,920,920,-15
752,11 Mei 2022,UNTR,29625,29625,30400,29625,30225,600
753,11 Mei 2022,UNVR,4380,4400,4940,4380,4880,500
4,12 Mei 2022,ACES,1025,0,1035,970,970,-55
34,12 Mei 2022,AMRT,1615,1610,1615,1505,1505,-110
55,12 Mei 2022,ASII,6900,6900,7025,6725,6850,-50
316,12 Mei 2022,HRUM,10350,10350,10500,9850,10000,-350
346,12 Mei 2022,INKP,7600,7600,7600,7225,7275,-325
354,12 Mei 2022,INTP,10500,10450,10450,10100,10150,-350
447,12 Mei 2022,MAPI,925,0,925,865,865,-60
643,12 Mei 2022,SIDO,920,0,930,900,900,-20
752,12 Mei 2022,UNTR,30225,29625,30200,28925,29300,-925
753,12 Mei 2022,UNVR,4880,4920,4940,4580,4690,-190
4,13 Mei 2022,ACES,970,0,1010,960,990,20
34,13 Mei 2022,AMRT,1505,1595,1675,1430,1575,70
55,13 Mei 2022,ASII,6850,6900,7225,6850,7125,275
316,13 Mei 2022,HRUM,10000,10300,10725,9950,10525,525
346,13 Mei 2022,INKP,7275,7275,7475,7200,7325,50
354,13 Mei 2022,INTP,10150,9450,9800,9450,9650,-500
447,13 Mei 2022,MAPI,865,0,905,835,890,25
643,13 Mei 2022,SIDO,900,0,925,900,925,25
752,13 Mei 2022,UNTR,29300,29300,30325,29300,30225,925
753,13 Mei 2022,UNVR,4690,4690,4900,4660,4800,110
4,17 Mei 2022,ACES,990,0,1025,1000,1015,25
34,17 Mei 2022,AMRT,1575,1600,1710,1600,1650,75
55,17 Mei 2022,ASII,7125,7250,7300,7000,7000,-125
316,17 Mei 2022,HRUM,10525,10700,10975,10600,10975,450
346,17 Mei 2022,INKP,7325,7400,7725,7350,7675,350
354,17 Mei 2022,INTP,9650,9650,9750,9375,9600,-50
447,17 Mei 2022,MAPI,890,0,910,865,865,-25
644,17 Mei 2022,SIDO,925,0,930,920,925,0
753,17 Mei 2022,UNTR,30225,30250,30775,29825,30075,-150
754,17 Mei 2022,UNVR,4800,4810,4900,4660,4800,0
4,18 Mei 2022,ACES,1015,0,1030,1000,1015,0
34,18 Mei 2022,AMRT,1650,1675,1750,1665,1705,55
55,18 Mei 2022,ASII,7000,6975,7200,6925,7100,100
316,18 Mei 2022,HRUM,10975,11150,11175,10700,10975,0
346,18 Mei 2022,INKP,7675,7675,7750,7575,7700,25
354,18 Mei 2022,INTP,9600,9650,9900,9500,9900,300
447,18 Mei 2022,MAPI,865,0,900,865,900,35
644,18 Mei 2022,SIDO,925,0,940,920,930,5
753,18 Mei 2022,UNTR,30075,30300,30400,30000,30300,225
754,18 Mei 2022,UNVR,4800,4820,5075,4810,5025,225
4,19 Mei 2022,ACES,1015,0,1020,980,1020,5
34,19 Mei 2022,AMRT,1705,1675,1745,1610,1700,-5
55,19 Mei 2022,ASII,7100,6925,7125,6850,7000,-100
316,19 Mei 2022,HRUM,10975,10500,10825,10375,10700,-275
346,19 Mei 2022,INKP,7700,7600,7650,7425,7525,-175
354,19 Mei 2022,INTP,9900,9800,9825,9550,9825,-75
447,19 Mei 2022,MAPI,900,0,890,840,845,-55
644,19 Mei 2022,SIDO,930,0,965,920,965,35
753,19 Mei 2022,UNTR,30300,30175,30175,29350,29975,-325
754,19 Mei 2022,UNVR,5025,4960,5000,4850,4880,-145
4,20 Mei 2022,ACES,1020,0,1025,990,1010,-10
34,20 Mei 2022,AMRT,1700,1730,1845,1730,1775,75
55,20 Mei 2022,ASII,7000,7050,7200,7050,7125,125
316,20 Mei 2022,HRUM,10700,10900,11250,10850,11050,350
346,20 Mei 2022,INKP,7525,7550,7850,7550,7625,100
354,20 Mei 2022,INTP,9825,9825,10000,9775,9900,75
447,20 Mei 2022,MAPI,845,0,865,820,845,0
644,20 Mei 2022,SIDO,965,0,970,950,960,-5
753,20 Mei 2022,UNTR,29975,29725,30500,29700,29900,-75
754,20 Mei 2022,UNVR,4880,4870,5125,4860,5050,170
4,23 Mei 2022,ACES,1010,0,1025,985,995,-15
34,23 Mei 2022,AMRT,1775,1785,1795,1660,1740,-35
55,23 Mei 2022,ASII,7125,7125,7175,6825,6950,-175
316,23 Mei 2022,HRUM,11050,11250,11300,10800,10900,-150
346,23 Mei 2022,INKP,7625,7725,7875,7650,7825,200
354,23 Mei 2022,INTP,9900,10000,10150,9950,10075,175
447,23 Mei 2022,MAPI,845,0,910,850,890,45
644,23 Mei 2022,SIDO,960,0,970,945,960,0
753,23 Mei 2022,UNTR,29900,30025,30150,29200,29650,-250
754,23 Mei 2022,UNVR,5050,5050,5075,4850,4880,-170
4,24 Mei 2022,ACES,995,0,995,960,975,-20
34,24 Mei 2022,AMRT,1740,1750,1785,1675,1695,-45
55,24 Mei 2022,ASII,6950,7025,7200,7025,7150,200
316,24 Mei 2022,HRUM,10900,10900,11150,10825,11075,175
346,24 Mei 2022,INKP,7825,7900,7925,7725,7775,-50
354,24 Mei 2022,INTP,10075,10150,10275,10100,10200,125
447,24 Mei 2022,MAPI,890,0,900,875,900,10
644,24 Mei 2022,SIDO,960,0,965,940,945,-15
753,24 Mei 2022,UNTR,29650,29650,30325,29625,30300,650
754,24 Mei 2022,UNVR,4880,4920,4950,4700,4810,-70
4,25 Mei 2022,ACES,975,0,1025,975,980,5
34,25 Mei 2022,AMRT,1695,1690,1800,1690,1755,60
55,25 Mei 2022,ASII,7150,7100,7175,7050,7100,-50
316,25 Mei 2022,HRUM,11075,11000,11000,10400,10425,-650
346,25 Mei 2022,INKP,7775,7825,7825,7575,7675,-100
354,25 Mei 2022,INTP,10200,10200,10225,10050,10200,0
447,25 Mei 2022,MAPI,900,0,900,875,895,-5
644,25 Mei 2022,SIDO,945,0,960,945,960,15
753,25 Mei 2022,UNTR,30300,30225,30800,29750,30175,-125
754,25 Mei 2022,UNVR,4810,4860,4900,4730,4770,-40
4,27 Mei 2022,ACES,980,0,1000,975,985,5
34,27 Mei 2022,AMRT,1755,1785,1815,1690,1690,-65
56,27 Mei 2022,ASII,7100,7200,7300,7150,7225,125
317,27 Mei 2022,HRUM,10425,10625,11425,10525,11425,1000
347,27 Mei 2022,INKP,7675,7750,7775,7625,7725,50
355,27 Mei 2022,INTP,10200,10275,10575,10275,10350,150
448,27 Mei 2022,MAPI,895,0,925,890,915,20
645,27 Mei 2022,SIDO,960,0,970,950,965,5
754,27 Mei 2022,UNTR,30175,30325,30400,30125,30400,225
755,27 Mei 2022,UNVR,4770,4800,4840,4710,4760,-10
4,30 Mei 2022,ACES,985,0,1010,980,1000,15
34,30 Mei 2022,AMRT,1690,1710,1760,1680,1690,0
56,30 Mei 2022,ASII,7225,7275,7275,7125,7250,25
317,30 Mei 2022,HRUM,11425,11500,11600,11150,11450,25
347,30 Mei 2022,INKP,7725,7775,8150,7750,8050,325
355,30 Mei 2022,INTP,10350,10350,10575,10200,10225,-125
448,30 Mei 2022,MAPI,915,0,920,890,900,-15
645,30 Mei 2022,SIDO,965,0,970,965,965,0
754,30 Mei 2022,UNTR,30400,30700,30875,29925,30250,-150
755,30 Mei 2022,UNVR,4760,4760,4760,4620,4650,-110
4,31 Mei 2022,ACES,1000,0,1010,960,960,-40
34,31 Mei 2022,AMRT,1690,1730,1820,1640,1820,130
56,31 Mei 2022,ASII,7250,7250,7475,7250,7350,100
317,31 Mei 2022,HRUM,11450,11625,11925,11500,11875,425
347,31 Mei 2022,INKP,8050,8125,8300,7950,8250,200
355,31 Mei 2022,INTP,10225,10225,10300,9725,9725,-500
448,31 Mei 2022,MAPI,900,0,905,890,900,0
645,31 Mei 2022,SIDO,965,0,1020,965,1020,55
754,31 Mei 2022,UNTR,30250,30500,31975,30300,31300,1050
755,31 Mei 2022,UNVR,4650,4680,4820,4630,4730,80
4,02 Jun 2022,ACES,960,0,1000,970,985,25
34,02 Jun 2022,AMRT,1820,1850,1900,1780,1800,-20
56,02 Jun 2022,ASII,7350,7300,7500,7250,7325,-25
317,02 Jun 2022,HRUM,2380,2380,2400,2300,2310,-70
347,02 Jun 2022,INKP,8250,8250,8475,8225,8425,175
355,02 Jun 2022,INTP,9725,9800,9925,9675,9850,125
448,02 Jun 2022,MAPI,900,0,910,890,895,-5
645,02 Jun 2022,SIDO,1020,0,1020,975,1000,-20
754,02 Jun 2022,UNTR,31300,31975,32500,30975,31625,325
755,02 Jun 2022,UNVR,4730,4760,4890,4710,4790,60
4,03 Jun 2022,ACES,985,0,1010,985,1000,15
34,03 Jun 2022,AMRT,1800,1810,1860,1795,1815,15
56,03 Jun 2022,ASII,7325,7350,7475,7300,7300,-25
317,03 Jun 2022,HRUM,2310,2310,2440,2230,2410,100
347,03 Jun 2022,INKP,8425,8450,8500,8250,8275,-150
355,03 Jun 2022,INTP,9850,9975,9975,9750,9800,-50
448,03 Jun 2022,MAPI,895,0,960,895,935,40
645,03 Jun 2022,SIDO,1000,0,1010,985,985,-15
754,03 Jun 2022,UNTR,31625,32450,32725,31600,32600,975
755,03 Jun 2022,UNVR,4790,4810,4810,4720,4720,-70
4,06 Jun 2022,ACES,1000,0,1005,970,980,-20
34,06 Jun 2022,AMRT,1815,1815,1845,1790,1820,5
56,06 Jun 2022,ASII,7300,7200,7250,7075,7225,-75
317,06 Jun 2022,HRUM,2410,2410,2470,2310,2330,-80
347,06 Jun 2022,INKP,8275,8275,8425,8100,8175,-100
355,06 Jun 2022,INTP,9800,9825,9950,9775,9900,100
448,06 Jun 2022,MAPI,935,0,985,930,960,25
645,06 Jun 2022,SIDO,985,0,995,980,990,5
754,06 Jun 2022,UNTR,32600,32600,32700,31825,32175,-425
755,06 Jun 2022,UNVR,4720,4720,4780,4700,4770,50
4,07 Jun 2022,ACES,980,0,990,980,990,10
34,07 Jun 2022,AMRT,1820,1815,1850,1805,1810,-10
56,07 Jun 2022,ASII,7225,7300,7400,7200,7200,-25
317,07 Jun 2022,HRUM,2330,2370,2380,2310,2330,0
347,07 Jun 2022,INKP,8175,8175,8450,8175,8200,25
355,07 Jun 2022,INTP,9900,9500,9650,9425,9550,-350
448,07 Jun 2022,MAPI,960,0,980,940,950,-10
645,07 Jun 2022,SIDO,990,0,995,980,985,-5
754,07 Jun 2022,UNTR,32175,32700,33375,32500,32825,650
755,07 Jun 2022,UNVR,4770,4770,4780,4720,4730,-40
4,08 Jun 2022,ACES,990,0,990,975,985,-5
34,08 Jun 2022,AMRT,1810,1815,1850,1815,1850,40
56,08 Jun 2022,ASII,7200,7150,7350,7150,7175,-25
317,08 Jun 2022,HRUM,2330,2330,2340,2170,2180,-150
347,08 Jun 2022,INKP,8200,8275,8400,8200,8350,150
355,08 Jun 2022,INTP,9550,9550,9725,9475,9650,100
448,08 Jun 2022,MAPI,950,0,985,950,965,15
645,08 Jun 2022,SIDO,985,0,995,975,985,0
754,08 Jun 2022,UNTR,32825,33275,33300,32775,33050,225
755,08 Jun 2022,UNVR,4730,4740,4970,4730,4890,160
4,09 Jun 2022,ACES,985,0,990,930,945,-40
34,09 Jun 2022,AMRT,1850,1865,1865,1805,1855,5
56,09 Jun 2022,ASII,7175,7150,7350,7150,7200,25
317,09 Jun 2022,HRUM,2180,2180,2230,2150,2180,0
347,09 Jun 2022,INKP,8350,8350,8450,8250,8275,-75
355,09 Jun 2022,INTP,9650,9675,9700,9500,9500,-150
448,09 Jun 2022,MAPI,965,0,970,940,950,-15
645,09 Jun 2022,SIDO,985,0,985,975,975,-10
754,09 Jun 2022,UNTR,33050,33050,33075,32275,32400,-650
755,09 Jun 2022,UNVR,4890,4900,4930,4760,4820,-70
4,10 Jun 2022,ACES,945,0,945,910,915,-30
34,10 Jun 2022,AMRT,1855,1840,1840,1765,1795,-60
56,10 Jun 2022,ASII,7200,7100,7175,6925,6925,-275
317,10 Jun 2022,HRUM,2180,2140,2160,2080,2100,-80
347,10 Jun 2022,INKP,8275,8225,8425,8100,8375,100
355,10 Jun 2022,INTP,9500,9500,9525,9350,9400,-100
448,10 Jun 2022,MAPI,950,0,960,915,925,-25
645,10 Jun 2022,SIDO,975,0,980,965,975,0
754,10 Jun 2022,UNTR,32400,32400,32700,32000,32200,-200
755,10 Jun 2022,UNVR,4820,4780,4790,4720,4750,-70
4,13 Jun 2022,ACES,915,0,915,875,880,-35
34,13 Jun 2022,AMRT,1795,1795,1815,1740,1770,-25
56,13 Jun 2022,ASII,6925,6900,7100,6725,7025,100
317,13 Jun 2022,HRUM,2100,2000,2050,1965,2020,-80
347,13 Jun 2022,INKP,8375,8200,8250,8000,8200,-175
355,13 Jun 2022,INTP,9400,9350,9350,9025,9150,-250
448,13 Jun 2022,MAPI,925,0,920,880,900,-25
645,13 Jun 2022,SIDO,975,0,990,945,960,-15
754,13 Jun 2022,UNTR,32200,32025,32025,30175,30675,-1525
755,13 Jun 2022,UNVR,4750,4690,4700,4600,4690,-60
4,14 Jun 2022,ACES,880,0,905,875,885,5
34,14 Jun 2022,AMRT,1770,1775,1840,1770,1835,65
56,14 Jun 2022,ASII,7025,6875,7000,6875,6975,-50
317,14 Jun 2022,HRUM,2020,2000,2070,1960,2020,0
347,14 Jun 2022,INKP,8200,8125,8250,7950,8000,-200
355,14 Jun 2022,INTP,9150,9125,9275,9075,9225,75
448,14 Jun 2022,MAPI,900,0,910,880,890,-10
645,14 Jun 2022,SIDO,960,0,960,945,945,-15
754,14 Jun 2022,UNTR,30675,30400,31550,30100,31550,875
755,14 Jun 2022,UNVR,4690,4640,4740,4610,4740,50
4,15 Jun 2022,ACES,885,0,890,860,860,-25
34,15 Jun 2022,AMRT,1835,1830,1835,1775,1795,-40
56,15 Jun 2022,ASII,6975,6975,6975,6700,6700,-275
317,15 Jun 2022,HRUM,2020,2020,2030,1880,1885,-135
347,15 Jun 2022,INKP,8000,8000,8075,7800,7800,-200
355,15 Jun 2022,INTP,9225,9225,9300,9100,9100,-125
448,15 Jun 2022,MAPI,890,0,905,885,900,10
645,15 Jun 2022,SIDO,945,0,955,935,950,5
754,15 Jun 2022,UNTR,31550,31550,31625,29700,29750,-1800
755,15 Jun 2022,UNVR,4740,4750,4810,4690,4800,60
4,16 Jun 2022,ACES,860,0,885,850,850,-10
34,16 Jun 2022,AMRT,1795,1820,1840,1795,1830,35
56,16 Jun 2022,ASII,6700,6850,6950,6750,6850,150
317,16 Jun 2022,HRUM,1885,1930,1960,1840,1860,-25
347,16 Jun 2022,INKP,7800,7950,8200,7925,8100,300
355,16 Jun 2022,INTP,9100,9150,9300,9150,9200,100
448,16 Jun 2022,MAPI,900,0,940,900,910,10
645,16 Jun 2022,SIDO,950,0,970,945,950,0
754,16 Jun 2022,UNTR,29750,30100,30900,29950,30000,250
755,16 Jun 2022,UNVR,4800,4850,4850,4730,4800,0
4,17 Jun 2022,ACES,850,0,840,800,805,-45
34,17 Jun 2022,AMRT,1830,1820,1830,1790,1805,-25
56,17 Jun 2022,ASII,6850,6675,6950,6675,6950,100
317,17 Jun 2022,HRUM,1860,1815,1815,1730,1730,-130
347,17 Jun 2022,INKP,8100,8000,8050,7875,7925,-175
355,17 Jun 2022,INTP,9200,9100,9250,9050,9250,50
448,17 Jun 2022,MAPI,910,0,915,860,875,-35
645,17 Jun 2022,SIDO,950,0,960,945,960,10
754,17 Jun 2022,UNTR,30000,29525,29550,28800,28800,-1200
755,17 Jun 2022,UNVR,4800,4760,4800,4650,4650,-150
4,20 Jun 2022,ACES,805,0,815,750,775,-30
34,20 Jun 2022,AMRT,1805,1805,1820,1790,1800,-5
56,20 Jun 2022,ASII,6950,6950,6975,6750,6925,-25
317,20 Jun 2022,HRUM,1730,1750,1755,1640,1680,-50
347,20 Jun 2022,INKP,7925,7925,7950,7700,7800,-125
355,20 Jun 2022,INTP,9250,9250,9275,9075,9200,-50
448,20 Jun 2022,MAPI,875,0,920,870,900,25
645,20 Jun 2022,SIDO,960,0,970,945,965,5
754,20 Jun 2022,UNTR,28800,28800,29125,28525,29000,200
755,20 Jun 2022,UNVR,4650,4680,5025,4660,5025,375
4,21 Jun 2022,ACES,775,0,800,760,765,-10
34,21 Jun 2022,AMRT,1800,1830,1835,1810,1830,30
56,21 Jun 2022,ASII,6925,6900,6975,6850,6850,-75
317,21 Jun 2022,HRUM,1680,1745,1765,1695,1725,45
347,21 Jun 2022,INKP,7800,7800,7900,7750,7775,-25
355,21 Jun 2022,INTP,9200,9225,9400,9200,9400,200
448,21 Jun 2022,MAPI,900,0,930,890,900,0
645,21 Jun 2022,SIDO,965,0,970,945,955,-10
754,21 Jun 2022,UNTR,29000,29500,29725,28825,29150,150
755,21 Jun 2022,UNVR,5025,5050,5100,4950,5050,25
4,22 Jun 2022,ACES,765,0,785,720,770,5
34,22 Jun 2022,AMRT,1830,1835,1960,1815,1960,130
56,22 Jun 2022,ASII,6850,6850,6925,6775,6800,-50
317,22 Jun 2022,HRUM,1725,1725,1780,1645,1655,-70
347,22 Jun 2022,INKP,7775,7800,7950,7625,7775,0
355,22 Jun 2022,INTP,9400,9350,9425,9275,9275,-125
448,22 Jun 2022,MAPI,900,0,910,890,895,-5
645,22 Jun 2022,SIDO,955,0,975,955,975,20
754,22 Jun 2022,UNTR,29150,29200,29525,29000,29200,50
755,22 Jun 2022,UNVR,5050,5050,5050,4860,4890,-160
4,23 Jun 2022,ACES,770,0,780,760,770,0
34,23 Jun 2022,AMRT,1960,1960,2040,1915,1990,30
56,23 Jun 2022,ASII,6800,6850,6875,6750,6875,75
317,23 Jun 2022,HRUM,1655,1650,1685,1585,1675,20
347,23 Jun 2022,INKP,7775,7750,7775,7600,7750,-25
355,23 Jun 2022,INTP,9275,9275,9500,9200,9500,225
448,23 Jun 2022,MAPI,895,0,910,880,900,5
645,23 Jun 2022,SIDO,975,0,985,970,985,10
754,23 Jun 2022,UNTR,29200,29450,29450,28650,29275,75
755,23 Jun 2022,UNVR,4890,4900,5000,4860,4960,70
4,24 Jun 2022,ACES,770,0,810,770,780,10
34,24 Jun 2022,AMRT,1990,1990,2020,1945,1990,0
56,24 Jun 2022,ASII,6875,6900,6900,6650,6675,-200
317,24 Jun 2022,HRUM,1675,1680,1695,1640,1675,0
347,24 Jun 2022,INKP,7750,7750,7775,7650,7725,-25
355,24 Jun 2022,INTP,9500,9500,9825,9450,9775,275
448,24 Jun 2022,MAPI,900,0,915,885,915,15
645,24 Jun 2022,SIDO,985,0,1000,980,990,5
754,24 Jun 2022,UNTR,29275,29400,29700,29075,29275,0
755,24 Jun 2022,UNVR,4960,4930,4990,4870,4990,30
4,27 Jun 2022,ACES,780,0,805,780,800,20
34,27 Jun 2022,AMRT,1990,2000,2000,1910,1985,-5
56,27 Jun 2022,ASII,6675,6700,6750,6550,6650,-25
317,27 Jun 2022,HRUM,1675,1625,1645,1565,1585,-90
347,27 Jun 2022,INKP,7725,7750,7900,7725,7900,175
355,27 Jun 2022,INTP,9775,9775,9800,9525,9750,-25
448,27 Jun 2022,MAPI,915,0,920,900,910,-5
645,27 Jun 2022,SIDO,990,0,1005,980,985,-5
754,27 Jun 2022,UNTR,29275,29500,29600,28975,29200,-75
755,27 Jun 2022,UNVR,4990,4990,5000,4900,4980,-10
4,28 Jun 2022,ACES,800,0,805,780,790,-10
34,28 Jun 2022,AMRT,1985,1985,1985,1920,1985,0
56,28 Jun 2022,ASII,6650,6650,6700,6600,6700,50
317,28 Jun 2022,HRUM,1585,1595,1625,1580,1610,25
347,28 Jun 2022,INKP,7900,7900,7950,7750,7775,-125
355,28 Jun 2022,INTP,9750,9725,9725,9450,9625,-125
448,28 Jun 2022,MAPI,910,0,955,910,925,15
645,28 Jun 2022,SIDO,985,0,995,985,995,10
754,28 Jun 2022,UNTR,29200,29400,29875,29300,29800,600
755,28 Jun 2022,UNVR,4980,4980,5075,4960,5050,70
4,29 Jun 2022,ACES,790,0,795,775,785,-5
34,29 Jun 2022,AMRT,1985,1985,1995,1975,1990,5
56,29 Jun 2022,ASII,6700,6625,6700,6500,6500,-200
317,29 Jun 2022,HRUM,1610,1610,1615,1535,1550,-60
347,29 Jun 2022,INKP,7775,7750,7825,7700,7700,-75
355,29 Jun 2022,INTP,9625,9550,9675,9425,9500,-125
448,29 Jun 2022,MAPI,925,0,990,925,965,40
645,29 Jun 2022,SIDO,995,0,1010,980,995,0
754,29 Jun 2022,UNTR,29800,29700,29700,28500,28525,-1275
755,29 Jun 2022,UNVR,5050,5000,5050,4910,4940,-110
4,30 Jun 2022,ACES,785,0,795,770,770,-15
34,30 Jun 2022,AMRT,1990,2000,2090,1990,2040,50
56,30 Jun 2022,ASII,6500,6525,6650,6500,6625,125
317,30 Jun 2022,HRUM,1550,1560,1590,1520,1545,-5
347,30 Jun 2022,INKP,7700,7700,7800,7600,7600,-100
355,30 Jun 2022,INTP,9500,9600,9700,9300,9475,-25
448,30 Jun 2022,MAPI,965,0,990,960,980,15
645,30 Jun 2022,SIDO,995,0,1000,985,1000,5
754,30 Jun 2022,UNTR,28525,28400,28750,28200,28400,-125
755,30 Jun 2022,UNVR,4940,4950,4980,4750,4770,-170
4,01 Jul 2022,ACES,770,0,785,770,775,5
34,01 Jul 2022,AMRT,2040,2040,2050,1990,2010,-30
56,01 Jul 2022,ASII,6625,6675,6675,6500,6525,-100
317,01 Jul 2022,HRUM,1545,1535,1555,1440,1440,-105
347,01 Jul 2022,INKP,7600,7600,7600,7400,7425,-175
355,01 Jul 2022,INTP,9475,9475,9500,9250,9400,-75
448,01 Jul 2022,MAPI,980,0,980,915,915,-65
645,01 Jul 2022,SIDO,1000,0,1000,975,990,-10
754,01 Jul 2022,UNTR,28400,28400,28600,26425,26500,-1900
755,01 Jul 2022,UNVR,4770,4750,4860,4690,4830,60
4,04 Jul 2022,ACES,775,0,780,725,725,-50
34,04 Jul 2022,AMRT,2010,2010,2020,1920,1920,-90
56,04 Jul 2022,ASII,6525,6500,6575,6300,6500,-25
317,04 Jul 2022,HRUM,1440,1415,1455,1375,1380,-60
347,04 Jul 2022,INKP,7425,7425,7525,7225,7450,25
355,04 Jul 2022,INTP,9400,9400,9425,9125,9200,-200
448,04 Jul 2022,MAPI,915,0,935,880,900,-15
645,04 Jul 2022,SIDO,990,0,990,955,985,-5
754,04 Jul 2022,UNTR,26500,26500,27350,26125,26525,25
755,04 Jul 2022,UNVR,4830,4800,4820,4550,4700,-130
4,05 Jul 2022,ACES,725,0,760,720,750,25
34,05 Jul 2022,AMRT,1920,1920,1995,1920,1980,60
56,05 Jul 2022,ASII,6500,6500,6525,6325,6325,-175
317,05 Jul 2022,HRUM,1380,1410,1520,1410,1500,120
347,05 Jul 2022,INKP,7450,7475,7600,7400,7400,-50
355,05 Jul 2022,INTP,9200,9250,9325,9175,9225,25
448,05 Jul 2022,MAPI,900,0,915,890,900,0
645,05 Jul 2022,SIDO,985,0,990,975,975,-10
754,05 Jul 2022,UNTR,26525,26875,28175,26875,27975,1450
755,05 Jul 2022,UNVR,4700,4700,4780,4680,4760,60
4,06 Jul 2022,ACES,750,0,760,740,755,5
34,06 Jul 2022,AMRT,1980,1980,2030,1960,2030,50
56,06 Jul 2022,ASII,6325,6300,6400,6050,6075,-250
317,06 Jul 2022,HRUM,1500,1500,1525,1445,1470,-30
347,06 Jul 2022,INKP,7400,7450,7475,7250,7325,-75
355,06 Jul 2022,INTP,9225,9225,9325,9025,9325,100
448,06 Jul 2022,MAPI,900,0,920,885,900,0
645,06 Jul 2022,SIDO,975,0,990,975,980,5
754,06 Jul 2022,UNTR,27975,27875,27875,26375,26800,-1175
755,06 Jul 2022,UNVR,4760,4740,4830,4710,4780,20
4,07 Jul 2022,ACES,755,0,775,755,765,10
34,07 Jul 2022,AMRT,2030,2030,2040,1900,1900,-130
56,07 Jul 2022,ASII,6075,6025,6125,5900,5950,-125
317,07 Jul 2022,HRUM,1470,1470,1500,1420,1450,-20
347,07 Jul 2022,INKP,7325,7325,7375,7225,7275,-50
355,07 Jul 2022,INTP,9325,9325,9325,9100,9125,-200
448,07 Jul 2022,MAPI,900,0,925,890,925,25
645,07 Jul 2022,SIDO,980,0,990,975,985,5
755,07 Jul 2022,UNTR,26800,26775,26925,26350,26775,-25
756,07 Jul 2022,UNVR,4780,4820,5025,4800,5000,220
4,08 Jul 2022,ACES,765,0,800,765,795,30
34,08 Jul 2022,AMRT,1900,1900,2030,1895,1900,0
57,08 Jul 2022,ASII,5950,6025,6075,5950,5975,25
319,08 Jul 2022,HRUM,1450,1495,1530,1470,1500,50
349,08 Jul 2022,INKP,7275,7325,7350,7250,7275,0
357,08 Jul 2022,INTP,9125,9200,9250,9050,9175,50
450,08 Jul 2022,MAPI,925,0,930,905,910,-15
647,08 Jul 2022,SIDO,985,0,985,970,970,-15
758,08 Jul 2022,UNTR,26775,27200,27600,26925,27450,675
759,08 Jul 2022,UNVR,5000,5025,5025,4810,4890,-110
4,11 Jul 2022,ACES,795,0,805,760,775,-20
34,11 Jul 2022,AMRT,1900,1910,2000,1910,1920,20
57,11 Jul 2022,ASII,5975,5975,6075,5925,6050,75
319,11 Jul 2022,HRUM,1500,1505,1520,1460,1510,10
349,11 Jul 2022,INKP,7275,7275,7550,7275,7525,250
357,11 Jul 2022,INTP,9175,9075,9125,9025,9125,-50
450,11 Jul 2022,MAPI,910,0,925,890,895,-15
647,11 Jul 2022,SIDO,970,0,990,970,980,10
758,11 Jul 2022,UNTR,27450,27450,27450,26900,27225,-225
759,11 Jul 2022,UNVR,4890,4900,4910,4750,4800,-90
4,12 Jul 2022,ACES,775,0,780,765,770,-5
34,12 Jul 2022,AMRT,1920,1930,1970,1920,1930,10
57,12 Jul 2022,ASII,6050,6050,6150,6050,6100,50
319,12 Jul 2022,HRUM,1510,1525,1535,1495,1510,0
349,12 Jul 2022,INKP,7525,7525,7550,7400,7475,-50
357,12 Jul 2022,INTP,9125,9125,9125,9000,9075,-50
450,12 Jul 2022,MAPI,895,0,915,890,895,0
647,12 Jul 2022,SIDO,980,0,985,965,980,0
758,12 Jul 2022,UNTR,27225,27250,27750,26775,26925,-300
759,12 Jul 2022,UNVR,4800,4800,4880,4770,4880,80
4,13 Jul 2022,ACES,770,0,780,750,750,-20
34,13 Jul 2022,AMRT,1930,1945,1945,1900,1935,5
57,13 Jul 2022,ASII,6100,6100,6100,5825,5825,-275
319,13 Jul 2022,HRUM,1510,1515,1520,1465,1480,-30
349,13 Jul 2022,INKP,7475,7500,7500,7400,7500,25
357,13 Jul 2022,INTP,9075,9075,9100,9000,9025,-50
450,13 Jul 2022,MAPI,895,0,900,850,850,-45
647,13 Jul 2022,SIDO,980,0,980,950,955,-25
758,13 Jul 2022,UNTR,26925,27750,28450,27600,28275,1350
759,13 Jul 2022,UNVR,4880,4900,4920,4820,4900,20
4,14 Jul 2022,ACES,750,0,760,735,745,-5
34,14 Jul 2022,AMRT,1935,1935,1950,1910,1945,10
57,14 Jul 2022,ASII,5825,5825,6100,5825,6100,275
319,14 Jul 2022,HRUM,1480,1470,1510,1450,1485,5
349,14 Jul 2022,INKP,7500,7475,7625,7350,7625,125
357,14 Jul 2022,INTP,9025,9000,9075,8975,9050,25
450,14 Jul 2022,MAPI,850,0,895,830,870,20
647,14 Jul 2022,SIDO,955,0,975,950,970,15
758,14 Jul 2022,UNTR,28275,28300,29975,28300,29800,1525
759,14 Jul 2022,UNVR,4900,4900,4900,4800,4900,0
4,15 Jul 2022,ACES,745,0,765,740,745,0
34,15 Jul 2022,AMRT,1945,1940,1940,1860,1860,-85
57,15 Jul 2022,ASII,6100,6000,6075,5925,5950,-150
319,15 Jul 2022,HRUM,1485,1450,1450,1385,1385,-100
349,15 Jul 2022,INKP,7625,7625,7625,7425,7450,-175
357,15 Jul 2022,INTP,9050,9050,9350,9025,9125,75
450,15 Jul 2022,MAPI,870,0,900,880,895,25
647,15 Jul 2022,SIDO,970,0,975,960,965,-5
758,15 Jul 2022,UNTR,29800,29700,29700,28925,29025,-775
759,15 Jul 2022,UNVR,4900,4900,4930,4820,4830,-70
4,18 Jul 2022,ACES,745,0,755,730,730,-15
34,18 Jul 2022,AMRT,1860,1855,1870,1785,1850,-10
57,18 Jul 2022,ASII,5950,5975,6025,5950,6025,75
320,18 Jul 2022,HRUM,1385,1385,1395,1335,1360,-25
350,18 Jul 2022,INKP,7450,7475,7650,7375,7650,200
358,18 Jul 2022,INTP,9125,9250,9300,9200,9275,150
451,18 Jul 2022,MAPI,895,0,905,870,880,-15
648,18 Jul 2022,SIDO,965,0,970,950,960,-5
759,18 Jul 2022,UNTR,29025,28950,29100,28625,28850,-175
760,18 Jul 2022,UNVR,4830,4870,4980,4830,4980,150
4,19 Jul 2022,ACES,730,0,760,705,755,25
34,19 Jul 2022,AMRT,1850,1850,1890,1830,1860,10
57,19 Jul 2022,ASII,6025,6025,6150,6025,6075,50
320,19 Jul 2022,HRUM,1360,1370,1515,1370,1510,150
350,19 Jul 2022,INKP,7650,7650,7650,7525,7650,0
358,19 Jul 2022,INTP,9275,9275,9375,9175,9375,100
451,19 Jul 2022,MAPI,880,0,920,875,920,40
648,19 Jul 2022,SIDO,960,0,960,955,960,0
759,19 Jul 2022,UNTR,28850,28825,29325,28600,29100,250
760,19 Jul 2022,UNVR,4980,4970,4990,4890,4970,-10
4,20 Jul 2022,ACES,755,0,770,740,740,-15
34,20 Jul 2022,AMRT,1860,1890,1890,1815,1850,-10
57,20 Jul 2022,ASII,6075,6175,6275,6100,6275,200
321,20 Jul 2022,HRUM,1510,1550,1585,1530,1580,70
351,20 Jul 2022,INKP,7650,7650,7725,7575,7600,-50
359,20 Jul 2022,INTP,9375,9350,9375,9300,9325,-50
452,20 Jul 2022,MAPI,920,0,980,915,940,20
649,20 Jul 2022,SIDO,960,0,990,960,970,10
760,20 Jul 2022,UNTR,29100,29600,30350,29575,30175,1075
761,20 Jul 2022,UNVR,4970,4990,5100,4950,4970,0
4,21 Jul 2022,ACES,740,0,750,725,730,-10
34,21 Jul 2022,AMRT,1850,1850,1855,1800,1835,-15
57,21 Jul 2022,ASII,6275,6200,6250,6050,6175,-100
321,21 Jul 2022,HRUM,1580,1580,1590,1535,1545,-35
351,21 Jul 2022,INKP,7600,7600,7800,7575,7800,200
359,21 Jul 2022,INTP,9325,9375,9400,9325,9400,75
452,21 Jul 2022,MAPI,940,0,960,915,915,-25
649,21 Jul 2022,SIDO,970,0,990,965,985,15
760,21 Jul 2022,UNTR,30175,30100,30200,29675,30000,-175
761,21 Jul 2022,UNVR,4970,4970,5000,4890,5000,30
4,22 Jul 2022,ACES,730,0,735,715,720,-10
34,22 Jul 2022,AMRT,1835,1835,1910,1830,1875,40
57,22 Jul 2022,ASII,6175,6175,6175,6050,6075,-100
321,22 Jul 2022,HRUM,1545,1560,1630,1555,1625,80
351,22 Jul 2022,INKP,7800,7800,7800,7675,7725,-75
359,22 Jul 2022,INTP,9400,9375,9525,9325,9450,50
452,22 Jul 2022,MAPI,915,0,935,900,920,5
649,22 Jul 2022,SIDO,985,0,990,970,975,-10
760,22 Jul 2022,UNTR,30000,30000,30225,29850,30075,75
761,22 Jul 2022,UNVR,5000,5000,5000,4940,5000,0
4,25 Jul 2022,ACES,720,0,730,710,715,-5
34,25 Jul 2022,AMRT,1875,1885,1885,1860,1885,10
57,25 Jul 2022,ASII,6075,6050,6150,6050,6075,0
321,25 Jul 2022,HRUM,1625,1635,1660,1580,1600,-25
351,25 Jul 2022,INKP,7725,7725,7750,7650,7650,-75
359,25 Jul 2022,INTP,9450,9325,9425,9225,9275,-175
453,25 Jul 2022,MAPI,920,0,940,920,940,20
650,25 Jul 2022,SIDO,975,0,985,970,980,5
761,25 Jul 2022,UNTR,30075,30075,30750,30075,30575,500
762,25 Jul 2022,UNVR,5000,4980,4980,4920,4930,-70
4,26 Jul 2022,ACES,715,0,725,700,700,-15
34,26 Jul 2022,AMRT,1885,1885,1890,1870,1890,5
57,26 Jul 2022,ASII,6075,6100,6125,6075,6100,25
322,26 Jul 2022,HRUM,1600,1615,1655,1610,1635,35
352,26 Jul 2022,INKP,7650,7650,7725,7600,7650,0
360,26 Jul 2022,INTP,9275,9275,9300,9150,9200,-75
454,26 Jul 2022,MAPI,940,0,940,910,920,-20
651,26 Jul 2022,SIDO,980,0,985,970,970,-10
762,26 Jul 2022,UNTR,30575,30625,30675,30375,30600,25
763,26 Jul 2022,UNVR,4930,4930,4950,4900,4930,0
4,27 Jul 2022,ACES,700,0,710,685,710,10
34,27 Jul 2022,AMRT,1890,1900,1920,1875,1910,20
57,27 Jul 2022,ASII,6100,6125,6125,6000,6100,0
322,27 Jul 2022,HRUM,1635,1650,1760,1625,1730,95
352,27 Jul 2022,INKP,7650,7650,7700,7575,7675,25
360,27 Jul 2022,INTP,9200,9200,9225,9100,9200,0
454,27 Jul 2022,MAPI,920,0,930,905,910,-10
651,27 Jul 2022,SIDO,970,0,990,970,975,5
762,27 Jul 2022,UNTR,30600,30625,31375,30500,31100,500
763,27 Jul 2022,UNVR,4930,4950,5025,4710,4720,-210
4,28 Jul 2022,ACES,710,0,725,705,705,-5
34,28 Jul 2022,AMRT,1910,1925,1925,1840,1885,-25
57,28 Jul 2022,ASII,6100,6125,6150,6025,6050,-50
322,28 Jul 2022,HRUM,1730,1780,1855,1745,1845,115
352,28 Jul 2022,INKP,7675,7675,7875,7675,7800,125
360,28 Jul 2022,INTP,9200,9225,9275,9175,9200,0
454,28 Jul 2022,MAPI,910,0,920,880,880,-30
651,28 Jul 2022,SIDO,975,0,990,970,970,-5
762,28 Jul 2022,UNTR,31100,31425,31475,30725,31300,200
763,28 Jul 2022,UNVR,4720,4720,4770,4500,4510,-210
4,29 Jul 2022,ACES,705,0,720,700,710,5
34,29 Jul 2022,AMRT,1885,1880,1885,1855,1875,-10
57,29 Jul 2022,ASII,6050,6150,6425,6125,6325,275
322,29 Jul 2022,HRUM,1845,1845,1875,1805,1845,0
352,29 Jul 2022,INKP,7800,7850,7875,7600,7600,-200
360,29 Jul 2022,INTP,9200,9225,9325,9150,9300,100
454,29 Jul 2022,MAPI,880,0,905,880,890,10
651,29 Jul 2022,SIDO,970,0,975,905,905,-65
762,29 Jul 2022,UNTR,31300,33000,33500,32225,32300,1000
763,29 Jul 2022,UNVR,4510,4520,4560,4480,4510,0
4,01 Agt 2022,ACES,710,0,720,695,700,-10
34,01 Agt 2022,AMRT,1875,1890,1910,1860,1880,5
57,01 Agt 2022,ASII,6325,6425,6550,6350,6475,150
322,01 Agt 2022,HRUM,1845,1900,1950,1875,1945,100
352,01 Agt 2022,INKP,7600,7600,7700,7425,7600,0
360,01 Agt 2022,INTP,9300,9300,9325,9100,9125,-175
454,01 Agt 2022,MAPI,890,0,930,890,930,40
651,01 Agt 2022,SIDO,905,0,905,845,845,-60
762,01 Agt 2022,UNTR,32300,32150,32950,32075,32175,-125
763,01 Agt 2022,UNVR,4510,4530,4650,4510,4550,40
4,02 Agt 2022,ACES,700,0,710,690,690,-10
34,02 Agt 2022,AMRT,1880,1900,1920,1890,1920,40
57,02 Agt 2022,ASII,6475,6475,6475,6275,6475,0
322,02 Agt 2022,HRUM,1945,1945,1950,1810,1810,-135
352,02 Agt 2022,INKP,7600,7575,7675,7500,7675,75
360,02 Agt 2022,INTP,9125,9125,9225,9125,9150,25
454,02 Agt 2022,MAPI,930,0,1000,895,1000,70
652,02 Agt 2022,SIDO,845,0,835,790,790,-55
763,02 Agt 2022,UNTR,32175,32400,33000,32325,32875,700
764,02 Agt 2022,UNVR,4550,4550,4610,4530,4600,50
4,03 Agt 2022,ACES,690,0,695,655,655,-35
34,03 Agt 2022,AMRT,1920,1930,1950,1895,1950,30
57,03 Agt 2022,ASII,6475,6450,6600,6375,6600,125
323,03 Agt 2022,HRUM,1810,1775,1835,1725,1785,-25
353,03 Agt 2022,INKP,7675,7600,7700,7575,7675,0
361,03 Agt 2022,INTP,9150,9200,9275,9075,9100,-50
455,03 Agt 2022,MAPI,1000,0,980,930,930,-70
653,03 Agt 2022,SIDO,790,0,820,740,765,-25
764,03 Agt 2022,UNTR,32875,32625,34000,32625,33950,1075
765,03 Agt 2022,UNVR,4600,4600,4600,4550,4590,-10
4,04 Agt 2022,ACES,655,0,665,650,650,-5
35,04 Agt 2022,AMRT,1950,1950,1950,1865,1875,-75
58,04 Agt 2022,ASII,6600,6700,6700,6450,6600,0
324,04 Agt 2022,HRUM,1785,1795,1815,1725,1730,-55
354,04 Agt 2022,INKP,7675,7650,7800,7625,7800,125
362,04 Agt 2022,INTP,9100,0,9650,9175,9625,525
457,04 Agt 2022,MAPI,930,0,945,915,930,0
655,04 Agt 2022,SIDO,765,0,795,765,770,5
766,04 Agt 2022,UNTR,33950,33950,34050,33100,33200,-750
767,04 Agt 2022,UNVR,4590,4590,4610,4530,4600,10
4,05 Agt 2022,ACES,650,0,705,650,690,40
35,05 Agt 2022,AMRT,1875,1870,1890,1810,1850,-25
58,05 Agt 2022,ASII,6600,6600,6650,6475,6625,25
324,05 Agt 2022,HRUM,1730,1725,1785,1700,1760,30
354,05 Agt 2022,INKP,7800,7775,7925,7700,7800,0
362,05 Agt 2022,INTP,9625,9750,9800,9525,9700,75
457,05 Agt 2022,MAPI,930,0,975,935,960,30
656,05 Agt 2022,SIDO,770,0,780,755,760,-10
767,05 Agt 2022,UNTR,33200,33150,33150,32275,32500,-700
768,05 Agt 2022,UNVR,4600,4650,4740,4620,4720,120
4,08 Agt 2022,ACES,690,0,730,690,705,15
35,08 Agt 2022,AMRT,1850,1855,1875,1820,1850,0
58,08 Agt 2022,ASII,6625,6625,6700,6525,6700,75
326,08 Agt 2022,HRUM,1760,1760,1795,1730,1775,15
356,08 Agt 2022,INKP,7800,7800,7800,7675,7800,0
364,08 Agt 2022,INTP,9700,9700,9850,9700,9750,50
460,08 Agt 2022,MAPI,960,0,1060,970,980,20
660,08 Agt 2022,SIDO,760,0,775,730,750,-10
771,08 Agt 2022,UNTR,32500,32500,32750,32275,32400,-100
772,08 Agt 2022,UNVR,4720,4740,4800,4730,4790,70
4,09 Agt 2022,ACES,705,0,730,710,715,10
35,09 Agt 2022,AMRT,1850,1850,1855,1825,1825,-25
58,09 Agt 2022,ASII,6700,6725,6825,6700,6750,50
327,09 Agt 2022,HRUM,1775,1800,1825,1790,1800,25
357,09 Agt 2022,INKP,7800,7800,7875,7775,7775,-25
365,09 Agt 2022,INTP,9750,9775,9875,9650,9650,-100
462,09 Agt 2022,MAPI,980,0,1040,975,985,5
662,09 Agt 2022,SIDO,750,0,780,750,775,25
774,09 Agt 2022,UNTR,32400,32700,33675,32375,32375,-25
775,09 Agt 2022,UNVR,4790,4800,4800,4720,4720,-70
4,10 Agt 2022,ACES,715,0,730,710,720,5
35,10 Agt 2022,AMRT,1825,1835,1855,1810,1840,15
58,10 Agt 2022,ASII,6750,6775,6850,6600,6850,100
328,10 Agt 2022,HRUM,1800,1805,1815,1770,1775,-25
358,10 Agt 2022,INKP,7775,7775,7800,7650,7775,0
366,10 Agt 2022,INTP,9650,9650,9725,9450,9725,75
463,10 Agt 2022,MAPI,985,0,1000,955,965,-20
664,10 Agt 2022,SIDO,775,0,780,770,770,-5
776,10 Agt 2022,UNTR,32375,32675,33075,32300,32350,-25
777,10 Agt 2022,UNVR,4720,4720,4780,4660,4780,60
4,11 Agt 2022,ACES,720,0,730,705,720,0
35,11 Agt 2022,AMRT,1840,1845,1875,1825,1840,0
58,11 Agt 2022,ASII,6850,6975,7000,6900,6950,100
328,11 Agt 2022,HRUM,1775,1825,1840,1790,1790,15
358,11 Agt 2022,INKP,7775,7800,7825,7675,7725,-50
366,11 Agt 2022,INTP,9725,9725,9775,9675,9675,-50
463,11 Agt 2022,MAPI,965,0,1010,970,980,15
664,11 Agt 2022,SIDO,770,0,780,765,765,-5
776,11 Agt 2022,UNTR,32350,32950,32950,31900,31900,-450
777,11 Agt 2022,UNVR,4780,4790,4800,4740,4750,-30
4,12 Agt 2022,ACES,720,0,745,720,740,20
35,12 Agt 2022,AMRT,1840,1840,1850,1785,1850,10
58,12 Agt 2022,ASII,6950,6950,7000,6850,6950,0
328,12 Agt 2022,HRUM,1790,1795,1805,1755,1765,-25
358,12 Agt 2022,INKP,7725,7750,7975,7725,7800,75
366,12 Agt 2022,INTP,9675,9700,9825,9525,9750,75
463,12 Agt 2022,MAPI,980,0,1035,980,1020,40
664,12 Agt 2022,SIDO,765,0,775,765,770,5
776,12 Agt 2022,UNTR,31900,31600,31850,31225,31600,-300
777,12 Agt 2022,UNVR,4750,4750,4850,4750,4770,20
4,15 Agt 2022,ACES,740,0,765,725,730,-10
35,15 Agt 2022,AMRT,1850,1850,1855,1825,1830,-20
58,15 Agt 2022,ASII,6950,6925,6950,6800,6875,-75
328,15 Agt 2022,HRUM,1765,1765,1775,1685,1690,-75
358,15 Agt 2022,INKP,7800,7825,7950,7825,7875,75
366,15 Agt 2022,INTP,9750,9750,9750,9550,9550,-200
463,15 Agt 2022,MAPI,1020,0,1040,1015,1020,0
664,15 Agt 2022,SIDO,770,0,785,770,775,5
776,15 Agt 2022,UNTR,31600,31700,32675,31675,32500,900
777,15 Agt 2022,UNVR,4770,4770,4780,4710,4760,-10
4,16 Agt 2022,ACES,730,0,740,715,735,5
35,16 Agt 2022,AMRT,1830,1840,1950,1840,1950,120
58,16 Agt 2022,ASII,6875,6875,7050,6875,6975,100
328,16 Agt 2022,HRUM,1690,1685,1690,1625,1630,-60
358,16 Agt 2022,INKP,7875,7950,7950,7850,7900,25
366,16 Agt 2022,INTP,9550,9575,9600,9450,9500,-50
463,16 Agt 2022,MAPI,1020,0,1075,1010,1025,5
664,16 Agt 2022,SIDO,775,0,780,770,770,-5
776,16 Agt 2022,UNTR,32500,32600,32775,32025,32400,-100
777,16 Agt 2022,UNVR,4760,4780,4810,4710,4770,10
4,18 Agt 2022,ACES,735,0,740,715,720,-15
35,18 Agt 2022,AMRT,1950,1950,1990,1935,1990,40
58,18 Agt 2022,ASII,6975,6975,7000,6850,6975,0
328,18 Agt 2022,HRUM,1630,1630,1705,1630,1675,45
358,18 Agt 2022,INKP,7900,7900,7975,7875,7950,50
366,18 Agt 2022,INTP,9500,9500,9525,9300,9300,-200
463,18 Agt 2022,MAPI,1025,0,1075,1020,1065,40
664,18 Agt 2022,SIDO,770,0,780,765,775,5
776,18 Agt 2022,UNTR,32400,31925,32175,31725,32000,-400
777,18 Agt 2022,UNVR,4770,4800,4810,4730,4790,20
4,19 Agt 2022,ACES,720,0,745,720,745,25
35,19 Agt 2022,AMRT,1990,1990,2090,1990,2090,100
58,19 Agt 2022,ASII,6975,6975,7000,6900,6975,0
328,19 Agt 2022,HRUM,1675,1695,1695,1665,1665,-10
358,19 Agt 2022,INKP,7950,7950,8050,7875,8000,50
366,19 Agt 2022,INTP,9300,9225,9250,9150,9200,-100
463,19 Agt 2022,MAPI,1065,0,1105,1060,1070,5
664,19 Agt 2022,SIDO,775,0,780,770,770,-5
776,19 Agt 2022,UNTR,32000,31925,32100,31650,31650,-350
777,19 Agt 2022,UNVR,4790,4810,4830,4730,4730,-60
4,22 Agt 2022,ACES,745,0,760,735,750,5
35,22 Agt 2022,AMRT,2090,2090,2100,2040,2090,0
58,22 Agt 2022,ASII,6975,6875,6925,6800,6925,-50
328,22 Agt 2022,HRUM,1665,1655,1660,1575,1580,-85
358,22 Agt 2022,INKP,8000,8000,8000,7800,7925,-75
366,22 Agt 2022,INTP,9200,9200,9300,9150,9225,25
463,22 Agt 2022,MAPI,1070,0,1080,1000,1020,-50
664,22 Agt 2022,SIDO,770,0,775,750,750,-20
776,22 Agt 2022,UNTR,31650,31925,32025,31450,31800,150
777,22 Agt 2022,UNVR,4730,4750,4800,4730,4750,20
4,23 Agt 2022,ACES,750,0,760,740,760,10
35,23 Agt 2022,AMRT,2090,2090,2140,2070,2100,10
58,23 Agt 2022,ASII,6925,6900,7025,6850,6975,50
328,23 Agt 2022,HRUM,1580,1580,1680,1580,1665,85
358,23 Agt 2022,INKP,7925,7900,8075,7850,8050,125
366,23 Agt 2022,INTP,9225,9275,9450,9225,9275,50
463,23 Agt 2022,MAPI,1020,0,1035,1000,1015,-5
664,23 Agt 2022,SIDO,750,0,780,745,750,0
776,23 Agt 2022,UNTR,31800,31350,32375,31350,32125,325
777,23 Agt 2022,UNVR,4750,4800,4830,4760,4810,60
4,24 Agt 2022,ACES,760,0,780,755,765,5
35,24 Agt 2022,AMRT,2100,2050,2100,2000,2010,-90
58,24 Agt 2022,ASII,6975,6925,7050,6900,7050,75
328,24 Agt 2022,HRUM,1665,1665,1730,1640,1700,35
358,24 Agt 2022,INKP,8050,8050,8075,7975,8075,25
366,24 Agt 2022,INTP,9275,9275,9525,9275,9500,225
463,24 Agt 2022,MAPI,1015,0,1030,1005,1015,0
664,24 Agt 2022,SIDO,750,0,755,750,750,0
776,24 Agt 2022,UNTR,32125,32375,32850,32125,32625,500
777,24 Agt 2022,UNVR,4810,4820,4880,4800,4850,40
4,25 Agt 2022,ACES,765,0,765,745,745,-20
35,25 Agt 2022,AMRT,2010,2020,2050,2000,2000,-10
58,25 Agt 2022,ASII,7050,7050,7050,6950,6975,-75
328,25 Agt 2022,HRUM,1700,1710,1730,1680,1710,10
358,25 Agt 2022,INKP,8075,8075,8100,7925,7950,-125
366,25 Agt 2022,INTP,9500,9500,9525,9300,9350,-150
463,25 Agt 2022,MAPI,1015,0,1035,980,990,-25
664,25 Agt 2022,SIDO,750,0,755,735,735,-15
776,25 Agt 2022,UNTR,32625,32850,33000,32450,32950,325
777,25 Agt 2022,UNVR,4850,4850,4870,4800,4840,-10
4,26 Agt 2022,ACES,745,0,750,735,740,-5
35,26 Agt 2022,AMRT,2000,2030,2080,1995,2020,20
58,26 Agt 2022,ASII,6975,6975,7025,6850,6875,-100
328,26 Agt 2022,HRUM,1710,1720,1725,1685,1690,-20
358,26 Agt 2022,INKP,7950,7950,8250,7950,8250,300
366,26 Agt 2022,INTP,9350,9350,9375,9300,9300,-50
463,26 Agt 2022,MAPI,990,0,1015,990,990,0
664,26 Agt 2022,SIDO,735,0,740,715,715,-20
776,26 Agt 2022,UNTR,32950,33150,33325,33025,33100,150
777,26 Agt 2022,UNVR,4840,4850,4850,4610,4610,-230
4,29 Agt 2022,ACES,740,0,740,720,720,-20
35,29 Agt 2022,AMRT,2020,1990,2030,1975,2020,0
58,29 Agt 2022,ASII,6875,6800,6900,6750,6825,-50
328,29 Agt 2022,HRUM,1690,1665,1730,1625,1725,35
358,29 Agt 2022,INKP,8250,8000,8350,8000,8350,100
366,29 Agt 2022,INTP,9300,9200,9325,9200,9325,25
463,29 Agt 2022,MAPI,990,0,985,960,970,-20
664,29 Agt 2022,SIDO,715,0,720,705,705,-10
776,29 Agt 2022,UNTR,33100,32750,33000,32275,33000,-100
777,29 Agt 2022,UNVR,4610,4560,4600,4510,4580,-30
4,30 Agt 2022,ACES,720,0,735,720,725,5
35,30 Agt 2022,AMRT,2020,2020,2070,2020,2030,10
58,30 Agt 2022,ASII,6825,6850,7025,6850,6900,75
328,30 Agt 2022,HRUM,1725,1745,1765,1725,1755,30
358,30 Agt 2022,INKP,8350,8375,8425,8300,8375,25
366,30 Agt 2022,INTP,9325,9300,9425,9275,9300,-25
463,30 Agt 2022,MAPI,970,0,1005,960,980,10
664,30 Agt 2022,SIDO,705,0,735,705,720,15
776,30 Agt 2022,UNTR,33000,33000,33825,32750,33325,325
777,30 Agt 2022,UNVR,4580,4590,4630,4580,4580,0
4,31 Agt 2022,ACES,725,0,730,700,720,-5
35,31 Agt 2022,AMRT,2030,2050,2180,2020,2180,150
58,31 Agt 2022,ASII,6900,6875,6975,6775,6975,75
328,31 Agt 2022,HRUM,1755,1755,1755,1690,1700,-55
358,31 Agt 2022,INKP,8375,8450,8500,8300,8325,-50
366,31 Agt 2022,INTP,9300,9300,9450,9250,9450,150
463,31 Agt 2022,MAPI,980,0,1035,980,1010,30
664,31 Agt 2022,SIDO,720,0,725,710,710,-10
776,31 Agt 2022,UNTR,33325,33075,33850,32700,33850,525
777,31 Agt 2022,UNVR,4580,4580,4620,4530,4590,10
4,01 Sep 2022,ACES,720,0,735,715,720,0
35,01 Sep 2022,AMRT,2180,2150,2150,2050,2080,-100
58,01 Sep 2022,ASII,6975,6975,7025,6900,6925,-50
328,01 Sep 2022,HRUM,1700,1705,1740,1700,1710,10
358,01 Sep 2022,INKP,8325,8350,8375,8200,8250,-75
366,01 Sep 2022,INTP,9450,9450,9450,9275,9300,-150
463,01 Sep 2022,MAPI,1010,0,1025,1000,1010,0
664,01 Sep 2022,SIDO,710,0,715,705,705,-5
776,01 Sep 2022,UNTR,33850,33750,33750,33275,33275,-575
777,01 Sep 2022,UNVR,4590,4590,4610,4540,4540,-50
4,02 Sep 2022,ACES,720,0,720,700,705,-15
35,02 Sep 2022,AMRT,2080,2030,2090,2030,2060,-20
58,02 Sep 2022,ASII,6925,6950,7000,6875,6925,0
328,02 Sep 2022,HRUM,1710,1725,1730,1665,1685,-25
358,02 Sep 2022,INKP,8250,8300,8925,8275,8850,600
366,02 Sep 2022,INTP,9300,9300,9475,9300,9475,175
463,02 Sep 2022,MAPI,1010,0,1060,1010,1050,40
664,02 Sep 2022,SIDO,705,0,720,705,715,10
776,02 Sep 2022,UNTR,33275,33300,33950,33300,33900,625
777,02 Sep 2022,UNVR,4540,4540,4600,4540,4550,10
4,05 Sep 2022,ACES,705,0,705,665,665,-40
35,05 Sep 2022,AMRT,2060,2080,2150,2040,2100,40
58,05 Sep 2022,ASII,6925,6900,6925,6850,6875,-50
328,05 Sep 2022,HRUM,1685,1685,1815,1685,1810,125
358,05 Sep 2022,INKP,8850,8850,8975,8700,8725,-125
366,05 Sep 2022,INTP,9475,9450,9475,9325,9450,-25
463,05 Sep 2022,MAPI,1050,0,1050,1010,1020,-30
664,05 Sep 2022,SIDO,715,0,720,705,715,0
776,05 Sep 2022,UNTR,33900,33850,34975,33675,34350,450
777,05 Sep 2022,UNVR,4550,4550,4570,4510,4530,-20
4,06 Sep 2022,ACES,665,0,695,655,660,-5
35,06 Sep 2022,AMRT,2100,2110,2150,2070,2080,-20
58,06 Sep 2022,ASII,6875,6875,6950,6850,6900,25
328,06 Sep 2022,HRUM,1810,1840,1885,1820,1855,45
358,06 Sep 2022,INKP,8725,8750,8800,8600,8675,-50
366,06 Sep 2022,INTP,9450,9450,9475,9325,9450,0
463,06 Sep 2022,MAPI,1020,0,1030,990,990,-30
664,06 Sep 2022,SIDO,715,0,720,710,715,0
776,06 Sep 2022,UNTR,34350,34850,35925,34550,35500,1150
777,06 Sep 2022,UNVR,4530,4530,4540,4450,4510,-20
4,07 Sep 2022,ACES,660,0,685,660,680,20
35,07 Sep 2022,AMRT,2080,2080,2130,2060,2100,20
58,07 Sep 2022,ASII,6900,6800,6875,6625,6650,-250
329,07 Sep 2022,HRUM,1855,1855,1855,1780,1810,-45
359,07 Sep 2022,INKP,8675,8700,8950,8550,8900,225
367,07 Sep 2022,INTP,9450,9450,9650,9400,9550,100
464,07 Sep 2022,MAPI,990,0,1005,955,965,-25
665,07 Sep 2022,SIDO,715,0,725,710,715,0
777,07 Sep 2022,UNTR,35500,35425,35425,34700,35075,-425
778,07 Sep 2022,UNVR,4510,4510,4590,4490,4590,80
4,08 Sep 2022,ACES,680,0,690,680,685,5
35,08 Sep 2022,AMRT,2100,2120,2130,2090,2090,-10
58,08 Sep 2022,ASII,6650,6650,6750,6625,6650,0
329,08 Sep 2022,HRUM,1810,1800,1830,1765,1770,-40
359,08 Sep 2022,INKP,8900,8950,9725,8950,9675,775
367,08 Sep 2022,INTP,9550,9650,9650,9550,9575,25
464,08 Sep 2022,MAPI,965,0,995,965,985,20
665,08 Sep 2022,SIDO,715,0,720,710,720,5
777,08 Sep 2022,UNTR,35075,35025,35500,34400,34400,-675
778,08 Sep 2022,UNVR,4590,4590,4610,4520,4520,-70
4,09 Sep 2022,ACES,685,0,690,670,675,-10
35,09 Sep 2022,AMRT,2090,2120,2130,2100,2110,20
58,09 Sep 2022,ASII,6650,6675,6775,6625,6775,125
329,09 Sep 2022,HRUM,1770,1770,1830,1740,1830,60
359,09 Sep 2022,INKP,9675,9700,9900,9525,9525,-150
367,09 Sep 2022,INTP,9575,9600,9700,9575,9625,50
464,09 Sep 2022,MAPI,985,0,995,975,995,10
665,09 Sep 2022,SIDO,720,0,725,700,705,-15
777,09 Sep 2022,UNTR,34400,34400,34500,34050,34300,-100
778,09 Sep 2022,UNVR,4520,4520,4570,4500,4500,-20
4,12 Sep 2022,ACES,675,0,685,670,680,5
35,12 Sep 2022,AMRT,2110,2150,2300,2130,2140,30
58,12 Sep 2022,ASII,6775,6775,6975,6725,6975,200
329,12 Sep 2022,HRUM,1830,1850,1875,1805,1815,-15
359,12 Sep 2022,INKP,9525,9525,9750,9425,9650,125
367,12 Sep 2022,INTP,9625,9650,9650,9450,9525,-100
464,12 Sep 2022,MAPI,995,0,1060,995,1055,60
665,12 Sep 2022,SIDO,705,0,715,700,710,5
777,12 Sep 2022,UNTR,34300,34325,34825,34275,34500,200
778,12 Sep 2022,UNVR,4500,4510,4560,4510,4550,50
4,13 Sep 2022,ACES,680,0,685,675,680,0
35,13 Sep 2022,AMRT,2140,2190,2280,2160,2220,80
58,13 Sep 2022,ASII,6975,7025,7225,6950,7200,225
329,13 Sep 2022,HRUM,1815,1850,1950,1840,1920,105
359,13 Sep 2022,INKP,9650,9650,9750,9550,9600,-50
367,13 Sep 2022,INTP,9525,9525,9675,9475,9650,125
464,13 Sep 2022,MAPI,1055,0,1060,1015,1020,-35
665,13 Sep 2022,SIDO,710,0,720,710,715,5
777,13 Sep 2022,UNTR,34500,34500,34750,34325,34350,-150
778,13 Sep 2022,UNVR,4550,4570,4670,4560,4670,120
4,14 Sep 2022,ACES,680,0,680,665,670,-10
35,14 Sep 2022,AMRT,2220,2220,2250,2140,2250,30
58,14 Sep 2022,ASII,7200,7100,7300,7050,7150,-50
329,14 Sep 2022,HRUM,1920,1895,2000,1865,2000,80
359,14 Sep 2022,INKP,9600,9500,9675,9400,9500,-100
367,14 Sep 2022,INTP,9650,9550,9675,9525,9675,25
464,14 Sep 2022,MAPI,1020,0,1050,1005,1050,30
665,14 Sep 2022,SIDO,715,0,715,705,710,-5
777,14 Sep 2022,UNTR,34350,34000,34175,33750,34000,-350
778,14 Sep 2022,UNVR,4670,4640,4640,4600,4630,-40
4,15 Sep 2022,ACES,670,0,675,665,670,0
35,15 Sep 2022,AMRT,2250,2280,2360,2220,2330,80
58,15 Sep 2022,ASII,7150,7125,7225,7050,7050,-100
329,15 Sep 2022,HRUM,2000,2000,2050,1965,1970,-30
359,15 Sep 2022,INKP,9500,9575,9675,9500,9500,0
367,15 Sep 2022,INTP,9675,9675,9750,9550,9600,-75
464,15 Sep 2022,MAPI,1050,0,1115,1050,1095,45
665,15 Sep 2022,SIDO,710,0,715,705,710,0
777,15 Sep 2022,UNTR,34000,35000,36200,34825,34900,900
778,15 Sep 2022,UNVR,4630,4640,4660,4580,4600,-30
4,16 Sep 2022,ACES,670,0,675,660,660,-10
35,16 Sep 2022,AMRT,2330,2290,2330,2210,2230,-100
58,16 Sep 2022,ASII,7050,7000,7050,6900,6900,-150
329,16 Sep 2022,HRUM,1970,1950,1960,1900,1910,-60
359,16 Sep 2022,INKP,9500,9500,9500,9200,9250,-250
367,16 Sep 2022,INTP,9600,9625,9925,9575,9925,325
464,16 Sep 2022,MAPI,1095,0,1125,1065,1080,-15
665,16 Sep 2022,SIDO,710,0,725,710,710,0
777,16 Sep 2022,UNTR,34900,34900,34900,33925,34325,-575
778,16 Sep 2022,UNVR,4600,4640,4640,4610,4630,30
4,19 Sep 2022,ACES,660,0,665,650,660,0
35,19 Sep 2022,AMRT,2230,2300,2320,2230,2250,20
58,19 Sep 2022,ASII,6900,6950,7225,6925,7125,225
329,19 Sep 2022,HRUM,1910,1950,1955,1830,1880,-30
359,19 Sep 2022,INKP,9250,9250,9375,8975,9300,50
367,19 Sep 2022,INTP,9925,9925,9950,9750,9925,0
464,19 Sep 2022,MAPI,1080,0,1115,1070,1100,20
665,19 Sep 2022,SIDO,710,0,745,710,745,35
777,19 Sep 2022,UNTR,34325,34050,34925,33900,34300,-25
778,19 Sep 2022,UNVR,4630,4630,4630,4510,4600,-30
4,20 Sep 2022,ACES,660,0,665,655,660,0
35,20 Sep 2022,AMRT,2250,2250,2290,2230,2240,-10
58,20 Sep 2022,ASII,7125,7150,7250,7100,7175,50
329,20 Sep 2022,HRUM,1880,1885,1910,1840,1850,-30
359,20 Sep 2022,INKP,9300,9300,9475,9075,9075,-225
367,20 Sep 2022,INTP,9925,9975,10225,9850,10100,175
464,20 Sep 2022,MAPI,1100,0,1145,1090,1135,35
665,20 Sep 2022,SIDO,745,0,760,720,720,-25
777,20 Sep 2022,UNTR,34300,34575,34950,34000,34150,-150
778,20 Sep 2022,UNVR,4600,4630,4730,4620,4730,130
4,21 Sep 2022,ACES,660,0,665,650,650,-10
35,21 Sep 2022,AMRT,2240,2290,2320,2230,2300,60
58,21 Sep 2022,ASII,7175,7125,7200,7100,7150,-25
329,21 Sep 2022,HRUM,1850,1850,1900,1830,1900,50
359,21 Sep 2022,INKP,9075,9050,9175,8900,8950,-125
367,21 Sep 2022,INTP,10100,10175,10200,10000,10150,50
464,21 Sep 2022,MAPI,1135,0,1150,1100,1140,5
665,21 Sep 2022,SIDO,720,0,735,715,730,10
777,21 Sep 2022,UNTR,34150,34000,34450,33425,34325,175
778,21 Sep 2022,UNVR,4730,4730,4840,4730,4810,80
4,22 Sep 2022,ACES,650,0,655,615,630,-20
35,22 Sep 2022,AMRT,2300,2340,2400,2300,2310,10
58,22 Sep 2022,ASII,7150,7025,7225,7000,7175,25
329,22 Sep 2022,HRUM,1900,1870,1960,1865,1940,40
359,22 Sep 2022,INKP,8950,8900,9125,8850,9100,150
367,22 Sep 2022,INTP,10150,10050,10075,9900,10075,-75
464,22 Sep 2022,MAPI,1140,0,1160,1110,1120,-20
665,22 Sep 2022,SIDO,730,0,735,720,720,-10
777,22 Sep 2022,UNTR,34325,34200,35100,33925,35100,775
778,22 Sep 2022,UNVR,4810,4810,4810,4740,4810,0
4,23 Sep 2022,ACES,630,0,640,620,625,-5
35,23 Sep 2022,AMRT,2310,2390,2410,2320,2390,80
58,23 Sep 2022,ASII,7175,7100,7175,7050,7150,-25
329,23 Sep 2022,HRUM,1940,1930,2000,1905,1920,-20
359,23 Sep 2022,INKP,9100,9100,9275,9075,9275,175
367,23 Sep 2022,INTP,10075,10075,10225,9950,10125,50
464,23 Sep 2022,MAPI,1120,0,1155,1075,1080,-40
665,23 Sep 2022,SIDO,720,0,725,715,720,0
777,23 Sep 2022,UNTR,35100,35000,35000,34000,34000,-1100
778,23 Sep 2022,UNVR,4810,4810,4820,4770,4810,0
4,26 Sep 2022,ACES,625,0,650,615,650,25
35,26 Sep 2022,AMRT,2390,2450,2450,2340,2360,-30
58,26 Sep 2022,ASII,7150,7000,7025,6850,6975,-175
329,26 Sep 2022,HRUM,1920,1865,1875,1790,1825,-95
359,26 Sep 2022,INKP,9275,9225,9250,8950,9100,-175
367,26 Sep 2022,INTP,10125,10100,10175,9900,10025,-100
464,26 Sep 2022,MAPI,1080,0,1130,1065,1120,40
665,26 Sep 2022,SIDO,720,0,725,710,720,0
777,26 Sep 2022,UNTR,34000,33300,33325,32000,33300,-700
778,26 Sep 2022,UNVR,4810,4810,4830,4750,4790,-20
4,27 Sep 2022,ACES,650,0,660,635,650,0
35,27 Sep 2022,AMRT,2360,2360,2390,2280,2360,0
58,27 Sep 2022,ASII,6975,7000,7050,6950,6950,-25
329,27 Sep 2022,HRUM,1825,1825,1855,1800,1840,15
359,27 Sep 2022,INKP,9100,9100,9250,9025,9050,-50
367,27 Sep 2022,INTP,10025,10025,10025,9800,9875,-150
464,27 Sep 2022,MAPI,1120,0,1130,1080,1115,-5
665,27 Sep 2022,SIDO,720,0,720,710,715,-5
777,27 Sep 2022,UNTR,33300,33300,33650,33075,33400,100
778,27 Sep 2022,UNVR,4790,4800,4810,4770,4800,10
4,28 Sep 2022,ACES,650,0,650,630,635,-15
35,28 Sep 2022,AMRT,2360,2370,2380,2350,2380,20
58,28 Sep 2022,ASII,6950,6950,7000,6800,6800,-150
329,28 Sep 2022,HRUM,1840,1830,1835,1755,1760,-80
359,28 Sep 2022,INKP,9050,9050,9100,8900,8900,-150
367,28 Sep 2022,INTP,9875,9875,9925,9650,9825,-50
464,28 Sep 2022,MAPI,1115,0,1115,1045,1050,-65
665,28 Sep 2022,SIDO,715,0,720,710,710,-5
777,28 Sep 2022,UNTR,33400,33400,33725,33000,33000,-400
778,28 Sep 2022,UNVR,4800,4800,4840,4780,4810,10
4,29 Sep 2022,ACES,635,0,655,630,640,5
35,29 Sep 2022,AMRT,2380,2380,2400,2350,2400,20
58,29 Sep 2022,ASII,6800,6850,6900,6700,6775,-25
329,29 Sep 2022,HRUM,1760,1780,1815,1765,1790,30
359,29 Sep 2022,INKP,8900,9000,9100,8950,9075,175
367,29 Sep 2022,INTP,9825,9825,9875,9650,9725,-100
464,29 Sep 2022,MAPI,1050,0,1105,1000,1060,10
665,29 Sep 2022,SIDO,710,0,715,710,715,5
777,29 Sep 2022,UNTR,33000,33000,33750,32800,33125,125
778,29 Sep 2022,UNVR,4810,4800,4870,4790,4850,40
4,30 Sep 2022,ACES,640,0,640,605,610,-30
35,30 Sep 2022,AMRT,2400,2400,2400,2330,2390,-10
58,30 Sep 2022,ASII,6775,6700,6750,6600,6625,-150
329,30 Sep 2022,HRUM,1790,1770,1785,1715,1780,-10
359,30 Sep 2022,INKP,9075,9075,9150,8625,9050,-25
367,30 Sep 2022,INTP,9725,9700,9700,9475,9500,-225
464,30 Sep 2022,MAPI,1060,0,1075,1035,1060,0
665,30 Sep 2022,SIDO,715,0,715,700,710,-5
777,30 Sep 2022,UNTR,33125,32875,33100,32575,32825,-300
778,30 Sep 2022,UNVR,4850,4840,4850,4710,4830,-20
4,03 Okt 2022,ACES,610,0,615,600,605,-5
35,03 Okt 2022,AMRT,2390,2300,2400,2290,2380,-10
58,03 Okt 2022,ASII,6625,6650,6700,6600,6625,0
329,03 Okt 2022,HRUM,1780,1770,1820,1755,1785,5
359,03 Okt 2022,INKP,9050,9050,9400,8850,9250,200
367,03 Okt 2022,INTP,9500,9500,9525,9375,9400,-100
464,03 Okt 2022,MAPI,1060,0,1070,1040,1050,-10
665,03 Okt 2022,SIDO,710,0,710,705,705,-5
777,03 Okt 2022,UNTR,32825,32825,33200,32675,33000,175
778,03 Okt 2022,UNVR,4830,4830,4870,4820,4850,20
4,04 Okt 2022,ACES,605,0,620,605,615,10
35,04 Okt 2022,AMRT,2380,2390,2400,2380,2400,20
58,04 Okt 2022,ASII,6625,6725,6800,6700,6725,100
329,04 Okt 2022,HRUM,1785,1820,1845,1815,1835,50
359,04 Okt 2022,INKP,9250,9375,9700,9350,9650,400
367,04 Okt 2022,INTP,9400,9500,9500,9300,9300,-100
464,04 Okt 2022,MAPI,1050,0,1085,1015,1020,-30
665,04 Okt 2022,SIDO,705,0,710,700,705,0
777,04 Okt 2022,UNTR,33000,33300,34100,33300,33800,800
778,04 Okt 2022,UNVR,4850,4880,4900,4850,4870,20
4,05 Okt 2022,ACES,615,0,630,610,615,0
35,05 Okt 2022,AMRT,2400,2400,2400,2360,2390,-10
58,05 Okt 2022,ASII,6725,6800,6825,6675,6675,-50
329,05 Okt 2022,HRUM,1835,1840,1865,1825,1830,-5
359,05 Okt 2022,INKP,9650,9650,9700,9375,9375,-275
367,05 Okt 2022,INTP,9300,9375,9375,9225,9250,-50
464,05 Okt 2022,MAPI,1020,0,1045,1020,1030,10
665,05 Okt 2022,SIDO,705,0,710,700,700,-5
777,05 Okt 2022,UNTR,33800,33125,34000,33075,33075,-725
778,05 Okt 2022,UNVR,4870,4900,4900,4830,4830,-40
4,06 Okt 2022,ACES,615,0,620,610,615,0
35,06 Okt 2022,AMRT,2390,2400,2400,2370,2390,0
58,06 Okt 2022,ASII,6675,6675,6750,6600,6600,-75
329,06 Okt 2022,HRUM,1830,1830,1860,1825,1825,-5
359,06 Okt 2022,INKP,9375,9375,9525,9300,9525,150
367,06 Okt 2022,INTP,9250,9250,9300,9125,9125,-125
464,06 Okt 2022,MAPI,1030,0,1085,1030,1070,40
665,06 Okt 2022,SIDO,700,0,710,700,705,5
777,06 Okt 2022,UNTR,33075,33375,33600,32800,32850,-225
778,06 Okt 2022,UNVR,4830,4860,4900,4840,4900,70
4,07 Okt 2022,ACES,615,0,620,605,610,-5
35,07 Okt 2022,AMRT,2390,2390,2390,2330,2330,-60
58,07 Okt 2022,ASII,6600,6550,6575,6450,6475,-125
329,07 Okt 2022,HRUM,1825,1820,1835,1805,1820,-5
359,07 Okt 2022,INKP,9525,9525,9525,9200,9250,-275
367,07 Okt 2022,INTP,9125,9150,9175,9100,9125,0
464,07 Okt 2022,MAPI,1070,0,1115,1050,1115,45
665,07 Okt 2022,SIDO,705,0,720,705,715,10
777,07 Okt 2022,UNTR,32850,32950,33175,32700,33000,150
778,07 Okt 2022,UNVR,4900,4900,4910,4760,4840,-60
4,10 Okt 2022,ACES,610,0,615,580,585,-25
35,10 Okt 2022,AMRT,2330,2330,2390,2320,2390,60
58,10 Okt 2022,ASII,6475,6425,6525,6375,6500,25
329,10 Okt 2022,HRUM,1820,1800,1800,1755,1775,-45
359,10 Okt 2022,INKP,9250,9175,9175,9025,9075,-175
367,10 Okt 2022,INTP,9125,9125,9175,9075,9100,-25
464,10 Okt 2022,MAPI,1115,0,1115,1065,1075,-40
665,10 Okt 2022,SIDO,715,0,715,700,705,-10
777,10 Okt 2022,UNTR,33000,32700,32700,32000,32300,-700
778,10 Okt 2022,UNVR,4840,4840,4840,4700,4800,-40
4,11 Okt 2022,ACES,585,0,600,575,585,0
35,11 Okt 2022,AMRT,2390,2390,2400,2340,2340,-50
58,11 Okt 2022,ASII,6500,6400,6575,6400,6525,25
329,11 Okt 2022,HRUM,1775,1780,1780,1730,1730,-45
359,11 Okt 2022,INKP,9075,9075,9075,8800,8875,-200
367,11 Okt 2022,INTP,9100,9150,9375,9075,9350,250
464,11 Okt 2022,MAPI,1075,0,1155,1070,1155,80
665,11 Okt 2022,SIDO,705,0,710,695,700,-5
777,11 Okt 2022,UNTR,32300,32300,32600,32050,32200,-100
778,11 Okt 2022,UNVR,4800,4780,4780,4730,4730,-70
4,12 Okt 2022,ACES,585,0,590,545,545,-40
35,12 Okt 2022,AMRT,2340,2350,2400,2350,2390,50
58,12 Okt 2022,ASII,6525,6450,6475,6350,6350,-175
329,12 Okt 2022,HRUM,1730,1730,1765,1700,1720,-10
359,12 Okt 2022,INKP,8875,8900,9025,8750,8925,50
367,12 Okt 2022,INTP,9350,9400,9400,9125,9200,-150
464,12 Okt 2022,MAPI,1155,0,1190,1125,1190,35
665,12 Okt 2022,SIDO,700,0,700,655,660,-40
777,12 Okt 2022,UNTR,32200,32300,32600,31400,32350,150
778,12 Okt 2022,UNVR,4730,4730,4790,4660,4790,60
4,13 Okt 2022,ACES,545,0,545,510,510,-35
35,13 Okt 2022,AMRT,2390,2390,2500,2380,2490,100
58,13 Okt 2022,ASII,6350,6375,6400,6275,6350,0
329,13 Okt 2022,HRUM,1720,1755,1755,1720,1730,10
359,13 Okt 2022,INKP,8925,8900,9125,8850,8950,25
367,13 Okt 2022,INTP,9200,9200,9225,9100,9150,-50
464,13 Okt 2022,MAPI,1190,0,1200,1150,1200,10
665,13 Okt 2022,SIDO,660,0,665,640,655,-5
777,13 Okt 2022,UNTR,32350,32425,32500,32000,32200,-150
778,13 Okt 2022,UNVR,4790,4790,4840,4770,4840,50
4,14 Okt 2022,ACES,510,0,535,510,525,15
35,14 Okt 2022,AMRT,2490,2500,2560,2470,2510,20
58,14 Okt 2022,ASII,6350,6500,6500,6350,6350,0
329,14 Okt 2022,HRUM,1730,1750,1750,1700,1725,-5
359,14 Okt 2022,INKP,8950,9075,9100,8725,8825,-125
367,14 Okt 2022,INTP,9150,9200,9275,9050,9050,-100
464,14 Okt 2022,MAPI,1200,0,1250,1170,1190,-10
665,14 Okt 2022,SIDO,655,0,665,650,655,0
777,14 Okt 2022,UNTR,32200,32350,33750,32350,33750,1550
778,14 Okt 2022,UNVR,4840,4840,4860,4770,4810,-30
4,17 Okt 2022,ACES,525,0,530,505,525,0
35,17 Okt 2022,AMRT,2510,2490,2500,2450,2500,-10
58,17 Okt 2022,ASII,6350,6325,6525,6200,6425,75
329,17 Okt 2022,HRUM,1725,1715,1715,1620,1655,-70
359,17 Okt 2022,INKP,8825,8800,8975,8675,8925,100
367,17 Okt 2022,INTP,9050,9050,9150,9000,9150,100
464,17 Okt 2022,MAPI,1190,0,1200,1125,1160,-30
665,17 Okt 2022,SIDO,655,0,655,630,635,-20
777,17 Okt 2022,UNTR,33750,33600,33600,32550,32900,-850
778,17 Okt 2022,UNVR,4810,4850,4850,4800,4830,20
4,18 Okt 2022,ACES,525,0,545,515,535,10
35,18 Okt 2022,AMRT,2500,2500,2700,2490,2700,200
58,18 Okt 2022,ASII,6425,6450,6500,6350,6350,-75
329,18 Okt 2022,HRUM,1655,1680,1680,1600,1610,-45
359,18 Okt 2022,INKP,8925,9000,9025,8750,8775,-150
367,18 Okt 2022,INTP,9150,9200,9275,9100,9250,100
464,18 Okt 2022,MAPI,1160,0,1180,1140,1140,-20
665,18 Okt 2022,SIDO,635,0,655,635,650,15
777,18 Okt 2022,UNTR,32900,32725,32850,32000,32000,-900
778,18 Okt 2022,UNVR,4830,4850,4900,4810,4900,70
4,19 Okt 2022,ACES,535,0,540,525,530,-5
35,19 Okt 2022,AMRT,2700,2650,2650,2520,2590,-110
58,19 Okt 2022,ASII,6350,6425,6525,6400,6525,175
329,19 Okt 2022,HRUM,1610,1610,1610,1570,1575,-35
359,19 Okt 2022,INKP,8775,8775,8825,8700,8775,0
367,19 Okt 2022,INTP,9250,9250,9500,9175,9425,175
464,19 Okt 2022,MAPI,1140,0,1250,1130,1215,75
665,19 Okt 2022,SIDO,650,0,685,645,665,15
777,19 Okt 2022,UNTR,32000,31700,32075,31500,31800,-200
778,19 Okt 2022,UNVR,4900,4930,5375,4930,5350,450
4,20 Okt 2022,ACES,530,0,535,500,500,-30
35,20 Okt 2022,AMRT,2590,2590,2650,2570,2630,40
58,20 Okt 2022,ASII,6525,6500,6525,6400,6425,-100
329,20 Okt 2022,HRUM,1575,1585,1630,1575,1630,55
359,20 Okt 2022,INKP,8775,8775,9150,8775,9050,275
367,20 Okt 2022,INTP,9425,9400,9525,9200,9200,-225
464,20 Okt 2022,MAPI,1215,0,1270,1185,1250,35
665,20 Okt 2022,SIDO,665,0,685,655,655,-10
777,20 Okt 2022,UNTR,31800,31850,32050,31600,31825,25
778,20 Okt 2022,UNVR,5350,5350,5450,5225,5400,50
4,21 Okt 2022,ACES,500,0,535,488,535,35
35,21 Okt 2022,AMRT,2630,2620,2660,2600,2630,0
58,21 Okt 2022,ASII,6425,6475,6675,6450,6575,150
329,21 Okt 2022,HRUM,1630,1630,1650,1610,1610,-20
359,21 Okt 2022,INKP,9050,9050,9075,8875,9000,-50
367,21 Okt 2022,INTP,9200,9275,9325,9225,9250,50
464,21 Okt 2022,MAPI,1250,0,1250,1200,1225,-25
665,21 Okt 2022,SIDO,655,0,695,650,675,20
777,21 Okt 2022,UNTR,31825,31900,32525,31900,32000,175
778,21 Okt 2022,UNVR,5400,5400,5400,5250,5300,-100
4,24 Okt 2022,ACES,535,0,555,535,540,5
35,24 Okt 2022,AMRT,2630,2640,2670,2620,2630,0
58,24 Okt 2022,ASII,6575,6575,6700,6575,6650,75
329,24 Okt 2022,HRUM,1610,1615,1635,1595,1610,0
359,24 Okt 2022,INKP,9000,9050,9275,8950,9125,125
367,24 Okt 2022,INTP,9250,9275,9425,9250,9275,25
464,24 Okt 2022,MAPI,1225,0,1265,1205,1240,15
665,24 Okt 2022,SIDO,675,0,715,675,710,35
777,24 Okt 2022,UNTR,32000,32000,32725,32000,32375,375
778,24 Okt 2022,UNVR,5300,5275,5475,5250,5325,25
4,25 Okt 2022,ACES,540,0,550,510,520,-20
35,25 Okt 2022,AMRT,2630,2650,2730,2600,2700,70
58,25 Okt 2022,ASII,6650,6700,6700,6600,6700,50
329,25 Okt 2022,HRUM,1610,1615,1620,1555,1565,-45
359,25 Okt 2022,INKP,9125,9175,9225,8925,9150,25
367,25 Okt 2022,INTP,9275,9275,9275,9100,9125,-150
464,25 Okt 2022,MAPI,1240,0,1240,1190,1200,-40
665,25 Okt 2022,SIDO,710,0,725,700,705,-5
777,25 Okt 2022,UNTR,32375,32400,32750,31875,32000,-375
778,25 Okt 2022,UNVR,5325,5325,5375,5200,5275,-50
4,26 Okt 2022,ACES,520,0,550,492,535,15
35,26 Okt 2022,AMRT,2700,2680,2700,2650,2660,-40
58,26 Okt 2022,ASII,6700,6700,6700,6575,6575,-125
329,26 Okt 2022,HRUM,1565,1570,1610,1565,1605,40
359,26 Okt 2022,INKP,9150,9175,9200,9025,9050,-100
367,26 Okt 2022,INTP,9125,9125,9250,9125,9250,125
464,26 Okt 2022,MAPI,1200,0,1265,1180,1185,-15
665,26 Okt 2022,SIDO,705,0,720,700,715,10
777,26 Okt 2022,UNTR,32000,32625,33200,32525,33200,1200
778,26 Okt 2022,UNVR,5275,5250,5400,5175,5400,125
4,27 Okt 2022,ACES,535,0,590,530,570,35
35,27 Okt 2022,AMRT,2660,2680,2720,2680,2720,60
58,27 Okt 2022,ASII,6575,6575,6675,6525,6650,75
329,27 Okt 2022,HRUM,1605,1615,1670,1605,1615,10
359,27 Okt 2022,INKP,9050,9050,9400,9050,9225,175
367,27 Okt 2022,INTP,9250,9250,9300,9200,9200,-50
464,27 Okt 2022,MAPI,1185,0,1330,1180,1250,65
665,27 Okt 2022,SIDO,715,0,745,715,740,25
777,27 Okt 2022,UNTR,33200,33200,33725,32750,32750,-450
778,27 Okt 2022,UNVR,5400,5400,5450,5275,5350,-50
4,28 Okt 2022,ACES,570,0,595,555,560,-10
35,28 Okt 2022,AMRT,2720,2720,2770,2700,2760,40
58,28 Okt 2022,ASII,6650,6650,6650,6500,6550,-100
329,28 Okt 2022,HRUM,1615,1620,1625,1585,1590,-25
359,28 Okt 2022,INKP,9225,9300,9400,9150,9300,75
367,28 Okt 2022,INTP,9200,9200,9275,9125,9275,75
464,28 Okt 2022,MAPI,1250,0,1260,1205,1235,-15
665,28 Okt 2022,SIDO,740,0,750,730,740,0
777,28 Okt 2022,UNTR,32750,32800,32975,32150,32250,-500
778,28 Okt 2022,UNVR,5350,5050,5075,4980,4980,-370
4,31 Okt 2022,ACES,560,0,575,550,565,5
35,31 Okt 2022,AMRT,2760,2760,2840,2740,2820,60
58,31 Okt 2022,ASII,6550,6550,6650,6550,6650,100
329,31 Okt 2022,HRUM,1590,1615,1625,1595,1610,20
359,31 Okt 2022,INKP,9300,9375,9600,9350,9600,300
367,31 Okt 2022,INTP,9275,9275,9325,9200,9275,0
464,31 Okt 2022,MAPI,1235,0,1260,1205,1205,-30
665,31 Okt 2022,SIDO,740,0,745,730,740,0
777,31 Okt 2022,UNTR,32250,32275,32750,32100,32300,50
778,31 Okt 2022,UNVR,4980,4650,4740,4640,4640,-340
4,01 Nov 2022,ACES,565,0,575,555,565,0
35,01 Nov 2022,AMRT,2820,2820,2830,2650,2760,-60
58,01 Nov 2022,ASII,6650,6650,6675,6475,6575,-75
329,01 Nov 2022,HRUM,1610,1595,1595,1505,1505,-105
359,01 Nov 2022,INKP,9600,9600,9650,9425,9600,0
367,01 Nov 2022,INTP,9275,9425,10250,9425,10200,925
464,01 Nov 2022,MAPI,1205,0,1310,1205,1305,100
665,01 Nov 2022,SIDO,740,0,755,740,750,10
777,01 Nov 2022,UNTR,32300,32400,32700,31400,31450,-850
778,01 Nov 2022,UNVR,4640,4590,4690,4500,4530,-110
4,02 Nov 2022,ACES,565,0,595,565,590,25
35,02 Nov 2022,AMRT,2760,2760,2760,2610,2650,-110
58,02 Nov 2022,ASII,6575,6525,6550,6375,6425,-150
329,02 Nov 2022,HRUM,1505,1570,1605,1530,1530,25
359,02 Nov 2022,INKP,9600,9600,9800,9500,9800,200
367,02 Nov 2022,INTP,10200,10200,10200,10000,10100,-100
464,02 Nov 2022,MAPI,1305,0,1350,1280,1350,45
665,02 Nov 2022,SIDO,750,0,755,740,745,-5
777,02 Nov 2022,UNTR,31450,31200,31350,30325,30700,-750
778,02 Nov 2022,UNVR,4530,4530,4590,4460,4500,-30
4,03 Nov 2022,ACES,590,0,610,575,580,-10
35,03 Nov 2022,AMRT,2650,2640,2680,2500,2630,-20
58,03 Nov 2022,ASII,6425,6375,6425,6350,6375,-50
329,03 Nov 2022,HRUM,1530,1540,1585,1540,1580,50
359,03 Nov 2022,INKP,9800,9800,10000,9600,9725,-75
367,03 Nov 2022,INTP,10100,10025,10175,9950,10100,0
464,03 Nov 2022,MAPI,1350,0,1355,1310,1335,-15
665,03 Nov 2022,SIDO,745,0,745,730,740,-5
777,03 Nov 2022,UNTR,30700,30675,31000,30150,31000,300
778,03 Nov 2022,UNVR,4500,4510,4560,4500,4510,10
4,04 Nov 2022,ACES,580,0,595,565,590,10
35,04 Nov 2022,AMRT,2630,2640,2640,2570,2630,0
58,04 Nov 2022,ASII,6375,6350,6425,6350,6425,50
329,04 Nov 2022,HRUM,1580,1565,1595,1550,1590,10
359,04 Nov 2022,INKP,9725,9725,10350,9725,10300,575
367,04 Nov 2022,INTP,10100,10075,10600,10025,10475,375
464,04 Nov 2022,MAPI,1335,0,1345,1275,1290,-45
665,04 Nov 2022,SIDO,740,0,740,730,740,0
777,04 Nov 2022,UNTR,31000,31000,31275,30400,31275,275
778,04 Nov 2022,UNVR,4510,4530,4550,4470,4540,30
4,07 Nov 2022,ACES,590,0,595,550,575,-15
35,07 Nov 2022,AMRT,2630,2650,2700,2620,2660,30
58,07 Nov 2022,ASII,6425,6425,6500,6425,6500,75
329,07 Nov 2022,HRUM,1590,1605,1670,1605,1660,70
359,07 Nov 2022,INKP,10300,10325,10350,10075,10300,0
367,07 Nov 2022,INTP,10475,10475,10650,10225,10525,50
464,07 Nov 2022,MAPI,1290,0,1320,1290,1305,15
665,07 Nov 2022,SIDO,740,0,745,735,745,5
777,07 Nov 2022,UNTR,31275,31225,31275,30700,31275,0
778,07 Nov 2022,UNVR,4540,4540,4620,4500,4620,80
4,08 Nov 2022,ACES,575,0,580,565,570,-5
35,08 Nov 2022,AMRT,2660,2700,2720,2650,2690,30
58,08 Nov 2022,ASII,6500,6500,6525,6450,6525,25
332,08 Nov 2022,HRUM,1660,1660,1675,1630,1665,5
362,08 Nov 2022,INKP,10300,10300,10400,10050,10200,-100
370,08 Nov 2022,INTP,10525,10650,10700,10250,10250,-275
467,08 Nov 2022,MAPI,1305,0,1310,1265,1290,-15
671,08 Nov 2022,SIDO,745,0,745,725,730,-15
783,08 Nov 2022,UNTR,31275,31275,31275,30800,31175,-100
784,08 Nov 2022,UNVR,4620,4640,4650,4600,4630,10
4,09 Nov 2022,ACES,570,0,570,560,565,-5
35,09 Nov 2022,AMRT,2690,2700,2700,2560,2680,-10
58,09 Nov 2022,ASII,6525,6525,6550,6475,6550,25
332,09 Nov 2022,HRUM,1665,1665,1700,1635,1635,-30
362,09 Nov 2022,INKP,10200,10225,10275,10025,10150,-50
370,09 Nov 2022,INTP,10250,10225,10450,10050,10175,-75
468,09 Nov 2022,MAPI,1290,0,1310,1275,1300,10
673,09 Nov 2022,SIDO,730,0,735,725,730,0
785,09 Nov 2022,UNTR,31175,31150,31150,30575,31000,-175
786,09 Nov 2022,UNVR,4630,4630,4630,4520,4540,-90
4,10 Nov 2022,ACES,565,0,570,555,555,-10
35,10 Nov 2022,AMRT,2680,2670,2670,2580,2600,-80
58,10 Nov 2022,ASII,6550,6550,6550,6450,6525,-25
332,10 Nov 2022,HRUM,1635,1610,1610,1560,1565,-70
362,10 Nov 2022,INKP,10150,10025,10125,9900,10000,-150
370,10 Nov 2022,INTP,10175,10175,10475,10100,10475,300
469,10 Nov 2022,MAPI,1300,0,1305,1275,1300,0
674,10 Nov 2022,SIDO,730,0,740,720,740,10
786,10 Nov 2022,UNTR,31000,30550,30550,29300,29400,-1600
787,10 Nov 2022,UNVR,4540,4530,4580,4500,4560,20
4,11 Nov 2022,ACES,555,0,570,550,560,5
35,11 Nov 2022,AMRT,2600,2600,2620,2540,2600,0
58,11 Nov 2022,ASII,6525,6600,6625,6450,6450,-75
332,11 Nov 2022,HRUM,1565,1600,1620,1575,1595,30
362,11 Nov 2022,INKP,10000,10200,10200,9925,10075,75
370,11 Nov 2022,INTP,10475,10500,10575,10225,10250,-225
469,11 Nov 2022,MAPI,1300,0,1365,1260,1310,10
674,11 Nov 2022,SIDO,740,0,745,730,740,0
786,11 Nov 2022,UNTR,29400,29500,29750,29000,29000,-400
787,11 Nov 2022,UNVR,4560,4610,4610,4520,4540,-20
4,14 Nov 2022,ACES,560,0,570,555,555,-5
35,14 Nov 2022,AMRT,2600,2600,2660,2560,2640,40
58,14 Nov 2022,ASII,6450,6450,6475,6300,6300,-150
332,14 Nov 2022,HRUM,1595,1635,1690,1620,1660,65
362,14 Nov 2022,INKP,10075,10150,10175,10025,10050,-25
370,14 Nov 2022,INTP,10250,10250,10300,10150,10300,50
469,14 Nov 2022,MAPI,1310,0,1310,1260,1300,-10
674,14 Nov 2022,SIDO,740,0,765,735,765,25
786,14 Nov 2022,UNTR,29000,29000,29200,28500,28700,-300
787,14 Nov 2022,UNVR,4540,4540,4600,4530,4590,50
4,15 Nov 2022,ACES,555,0,565,535,535,-20
35,15 Nov 2022,AMRT,2640,2640,2770,2620,2760,120
58,15 Nov 2022,ASII,6300,6300,6350,6200,6225,-75
332,15 Nov 2022,HRUM,1660,1700,1735,1695,1700,40
362,15 Nov 2022,INKP,10050,10150,10175,10000,10175,125
370,15 Nov 2022,INTP,10300,10250,10250,10050,10100,-200
469,15 Nov 2022,MAPI,1300,0,1310,1260,1270,-30
674,15 Nov 2022,SIDO,765,0,775,760,770,5
786,15 Nov 2022,UNTR,28700,28125,28775,28125,28650,-50
787,15 Nov 2022,UNVR,4590,4590,4610,4540,4610,20
4,16 Nov 2022,ACES,535,0,555,530,535,0
35,16 Nov 2022,AMRT,2760,2770,2900,2760,2840,80
58,16 Nov 2022,ASII,6225,6175,6200,6100,6175,-50
332,16 Nov 2022,HRUM,1700,1725,1730,1670,1675,-25
362,16 Nov 2022,INKP,10175,10150,10150,9800,9875,-300
370,16 Nov 2022,INTP,10100,10100,10125,9700,9825,-275
469,16 Nov 2022,MAPI,1270,0,1285,1235,1250,-20
674,16 Nov 2022,SIDO,770,0,780,760,765,-5
786,16 Nov 2022,UNTR,28650,28700,28800,28300,28750,100
787,16 Nov 2022,UNVR,4610,4610,4610,4550,4610,0
4,17 Nov 2022,ACES,535,0,560,540,555,20
35,17 Nov 2022,AMRT,2840,2840,2860,2790,2820,-20
58,17 Nov 2022,ASII,6175,6200,6300,6050,6300,125
332,17 Nov 2022,HRUM,1675,1650,1685,1620,1680,5
362,17 Nov 2022,INKP,9875,9825,9850,9650,9775,-100
370,17 Nov 2022,INTP,9825,9750,9825,9525,9625,-200
469,17 Nov 2022,MAPI,1250,0,1265,1190,1200,-50
674,17 Nov 2022,SIDO,765,0,775,720,760,-5
786,17 Nov 2022,UNTR,28750,28500,28700,28150,28625,-125
787,17 Nov 2022,UNVR,4610,4600,4610,4560,4590,-20
4,18 Nov 2022,ACES,555,0,575,555,570,15
35,18 Nov 2022,AMRT,2820,2830,2850,2740,2830,10
58,18 Nov 2022,ASII,6300,6275,6300,6200,6225,-75
332,18 Nov 2022,HRUM,1680,1680,1680,1640,1640,-40
362,18 Nov 2022,INKP,9775,10025,10325,9825,9875,100
370,18 Nov 2022,INTP,9625,9625,9900,9600,9900,275
469,18 Nov 2022,MAPI,1200,0,1275,1190,1260,60
674,18 Nov 2022,SIDO,760,0,765,755,755,-5
786,18 Nov 2022,UNTR,28625,28500,29050,28325,28800,175
787,18 Nov 2022,UNVR,4590,4590,4660,4560,4640,50
4,21 Nov 2022,ACES,570,0,580,555,555,-15
35,21 Nov 2022,AMRT,2830,2820,2820,2720,2760,-70
58,21 Nov 2022,ASII,6225,6275,6350,6250,6325,100
332,21 Nov 2022,HRUM,1640,1665,1670,1635,1645,5
362,21 Nov 2022,INKP,9875,9875,9975,9750,9825,-50
370,21 Nov 2022,INTP,9900,9925,9950,9700,9750,-150
469,21 Nov 2022,MAPI,1260,0,1340,1255,1340,80
674,21 Nov 2022,SIDO,755,0,775,755,770,15
786,21 Nov 2022,UNTR,28800,29100,29275,28675,28800,0
787,21 Nov 2022,UNVR,4640,4630,4630,4550,4550,-90
4,22 Nov 2022,ACES,555,0,565,535,540,-15
35,22 Nov 2022,AMRT,2760,2790,2820,2750,2750,-10
58,22 Nov 2022,ASII,6325,6325,6350,6225,6225,-100
332,22 Nov 2022,HRUM,1645,1655,1660,1635,1650,5
362,22 Nov 2022,INKP,9825,9825,9925,9700,9700,-125
370,22 Nov 2022,INTP,9750,0,9800,9625,9625,-125
469,22 Nov 2022,MAPI,1340,0,1345,1315,1330,-10
674,22 Nov 2022,SIDO,770,0,775,750,770,0
786,22 Nov 2022,UNTR,28800,28800,29200,28800,28950,150
787,22 Nov 2022,UNVR,4550,4570,4620,4560,4560,10
4,23 Nov 2022,ACES,540,0,550,535,545,5
35,23 Nov 2022,AMRT,2750,2750,2860,2750,2780,30
58,23 Nov 2022,ASII,6225,6275,6300,6200,6200,-25
332,23 Nov 2022,HRUM,1650,1670,1715,1670,1685,35
362,23 Nov 2022,INKP,9700,9700,9800,9600,9675,-25
370,23 Nov 2022,INTP,9625,0,9775,9650,9675,50
469,23 Nov 2022,MAPI,1330,0,1385,1305,1345,15
674,23 Nov 2022,SIDO,770,0,775,765,765,-5
786,23 Nov 2022,UNTR,28950,29050,29950,29050,29625,675
787,23 Nov 2022,UNVR,4560,4580,4590,4550,4550,-10
4,24 Nov 2022,ACES,545,0,550,540,540,-5
35,24 Nov 2022,AMRT,2780,2790,2880,2790,2830,50
58,24 Nov 2022,ASII,6200,6200,6275,6200,6200,0
332,24 Nov 2022,HRUM,1685,1695,1700,1670,1675,-10
362,24 Nov 2022,INKP,9675,9700,9700,9525,9575,-100
370,24 Nov 2022,INTP,9675,9675,9900,9600,9750,75
469,24 Nov 2022,MAPI,1345,0,1385,1340,1365,20
674,24 Nov 2022,SIDO,765,0,770,760,765,0
786,24 Nov 2022,UNTR,29625,29725,30100,29725,29975,350
787,24 Nov 2022,UNVR,4550,4550,4600,4550,4560,10
4,25 Nov 2022,ACES,540,0,545,535,540,0
35,25 Nov 2022,AMRT,2830,2830,2840,2750,2770,-60
58,25 Nov 2022,ASII,6200,6175,6200,6125,6175,-25
332,25 Nov 2022,HRUM,1675,1680,1685,1635,1655,-20
362,25 Nov 2022,INKP,9575,9575,9625,9500,9525,-50
370,25 Nov 2022,INTP,9750,9750,9925,9700,9900,150
469,25 Nov 2022,MAPI,1365,0,1385,1340,1365,0
674,25 Nov 2022,SIDO,765,0,775,765,775,10
786,25 Nov 2022,UNTR,29975,29950,30000,29500,29850,-125
787,25 Nov 2022,UNVR,4560,4570,4600,4530,4600,40
4,28 Nov 2022,ACES,540,0,550,535,540,0
35,28 Nov 2022,AMRT,2770,2790,2910,2780,2860,90
58,28 Nov 2022,ASII,6175,6175,6275,6150,6225,50
332,28 Nov 2022,HRUM,1655,1655,1660,1600,1630,-25
362,28 Nov 2022,INKP,9525,9500,9775,9500,9525,0
370,28 Nov 2022,INTP,9900,9900,9975,9825,9925,25
469,28 Nov 2022,MAPI,1365,0,1375,1335,1375,10
674,28 Nov 2022,SIDO,775,0,775,765,775,0
786,28 Nov 2022,UNTR,29850,29775,30025,29675,29750,-100
787,28 Nov 2022,UNVR,4600,4600,4730,4560,4710,110
4,29 Nov 2022,ACES,540,0,545,515,520,-20
35,29 Nov 2022,AMRT,2860,2820,2900,2770,2840,-20
58,29 Nov 2022,ASII,6225,6125,6150,6025,6050,-175
332,29 Nov 2022,HRUM,1630,1640,1720,1630,1710,80
362,29 Nov 2022,INKP,9525,9550,9750,9525,9750,225
370,29 Nov 2022,INTP,9925,9925,9950,9825,9850,-75
469,29 Nov 2022,MAPI,1375,0,1530,1355,1390,15
674,29 Nov 2022,SIDO,775,0,780,770,775,0
786,29 Nov 2022,UNTR,29750,29750,30825,29750,30700,950
787,29 Nov 2022,UNVR,4710,4710,4710,4660,4700,-10
4,30 Nov 2022,ACES,520,0,525,496,500,-20
35,30 Nov 2022,AMRT,2840,2870,3090,2840,3090,250
58,30 Nov 2022,ASII,6050,6050,6200,6025,6050,0
332,30 Nov 2022,HRUM,1710,1730,1760,1730,1755,45
362,30 Nov 2022,INKP,9750,9775,10000,9725,10000,250
370,30 Nov 2022,INTP,9850,9775,10050,9775,9950,100
469,30 Nov 2022,MAPI,1390,0,1480,1390,1450,60
674,30 Nov 2022,SIDO,775,0,790,770,785,10
786,30 Nov 2022,UNTR,30700,30700,31250,30450,30800,100
787,30 Nov 2022,UNVR,4700,4660,4800,4620,4800,100
4,01 Des 2022,ACES,500,0,510,498,500,0
35,01 Des 2022,AMRT,3090,3090,3090,2940,2940,-150
58,01 Des 2022,ASII,6050,6100,6200,6100,6175,125
332,01 Des 2022,HRUM,1755,1770,1775,1755,1770,15
362,01 Des 2022,INKP,10000,10000,10025,9825,9875,-125
370,01 Des 2022,INTP,9950,9875,10025,9850,10000,50
469,01 Des 2022,MAPI,1450,0,1455,1410,1425,-25
674,01 Des 2022,SIDO,785,0,790,780,790,5
786,01 Des 2022,UNTR,30800,31000,31175,30525,30675,-125
787,01 Des 2022,UNVR,4800,4800,4800,4670,4710,-90
4,02 Des 2022,ACES,500,0,505,490,492,-8
35,02 Des 2022,AMRT,2940,2960,3010,2910,2950,10
58,02 Des 2022,ASII,6175,6175,6175,6050,6125,-50
332,02 Des 2022,HRUM,1770,1770,1770,1735,1755,-15
362,02 Des 2022,INKP,9875,9875,9950,9725,9925,50
370,02 Des 2022,INTP,10000,10050,10100,9850,10000,0
469,02 Des 2022,MAPI,1425,0,1475,1410,1475,50
674,02 Des 2022,SIDO,790,0,790,780,785,-5
786,02 Des 2022,UNTR,30675,30600,30600,29225,29225,-1450
787,02 Des 2022,UNVR,4710,4710,4710,4660,4710,0
4,05 Des 2022,ACES,492,0,505,476,478,-14
35,05 Des 2022,AMRT,2950,2930,2960,2910,2920,-30
58,05 Des 2022,ASII,6125,6075,6100,6000,6025,-100
332,05 Des 2022,HRUM,1755,1780,1810,1760,1775,20
362,05 Des 2022,INKP,9925,9950,9975,9825,9925,0
370,05 Des 2022,INTP,10000,10000,10000,9850,9925,-75
469,05 Des 2022,MAPI,1475,0,1480,1410,1435,-40
675,05 Des 2022,SIDO,785,0,790,755,770,-15
787,05 Des 2022,UNTR,29225,29225,29500,28500,28500,-725
788,05 Des 2022,UNVR,4710,4710,4800,4700,4740,30
4,06 Des 2022,ACES,478,0,478,460,460,-18
35,06 Des 2022,AMRT,2920,2940,2940,2820,2910,-10
58,06 Des 2022,ASII,6025,6000,6025,5800,5875,-150
332,06 Des 2022,HRUM,1775,1790,1805,1765,1770,-5
362,06 Des 2022,INKP,9925,9900,9925,9625,9750,-175
370,06 Des 2022,INTP,9925,9925,9975,9725,9975,50
469,06 Des 2022,MAPI,1435,0,1435,1345,1400,-35
676,06 Des 2022,SIDO,770,0,770,740,750,-20
788,06 Des 2022,UNTR,28500,28500,28625,27900,28100,-400
789,06 Des 2022,UNVR,4740,4740,4750,4670,4740,0
4,07 Des 2022,ACES,460,0,466,440,442,-18
35,07 Des 2022,AMRT,2910,2910,2940,2860,2880,-30
58,07 Des 2022,ASII,5875,5800,5900,5700,5725,-150
332,07 Des 2022,HRUM,1770,1785,1795,1750,1760,-10
362,07 Des 2022,INKP,9750,9750,9750,9475,9475,-275
370,07 Des 2022,INTP,9975,9950,9950,9750,9950,-25
469,07 Des 2022,MAPI,1400,0,1440,1390,1420,20
676,07 Des 2022,SIDO,750,0,755,730,755,5
788,07 Des 2022,UNTR,28100,28125,28650,27525,28050,-50
789,07 Des 2022,UNVR,4740,4740,4740,4670,4700,-40
4,08 Des 2022,ACES,442,0,454,436,442,0
35,08 Des 2022,AMRT,2880,2870,2880,2680,2680,-200
58,08 Des 2022,ASII,5725,5650,5800,5550,5675,-50
332,08 Des 2022,HRUM,1760,1770,1775,1705,1745,-15
362,08 Des 2022,INKP,9475,9475,9475,8975,9250,-225
370,08 Des 2022,INTP,9950,9950,9950,9500,9900,-50
469,08 Des 2022,MAPI,1420,0,1470,1400,1460,40
677,08 Des 2022,SIDO,755,0,770,750,760,5
789,08 Des 2022,UNTR,28050,27900,28025,27025,27300,-750
790,08 Des 2022,UNVR,4700,4670,4690,4560,4660,-40
4,09 Des 2022,ACES,442,0,448,432,436,-6
35,09 Des 2022,AMRT,2680,2530,2530,2500,2500,-180
58,09 Des 2022,ASII,5675,5700,5750,5650,5675,0
332,09 Des 2022,HRUM,1745,1745,1760,1735,1755,10
362,09 Des 2022,INKP,9250,9250,9325,9125,9275,25
370,09 Des 2022,INTP,9900,9900,9975,9825,9925,25
470,09 Des 2022,MAPI,1460,0,1475,1390,1425,-35
678,09 Des 2022,SIDO,760,0,770,750,765,5
790,09 Des 2022,UNTR,27300,27025,27175,26125,26125,-1175
791,09 Des 2022,UNVR,4660,4660,4660,4600,4620,-40
4,12 Des 2022,ACES,436,0,442,434,440,4
35,12 Des 2022,AMRT,2500,2330,2650,2330,2550,50
58,12 Des 2022,ASII,5675,5675,5725,5625,5675,0
332,12 Des 2022,HRUM,1755,1760,1800,1755,1795,40
362,12 Des 2022,INKP,9275,9275,9800,9075,9800,525
370,12 Des 2022,INTP,9925,9925,10100,9850,10000,75
470,12 Des 2022,MAPI,1425,0,1450,1390,1400,-25
678,12 Des 2022,SIDO,765,0,775,760,770,5
790,12 Des 2022,UNTR,26125,26125,26925,26025,26875,750
791,12 Des 2022,UNVR,4620,4620,4690,4580,4690,70
4,13 Des 2022,ACES,440,0,444,434,434,-6
35,13 Des 2022,AMRT,2550,2570,2650,2520,2600,50
58,13 Des 2022,ASII,5675,5700,5900,5675,5825,150
332,13 Des 2022,HRUM,1795,1800,1810,1755,1770,-25
362,13 Des 2022,INKP,9800,9800,9875,9575,9575,-225
370,13 Des 2022,INTP,10000,10075,10075,9875,10000,0
470,13 Des 2022,MAPI,1400,0,1430,1385,1420,20
678,13 Des 2022,SIDO,770,0,770,755,760,-10
790,13 Des 2022,UNTR,26875,26850,27125,26600,26825,-50
791,13 Des 2022,UNVR,4690,4700,4720,4630,4720,30
4,14 Des 2022,ACES,434,0,442,424,426,-8
35,14 Des 2022,AMRT,2600,2600,2610,2580,2590,-10
58,14 Des 2022,ASII,5825,5925,5950,5775,5825,0
332,14 Des 2022,HRUM,1770,1730,1755,1700,1745,-25
362,14 Des 2022,INKP,9575,9675,9750,9500,9650,75
370,14 Des 2022,INTP,10000,10000,10050,9925,9975,-25
470,14 Des 2022,MAPI,1420,0,1420,1385,1400,-20
678,14 Des 2022,SIDO,760,0,770,760,770,10
790,14 Des 2022,UNTR,26825,26825,27350,26825,26850,25
791,14 Des 2022,UNVR,4720,4720,4720,4670,4720,0
4,15 Des 2022,ACES,426,0,436,410,414,-12
35,15 Des 2022,AMRT,2590,2580,2600,2550,2570,-20
58,15 Des 2022,ASII,5825,5825,5850,5750,5800,-25
332,15 Des 2022,HRUM,1745,1745,1760,1725,1745,0
362,15 Des 2022,INKP,9650,0,9750,9575,9700,50
370,15 Des 2022,INTP,9975,9975,9975,9825,9850,-125
470,15 Des 2022,MAPI,1400,0,1400,1350,1360,-40
678,15 Des 2022,SIDO,770,0,770,760,760,-10
790,15 Des 2022,UNTR,26850,26775,26800,26525,26525,-325
791,15 Des 2022,UNVR,4720,4720,4720,4640,4700,-20
4,16 Des 2022,ACES,414,0,420,398,398,-16
35,16 Des 2022,AMRT,2570,2560,2590,2540,2560,-10
58,16 Des 2022,ASII,5800,5775,5800,5700,5775,-25
332,16 Des 2022,HRUM,1745,1735,1750,1710,1750,5
362,16 Des 2022,INKP,9700,9625,9800,9400,9800,100
370,16 Des 2022,INTP,9850,9800,9950,9775,9950,100
470,16 Des 2022,MAPI,1360,0,1360,1270,1305,-55
678,16 Des 2022,SIDO,760,0,765,740,755,-5
790,16 Des 2022,UNTR,26525,26475,26775,26250,26550,25
791,16 Des 2022,UNVR,4700,4690,4870,4660,4870,170
4,19 Des 2022,ACES,398,0,422,392,420,22
35,19 Des 2022,AMRT,2560,2550,2620,2530,2550,-10
58,19 Des 2022,ASII,5775,5850,5850,5650,5700,-75
332,19 Des 2022,HRUM,1750,1750,1755,1710,1725,-25
362,19 Des 2022,INKP,9800,9650,9700,9475,9525,-275
370,19 Des 2022,INTP,9950,9950,9950,9775,9875,-75
470,19 Des 2022,MAPI,1305,0,1375,1305,1335,30
678,19 Des 2022,SIDO,755,0,765,740,740,-15
790,19 Des 2022,UNTR,26550,26300,26850,26300,26850,300
791,19 Des 2022,UNVR,4870,4830,4830,4730,4730,-140
4,20 Des 2022,ACES,420,0,438,416,430,10
35,20 Des 2022,AMRT,2550,2550,2600,2520,2570,20
58,20 Des 2022,ASII,5700,5675,5750,5675,5700,0
332,20 Des 2022,HRUM,1725,1725,1725,1650,1655,-70
362,20 Des 2022,INKP,9525,9525,9525,9275,9300,-225
370,20 Des 2022,INTP,9875,9875,9925,9800,9850,-25
470,20 Des 2022,MAPI,1335,0,1440,1335,1435,100
678,20 Des 2022,SIDO,740,0,755,735,755,15
790,20 Des 2022,UNTR,26850,26850,27025,26400,26650,-200
791,20 Des 2022,UNVR,4730,4730,4770,4700,4770,40
4,21 Des 2022,ACES,430,0,440,422,430,0
35,21 Des 2022,AMRT,2570,2590,2640,2550,2600,30
58,21 Des 2022,ASII,5700,5700,5725,5650,5700,0
332,21 Des 2022,HRUM,1655,1660,1680,1660,1660,5
362,21 Des 2022,INKP,9300,9300,9450,9300,9375,75
370,21 Des 2022,INTP,9850,9850,9925,9750,9850,0
470,21 Des 2022,MAPI,1435,0,1445,1400,1420,-15
678,21 Des 2022,SIDO,755,0,765,755,765,10
790,21 Des 2022,UNTR,26650,26625,26850,26425,26625,-25
791,21 Des 2022,UNVR,4770,4770,4790,4740,4780,10
4,22 Des 2022,ACES,430,0,496,432,486,56
35,22 Des 2022,AMRT,2600,2600,2600,2570,2600,0
58,22 Des 2022,ASII,5700,5700,5775,5675,5775,75
332,22 Des 2022,HRUM,1660,1690,1695,1670,1685,25
362,22 Des 2022,INKP,9375,9375,9450,9150,9200,-175
370,22 Des 2022,INTP,9850,9850,9850,9625,9650,-200
470,22 Des 2022,MAPI,1420,0,1460,1420,1425,5
678,22 Des 2022,SIDO,765,0,785,755,770,5
790,22 Des 2022,UNTR,26625,26750,27000,26450,27000,375
791,22 Des 2022,UNVR,4780,4780,4840,4770,4840,60
4,23 Des 2022,ACES,486,0,498,470,480,-6
35,23 Des 2022,AMRT,2600,2590,2640,2560,2620,20
58,23 Des 2022,ASII,5775,5750,5775,5650,5675,-100
332,23 Des 2022,HRUM,1685,1685,1685,1650,1665,-20
362,23 Des 2022,INKP,9200,9200,9225,9050,9150,-50
370,23 Des 2022,INTP,9650,9650,9750,9625,9750,100
470,23 Des 2022,MAPI,1425,0,1445,1420,1445,20
678,23 Des 2022,SIDO,770,0,770,750,750,-20
790,23 Des 2022,UNTR,27000,27000,27000,26625,26875,-125
791,23 Des 2022,UNVR,4840,4830,4830,4760,4820,-20
4,26 Des 2022,ACES,480,0,520,480,500,20
35,26 Des 2022,AMRT,2620,2640,2700,2630,2650,30
58,26 Des 2022,ASII,5675,5675,5725,5625,5650,-25
332,26 Des 2022,HRUM,1665,1670,1670,1645,1645,-20
362,26 Des 2022,INKP,9150,9150,9200,9025,9075,-75
370,26 Des 2022,INTP,9750,9725,9875,9650,9825,75
470,26 Des 2022,MAPI,1445,0,1455,1370,1380,-65
678,26 Des 2022,SIDO,750,0,760,750,755,5
790,26 Des 2022,UNTR,26875,26900,26900,26375,26400,-475
791,26 Des 2022,UNVR,4820,4820,4820,4740,4750,-70
4,27 Des 2022,ACES,500,0,515,492,492,-8
35,27 Des 2022,AMRT,2650,2680,2820,2640,2820,170
58,27 Des 2022,ASII,5650,5700,5750,5650,5675,25
332,27 Des 2022,HRUM,1645,1660,1680,1615,1620,-25
362,27 Des 2022,INKP,9075,9075,9175,8975,9025,-50
370,27 Des 2022,INTP,9825,9800,10100,9800,10075,250
470,27 Des 2022,MAPI,1380,0,1440,1375,1410,30
678,27 Des 2022,SIDO,755,0,760,750,755,0
790,27 Des 2022,UNTR,26400,26400,26850,26375,26625,225
791,27 Des 2022,UNVR,4750,4760,4810,4740,4810,60
4,28 Des 2022,ACES,492,0,520,492,494,2
35,28 Des 2022,AMRT,2820,2820,2820,2660,2680,-140
58,28 Des 2022,ASII,5675,5725,5725,5575,5625,-50
332,28 Des 2022,HRUM,1620,1620,1630,1600,1605,-15
362,28 Des 2022,INKP,9025,9025,9025,8850,8900,-125
370,28 Des 2022,INTP,10075,10025,10050,9900,10025,-50
470,28 Des 2022,MAPI,1410,0,1415,1385,1415,5
678,28 Des 2022,SIDO,755,0,760,750,755,0
790,28 Des 2022,UNTR,26625,26625,26700,26025,26175,-450
791,28 Des 2022,UNVR,4810,4810,4820,4710,4770,-40
4,29 Des 2022,ACES,494,0,505,486,496,2
35,29 Des 2022,AMRT,2680,2670,2770,2610,2740,60
58,29 Des 2022,ASII,5625,5600,5675,5550,5650,25
332,29 Des 2022,HRUM,1605,1610,1620,1590,1605,0
362,29 Des 2022,INKP,8900,8900,8925,8775,8800,-100
370,29 Des 2022,INTP,10025,0,10025,9900,9925,-100
470,29 Des 2022,MAPI,1415,0,1430,1395,1415,0
678,29 Des 2022,SIDO,755,0,760,750,755,0
790,29 Des 2022,UNTR,26175,26125,26350,25675,26275,100
791,29 Des 2022,UNVR,4770,4740,4760,4700,4760,-10
4,30 Des 2022,ACES,496,0,510,494,496,0
35,30 Des 2022,AMRT,2740,2740,2750,2650,2650,-90
58,30 Des 2022,ASII,5650,5675,5750,5650,5700,50
332,30 Des 2022,HRUM,1605,1615,1635,1610,1620,15
362,30 Des 2022,INKP,8800,8800,8950,8725,8725,-75
370,30 Des 2022,INTP,9925,10000,10000,9875,9900,-25
470,30 Des 2022,MAPI,1415,0,1450,1395,1445,30
678,30 Des 2022,SIDO,755,0,760,750,755,0
790,30 Des 2022,UNTR,26275,26275,26400,26075,26075,-200
791,30 Des 2022,UNVR,4760,4780,4780,4700,4700,-60
